ticker,date,research_development,income_before_tax,minority_interest,net_income,selling_general_administrative,gross_profit,ebit,operating_income,interest_expense,income_tax_expense,total_revenue,total_operating_expenses,cost_of_revenue,total_other_income_expense_net,discontinued_operations,net_income_from_continuing_ops,net_income_applicable_to_common_shares,other_operating_expenses,form,industry,short_name,long_business_summary
SABR,2017-12-31,1156723000,377613000,5198000,242531000,534211000,1097231000,563020000,563020000,-153925000,128037000,3598484000,3035464000,2501253000,-185407000,-1932000,249576000,242531000,NA,income_statement,Information Technology Services,Sabre Corporation,"Sabre Corporation, through its subsidiary, Sabre Holdings Corporation, provides technology solutions to the travel and tourism industry worldwide. It operates in three segments: Travel Network, Airline Solutions, and Hospitality Solutions. The Travel Network segment operates as a business-to-business travel marketplace that offers travel content, such as inventory, prices, and availability from a range of travel suppliers, including airlines, hotels, car rental brands, rail carriers, cruise lines, and tour operators with a network of travel buyers comprising online and offline travel agencies, travel management companies, and corporate travel departments. The Airline Solutions segment provides a portfolio of software technology products and solutions through software-as-a-service (SaaS) and hosted delivery models to airlines and other travel suppliers. Its products include SabreSonic Customer Sales & Service, a reservation system that provides capabilities around managing sales and customer service across an airline's touch points; Sabre AirVision Marketing & Planning, a set of airline commercial planning solutions; and Sabre AirCentre Enterprise Operations, a set of solutions for planning and management of airline, airport, and customer operations. The Hospitality Solutions segment provides software and solutions to hoteliers through SaaS and hosted delivery model. It offers SynXis, a central reservation system; SynXis Property Manager Solution for property management; and marketing, professional, and revenue management services. Sabre Corporation has strategic partnership with Google to develop an artificial intelligence (ai)-driven technology platform. sThe company was founded in 2006 and is headquartered in Southlake, Texas."
SABR,2018-12-31,1156723000,398413000,7205000,337531000,501937000,1075542000,573605000,573605000,-157017000,57492000,3866956000,3293351000,2791414000,-175192000,1739000,340921000,337531000,NA,income_statement,Information Technology Services,Sabre Corporation,"Sabre Corporation, through its subsidiary, Sabre Holdings Corporation, provides technology solutions to the travel and tourism industry worldwide. It operates in three segments: Travel Network, Airline Solutions, and Hospitality Solutions. The Travel Network segment operates as a business-to-business travel marketplace that offers travel content, such as inventory, prices, and availability from a range of travel suppliers, including airlines, hotels, car rental brands, rail carriers, cruise lines, and tour operators with a network of travel buyers comprising online and offline travel agencies, travel management companies, and corporate travel departments. The Airline Solutions segment provides a portfolio of software technology products and solutions through software-as-a-service (SaaS) and hosted delivery models to airlines and other travel suppliers. Its products include SabreSonic Customer Sales & Service, a reservation system that provides capabilities around managing sales and customer service across an airline's touch points; Sabre AirVision Marketing & Planning, a set of airline commercial planning solutions; and Sabre AirCentre Enterprise Operations, a set of solutions for planning and management of airline, airport, and customer operations. The Hospitality Solutions segment provides software and solutions to hoteliers through SaaS and hosted delivery model. It offers SynXis, a central reservation system; SynXis Property Manager Solution for property management; and marketing, professional, and revenue management services. Sabre Corporation has strategic partnership with Google to develop an artificial intelligence (ai)-driven technology platform. sThe company was founded in 2006 and is headquartered in Southlake, Texas."
SABR,2019-12-31,1156723000,199638000,8588000,158592000,560110000,939985000,379875000,379875000,-156391000,35326000,3974988000,3595113000,3035003000,-180237000,-1766000,164312000,158592000,NA,income_statement,Information Technology Services,Sabre Corporation,"Sabre Corporation, through its subsidiary, Sabre Holdings Corporation, provides technology solutions to the travel and tourism industry worldwide. It operates in three segments: Travel Network, Airline Solutions, and Hospitality Solutions. The Travel Network segment operates as a business-to-business travel marketplace that offers travel content, such as inventory, prices, and availability from a range of travel suppliers, including airlines, hotels, car rental brands, rail carriers, cruise lines, and tour operators with a network of travel buyers comprising online and offline travel agencies, travel management companies, and corporate travel departments. The Airline Solutions segment provides a portfolio of software technology products and solutions through software-as-a-service (SaaS) and hosted delivery models to airlines and other travel suppliers. Its products include SabreSonic Customer Sales & Service, a reservation system that provides capabilities around managing sales and customer service across an airline's touch points; Sabre AirVision Marketing & Planning, a set of airline commercial planning solutions; and Sabre AirCentre Enterprise Operations, a set of solutions for planning and management of airline, airport, and customer operations. The Hospitality Solutions segment provides software and solutions to hoteliers through SaaS and hosted delivery model. It offers SynXis, a central reservation system; SynXis Property Manager Solution for property management; and marketing, professional, and revenue management services. Sabre Corporation has strategic partnership with Google to develop an artificial intelligence (ai)-driven technology platform. sThe company was founded in 2006 and is headquartered in Southlake, Texas."
SABR,2020-12-31,1156723000,-1314245000,7028000,-1272744000,604406000,755090000,-1006039000,-1006039000,-235091000,-39913000,1334100000,2340139000,579010000,-308206000,2788000,-1274332000,-1280403000,NA,income_statement,Information Technology Services,Sabre Corporation,"Sabre Corporation, through its subsidiary, Sabre Holdings Corporation, provides technology solutions to the travel and tourism industry worldwide. It operates in three segments: Travel Network, Airline Solutions, and Hospitality Solutions. The Travel Network segment operates as a business-to-business travel marketplace that offers travel content, such as inventory, prices, and availability from a range of travel suppliers, including airlines, hotels, car rental brands, rail carriers, cruise lines, and tour operators with a network of travel buyers comprising online and offline travel agencies, travel management companies, and corporate travel departments. The Airline Solutions segment provides a portfolio of software technology products and solutions through software-as-a-service (SaaS) and hosted delivery models to airlines and other travel suppliers. Its products include SabreSonic Customer Sales & Service, a reservation system that provides capabilities around managing sales and customer service across an airline's touch points; Sabre AirVision Marketing & Planning, a set of airline commercial planning solutions; and Sabre AirCentre Enterprise Operations, a set of solutions for planning and management of airline, airport, and customer operations. The Hospitality Solutions segment provides software and solutions to hoteliers through SaaS and hosted delivery model. It offers SynXis, a central reservation system; SynXis Property Manager Solution for property management; and marketing, professional, and revenue management services. Sabre Corporation has strategic partnership with Google to develop an artificial intelligence (ai)-driven technology platform. sThe company was founded in 2006 and is headquartered in Southlake, Texas."
SABRP,2017-12-31,1156723000,377613000,5198000,242531000,534211000,1097231000,563020000,563020000,-153925000,128037000,3598484000,3035464000,2501253000,-185407000,-1932000,249576000,242531000,NA,income_statement,Information Technology Services,Sabre Corporation - 6.50% Serie,"Sabre Corporation, through its subsidiary, Sabre Holdings Corporation, provides technology solutions to the travel and tourism industry worldwide. It operates in three segments: Travel Network, Airline Solutions, and Hospitality Solutions. The Travel Network segment operates as a business-to-business travel marketplace that offers travel content, such as inventory, prices, and availability from a range of travel suppliers, including airlines, hotels, car rental brands, rail carriers, cruise lines, and tour operators with a network of travel buyers comprising online and offline travel agencies, travel management companies, and corporate travel departments. The Airline Solutions segment provides a portfolio of software technology products and solutions through software-as-a-service (SaaS) and hosted delivery models to airlines and other travel suppliers. Its products include SabreSonic Customer Sales & Service, a reservation system that provides capabilities around managing sales and customer service across an airline's touch points; Sabre AirVision Marketing & Planning, a set of airline commercial planning solutions; and Sabre AirCentre Enterprise Operations, a set of solutions for planning and management of airline, airport, and customer operations. The Hospitality Solutions segment provides software and solutions to hoteliers through SaaS and hosted delivery model. It offers SynXis, a central reservation system; SynXis Property Manager Solution for property management; and marketing, professional, and revenue management services. Sabre Corporation has strategic partnership with Google to develop an artificial intelligence (ai)-driven technology platform. sThe company was founded in 2006 and is headquartered in Southlake, Texas."
SABRP,2018-12-31,1156723000,398413000,7205000,337531000,501937000,1075542000,573605000,573605000,-157017000,57492000,3866956000,3293351000,2791414000,-175192000,1739000,340921000,337531000,NA,income_statement,Information Technology Services,Sabre Corporation - 6.50% Serie,"Sabre Corporation, through its subsidiary, Sabre Holdings Corporation, provides technology solutions to the travel and tourism industry worldwide. It operates in three segments: Travel Network, Airline Solutions, and Hospitality Solutions. The Travel Network segment operates as a business-to-business travel marketplace that offers travel content, such as inventory, prices, and availability from a range of travel suppliers, including airlines, hotels, car rental brands, rail carriers, cruise lines, and tour operators with a network of travel buyers comprising online and offline travel agencies, travel management companies, and corporate travel departments. The Airline Solutions segment provides a portfolio of software technology products and solutions through software-as-a-service (SaaS) and hosted delivery models to airlines and other travel suppliers. Its products include SabreSonic Customer Sales & Service, a reservation system that provides capabilities around managing sales and customer service across an airline's touch points; Sabre AirVision Marketing & Planning, a set of airline commercial planning solutions; and Sabre AirCentre Enterprise Operations, a set of solutions for planning and management of airline, airport, and customer operations. The Hospitality Solutions segment provides software and solutions to hoteliers through SaaS and hosted delivery model. It offers SynXis, a central reservation system; SynXis Property Manager Solution for property management; and marketing, professional, and revenue management services. Sabre Corporation has strategic partnership with Google to develop an artificial intelligence (ai)-driven technology platform. sThe company was founded in 2006 and is headquartered in Southlake, Texas."
SABRP,2019-12-31,1156723000,199638000,8588000,158592000,560110000,939985000,379875000,379875000,-156391000,35326000,3974988000,3595113000,3035003000,-180237000,-1766000,164312000,158592000,NA,income_statement,Information Technology Services,Sabre Corporation - 6.50% Serie,"Sabre Corporation, through its subsidiary, Sabre Holdings Corporation, provides technology solutions to the travel and tourism industry worldwide. It operates in three segments: Travel Network, Airline Solutions, and Hospitality Solutions. The Travel Network segment operates as a business-to-business travel marketplace that offers travel content, such as inventory, prices, and availability from a range of travel suppliers, including airlines, hotels, car rental brands, rail carriers, cruise lines, and tour operators with a network of travel buyers comprising online and offline travel agencies, travel management companies, and corporate travel departments. The Airline Solutions segment provides a portfolio of software technology products and solutions through software-as-a-service (SaaS) and hosted delivery models to airlines and other travel suppliers. Its products include SabreSonic Customer Sales & Service, a reservation system that provides capabilities around managing sales and customer service across an airline's touch points; Sabre AirVision Marketing & Planning, a set of airline commercial planning solutions; and Sabre AirCentre Enterprise Operations, a set of solutions for planning and management of airline, airport, and customer operations. The Hospitality Solutions segment provides software and solutions to hoteliers through SaaS and hosted delivery model. It offers SynXis, a central reservation system; SynXis Property Manager Solution for property management; and marketing, professional, and revenue management services. Sabre Corporation has strategic partnership with Google to develop an artificial intelligence (ai)-driven technology platform. sThe company was founded in 2006 and is headquartered in Southlake, Texas."
SABRP,2020-12-31,1156723000,-1314245000,7028000,-1272744000,604406000,755090000,-1006039000,-1006039000,-235091000,-39913000,1334100000,2340139000,579010000,-308206000,2788000,-1274332000,-1280403000,NA,income_statement,Information Technology Services,Sabre Corporation - 6.50% Serie,"Sabre Corporation, through its subsidiary, Sabre Holdings Corporation, provides technology solutions to the travel and tourism industry worldwide. It operates in three segments: Travel Network, Airline Solutions, and Hospitality Solutions. The Travel Network segment operates as a business-to-business travel marketplace that offers travel content, such as inventory, prices, and availability from a range of travel suppliers, including airlines, hotels, car rental brands, rail carriers, cruise lines, and tour operators with a network of travel buyers comprising online and offline travel agencies, travel management companies, and corporate travel departments. The Airline Solutions segment provides a portfolio of software technology products and solutions through software-as-a-service (SaaS) and hosted delivery models to airlines and other travel suppliers. Its products include SabreSonic Customer Sales & Service, a reservation system that provides capabilities around managing sales and customer service across an airline's touch points; Sabre AirVision Marketing & Planning, a set of airline commercial planning solutions; and Sabre AirCentre Enterprise Operations, a set of solutions for planning and management of airline, airport, and customer operations. The Hospitality Solutions segment provides software and solutions to hoteliers through SaaS and hosted delivery model. It offers SynXis, a central reservation system; SynXis Property Manager Solution for property management; and marketing, professional, and revenue management services. Sabre Corporation has strategic partnership with Google to develop an artificial intelligence (ai)-driven technology platform. sThe company was founded in 2006 and is headquartered in Southlake, Texas."
SAFM,2017-10-31,NA,424530000,NA,279745000,216303000,641542000,425239000,425239000,-1886000,144785000,3342226000,2916987000,2700684000,-709000,NA,279745000,275460000,NA,income_statement,Packaged Foods,"Sanderson Farms, Inc.","Sanderson Farms, Inc., an integrated poultry processing company, produces, processes, markets, and distributes fresh, frozen, and prepared chicken products in the United States. The company sells ice-packed, chill-packed, bulk-packed, and frozen chicken primarily under the Sanderson Farms brand name to retailers, distributors, and casual dining operators in the southeastern, southwestern, northeastern, and western United States, as well as to customers who resell frozen chicken into export markets. Its prepared chicken product line includes institutional and consumer packaged partially cooked or marinated chicken items for distributors and food service establishments. Sanderson Farms, Inc. was founded in 1947 and is headquartered in Laurel, Mississippi."
SAFM,2018-10-31,NA,30557000,NA,61431000,221965000,251665000,29700000,29700000,-2066000,-30874000,3236004000,3206304000,2984339000,857000,NA,61431000,60553000,NA,income_statement,Packaged Foods,"Sanderson Farms, Inc.","Sanderson Farms, Inc., an integrated poultry processing company, produces, processes, markets, and distributes fresh, frozen, and prepared chicken products in the United States. The company sells ice-packed, chill-packed, bulk-packed, and frozen chicken primarily under the Sanderson Farms brand name to retailers, distributors, and casual dining operators in the southeastern, southwestern, northeastern, and western United States, as well as to customers who resell frozen chicken into export markets. Its prepared chicken product line includes institutional and consumer packaged partially cooked or marinated chicken items for distributors and food service establishments. Sanderson Farms, Inc. was founded in 1947 and is headquartered in Laurel, Mississippi."
SAFM,2019-10-31,NA,63847000,NA,53294000,211141000,279135000,67994000,67994000,-4156000,10553000,3440258000,3372264000,3161123000,-4147000,NA,53294000,52516000,NA,income_statement,Packaged Foods,"Sanderson Farms, Inc.","Sanderson Farms, Inc., an integrated poultry processing company, produces, processes, markets, and distributes fresh, frozen, and prepared chicken products in the United States. The company sells ice-packed, chill-packed, bulk-packed, and frozen chicken primarily under the Sanderson Farms brand name to retailers, distributors, and casual dining operators in the southeastern, southwestern, northeastern, and western United States, as well as to customers who resell frozen chicken into export markets. Its prepared chicken product line includes institutional and consumer packaged partially cooked or marinated chicken items for distributors and food service establishments. Sanderson Farms, Inc. was founded in 1947 and is headquartered in Laurel, Mississippi."
SAFM,2020-10-31,NA,-16311000,NA,28274000,193044000,217856000,24812000,24812000,-5207000,-44585000,3564267000,3539455000,3346411000,-41123000,NA,28274000,27902000,NA,income_statement,Packaged Foods,"Sanderson Farms, Inc.","Sanderson Farms, Inc., an integrated poultry processing company, produces, processes, markets, and distributes fresh, frozen, and prepared chicken products in the United States. The company sells ice-packed, chill-packed, bulk-packed, and frozen chicken primarily under the Sanderson Farms brand name to retailers, distributors, and casual dining operators in the southeastern, southwestern, northeastern, and western United States, as well as to customers who resell frozen chicken into export markets. Its prepared chicken product line includes institutional and consumer packaged partially cooked or marinated chicken items for distributors and food service establishments. Sanderson Farms, Inc. was founded in 1947 and is headquartered in Laurel, Mississippi."
SAFT,2016-12-31,NA,93282000,NA,64585000,NA,93372000,93372000,93372000,-90000,28697000,819822000,726450000,726450000,-90000,NA,64585000,64149000,NA,income_statement,Insurance—Property & Casualty,"Safety Insurance Group, Inc.","Safety Insurance Group, Inc. provides private passenger and commercial automobile, and homeowner insurance in the United States. The company's private passenger automobile policies offer coverage for bodily injury and property damage to others, no-fault personal injury coverage for the insured/insured's car occupants, and physical damage coverage for an insured's own vehicle for collision or other perils. It also provides commercial automobile policies that offer insurance for commercial vehicles used for business purposes, including private passenger-type vehicles, trucks, tractors and trailers, insure individual vehicles, and commercial fleets; and homeowners policies, which provide coverage for homes, condominiums, and apartments for losses to a dwelling and its contents from various perils, and coverage for liability to others arising from ownership or occupancy. In addition, the company offers business owners policies that cover apartments and residential condominiums, restaurants, office condominiums, processing and services businesses, special trade contractors, and wholesalers. Further, it provides personal umbrella policies, which provide personal excess liability coverage over and above the limits of individual automobile, watercraft, and homeowner's insurance policies; and commercial umbrella policies, as well as underwrites dwelling fire insurance for non-owner occupied residences. Additionally, the company offers inland marine coverage for homeowners and business owner policies; and watercraft coverage for small and medium sized pleasure crafts. It distributes its products through independent agents. The company was formerly known as Safety Holdings Inc and changed its name to Safety Insurance Group, Inc. in April 2002. Safety Insurance Group, Inc. was founded in 1979 and is based in Boston, Massachusetts."
SAFT,2017-12-31,NA,86700000,NA,62387000,NA,86790000,86790000,86790000,-90000,24313000,839113000,752323000,752323000,-90000,NA,62387000,61995000,NA,income_statement,Insurance—Property & Casualty,"Safety Insurance Group, Inc.","Safety Insurance Group, Inc. provides private passenger and commercial automobile, and homeowner insurance in the United States. The company's private passenger automobile policies offer coverage for bodily injury and property damage to others, no-fault personal injury coverage for the insured/insured's car occupants, and physical damage coverage for an insured's own vehicle for collision or other perils. It also provides commercial automobile policies that offer insurance for commercial vehicles used for business purposes, including private passenger-type vehicles, trucks, tractors and trailers, insure individual vehicles, and commercial fleets; and homeowners policies, which provide coverage for homes, condominiums, and apartments for losses to a dwelling and its contents from various perils, and coverage for liability to others arising from ownership or occupancy. In addition, the company offers business owners policies that cover apartments and residential condominiums, restaurants, office condominiums, processing and services businesses, special trade contractors, and wholesalers. Further, it provides personal umbrella policies, which provide personal excess liability coverage over and above the limits of individual automobile, watercraft, and homeowner's insurance policies; and commercial umbrella policies, as well as underwrites dwelling fire insurance for non-owner occupied residences. Additionally, the company offers inland marine coverage for homeowners and business owner policies; and watercraft coverage for small and medium sized pleasure crafts. It distributes its products through independent agents. The company was formerly known as Safety Holdings Inc and changed its name to Safety Insurance Group, Inc. in April 2002. Safety Insurance Group, Inc. was founded in 1979 and is based in Boston, Massachusetts."
SAFT,2018-12-31,NA,104251000,NA,83195000,NA,104341000,104341000,104341000,-90000,21056000,836497000,732156000,732156000,-90000,NA,83195000,82699000,NA,income_statement,Insurance—Property & Casualty,"Safety Insurance Group, Inc.","Safety Insurance Group, Inc. provides private passenger and commercial automobile, and homeowner insurance in the United States. The company's private passenger automobile policies offer coverage for bodily injury and property damage to others, no-fault personal injury coverage for the insured/insured's car occupants, and physical damage coverage for an insured's own vehicle for collision or other perils. It also provides commercial automobile policies that offer insurance for commercial vehicles used for business purposes, including private passenger-type vehicles, trucks, tractors and trailers, insure individual vehicles, and commercial fleets; and homeowners policies, which provide coverage for homes, condominiums, and apartments for losses to a dwelling and its contents from various perils, and coverage for liability to others arising from ownership or occupancy. In addition, the company offers business owners policies that cover apartments and residential condominiums, restaurants, office condominiums, processing and services businesses, special trade contractors, and wholesalers. Further, it provides personal umbrella policies, which provide personal excess liability coverage over and above the limits of individual automobile, watercraft, and homeowner's insurance policies; and commercial umbrella policies, as well as underwrites dwelling fire insurance for non-owner occupied residences. Additionally, the company offers inland marine coverage for homeowners and business owner policies; and watercraft coverage for small and medium sized pleasure crafts. It distributes its products through independent agents. The company was formerly known as Safety Holdings Inc and changed its name to Safety Insurance Group, Inc. in April 2002. Safety Insurance Group, Inc. was founded in 1979 and is based in Boston, Massachusetts."
SAFT,2019-12-31,NA,123681000,NA,99601000,NA,123771000,123771000,123771000,-90000,24080000,877753000,753982000,753982000,-90000,NA,99601000,99078000,NA,income_statement,Insurance—Property & Casualty,"Safety Insurance Group, Inc.","Safety Insurance Group, Inc. provides private passenger and commercial automobile, and homeowner insurance in the United States. The company's private passenger automobile policies offer coverage for bodily injury and property damage to others, no-fault personal injury coverage for the insured/insured's car occupants, and physical damage coverage for an insured's own vehicle for collision or other perils. It also provides commercial automobile policies that offer insurance for commercial vehicles used for business purposes, including private passenger-type vehicles, trucks, tractors and trailers, insure individual vehicles, and commercial fleets; and homeowners policies, which provide coverage for homes, condominiums, and apartments for losses to a dwelling and its contents from various perils, and coverage for liability to others arising from ownership or occupancy. In addition, the company offers business owners policies that cover apartments and residential condominiums, restaurants, office condominiums, processing and services businesses, special trade contractors, and wholesalers. Further, it provides personal umbrella policies, which provide personal excess liability coverage over and above the limits of individual automobile, watercraft, and homeowner's insurance policies; and commercial umbrella policies, as well as underwrites dwelling fire insurance for non-owner occupied residences. Additionally, the company offers inland marine coverage for homeowners and business owner policies; and watercraft coverage for small and medium sized pleasure crafts. It distributes its products through independent agents. The company was formerly known as Safety Holdings Inc and changed its name to Safety Insurance Group, Inc. in April 2002. Safety Insurance Group, Inc. was founded in 1979 and is based in Boston, Massachusetts."
SAGE,2016-12-31,120756000,-158987000,NA,-158987000,39407000,-120756000,-160163000,-160163000,NA,0,0,160163000,120756000,1176000,NA,-158987000,-158987000,NA,income_statement,Biotechnology,"Sage Therapeutics, Inc.","Sage Therapeutics, Inc., a biopharmaceutical company, develops and commercializes novel medicines to treat central nervous system (CNS) disorders. Its lead product candidate is ZULRESSO, a proprietary intravenous formulation of brexanolone for the treatment of postpartum depression (PPD). The company's product pipeline also includes SAGE-217, a novel neuroactive steroid, which is in Phase III clinical trials for treating PPD, major depressive disorders, bipolar depression, and generalized anxiety disorders; and SAGE-324, a novel compound that is in Phase II clinical trial to treat essential tremors, as well as has completed Phase I clinical trial for epileptiform disorders and Parkinson's diseases. In addition, its product pipeline comprises SAGE-718, an oxysterol-based positive allosteric modulator of the NMDA receptor, which has completed Phase I clinical trial for the treatment of depression, Huntington's disease, Alzheimer's disease, attention deficit hyperactivity disorder, schizophrenia, and neuropathic pain. Further, the company is developing SAGE-904, an oral therapy that is in Phase I clinical trial for disorders associated with NMDA hypofunction; and SAGE-689 for intramuscular administration. Sage Therapeutics, Inc. has a strategic collaboration with Shionogi & Co., Ltd. for the development and commercialization of SAGE-217; Biogen Inc. to develop and commercialize zuranolone (SAGE-217) for various depressive disorder, postpartum depression, and other psychiatric disorders, as well as SAGE-324 for essential tremor and other neurological disorders; and Biogen MA Inc. and Biogen International GmbH for the development, manufacture, and commercialization of products containing SAGE-217 molecule and products containing the SAGE-324 molecule. The company was formerly known as Sterogen Biopharma, Inc. and changed its name to Sage Therapeutics, Inc. in September 2011. Sage Therapeutics, Inc. was founded in 2010 and is headquartered in Cambridge, Massachusetts."
SAGE,2017-12-31,210277000,-270120000,NA,-270120000,62878000,-210277000,-273155000,-273155000,NA,0,0,273155000,210277000,3035000,NA,-270120000,-270120000,NA,income_statement,Biotechnology,"Sage Therapeutics, Inc.","Sage Therapeutics, Inc., a biopharmaceutical company, develops and commercializes novel medicines to treat central nervous system (CNS) disorders. Its lead product candidate is ZULRESSO, a proprietary intravenous formulation of brexanolone for the treatment of postpartum depression (PPD). The company's product pipeline also includes SAGE-217, a novel neuroactive steroid, which is in Phase III clinical trials for treating PPD, major depressive disorders, bipolar depression, and generalized anxiety disorders; and SAGE-324, a novel compound that is in Phase II clinical trial to treat essential tremors, as well as has completed Phase I clinical trial for epileptiform disorders and Parkinson's diseases. In addition, its product pipeline comprises SAGE-718, an oxysterol-based positive allosteric modulator of the NMDA receptor, which has completed Phase I clinical trial for the treatment of depression, Huntington's disease, Alzheimer's disease, attention deficit hyperactivity disorder, schizophrenia, and neuropathic pain. Further, the company is developing SAGE-904, an oral therapy that is in Phase I clinical trial for disorders associated with NMDA hypofunction; and SAGE-689 for intramuscular administration. Sage Therapeutics, Inc. has a strategic collaboration with Shionogi & Co., Ltd. for the development and commercialization of SAGE-217; Biogen Inc. to develop and commercialize zuranolone (SAGE-217) for various depressive disorder, postpartum depression, and other psychiatric disorders, as well as SAGE-324 for essential tremor and other neurological disorders; and Biogen MA Inc. and Biogen International GmbH for the development, manufacture, and commercialization of products containing SAGE-217 molecule and products containing the SAGE-324 molecule. The company was formerly known as Sterogen Biopharma, Inc. and changed its name to Sage Therapeutics, Inc. in September 2011. Sage Therapeutics, Inc. was founded in 2010 and is headquartered in Cambridge, Massachusetts."
SAGE,2018-12-31,368815000,-372882000,NA,-372882000,201404000,-191834000,-393238000,-393238000,NA,0,90273000,483511000,282107000,20356000,NA,-372882000,-372882000,NA,income_statement,Biotechnology,"Sage Therapeutics, Inc.","Sage Therapeutics, Inc., a biopharmaceutical company, develops and commercializes novel medicines to treat central nervous system (CNS) disorders. Its lead product candidate is ZULRESSO, a proprietary intravenous formulation of brexanolone for the treatment of postpartum depression (PPD). The company's product pipeline also includes SAGE-217, a novel neuroactive steroid, which is in Phase III clinical trials for treating PPD, major depressive disorders, bipolar depression, and generalized anxiety disorders; and SAGE-324, a novel compound that is in Phase II clinical trial to treat essential tremors, as well as has completed Phase I clinical trial for epileptiform disorders and Parkinson's diseases. In addition, its product pipeline comprises SAGE-718, an oxysterol-based positive allosteric modulator of the NMDA receptor, which has completed Phase I clinical trial for the treatment of depression, Huntington's disease, Alzheimer's disease, attention deficit hyperactivity disorder, schizophrenia, and neuropathic pain. Further, the company is developing SAGE-904, an oral therapy that is in Phase I clinical trial for disorders associated with NMDA hypofunction; and SAGE-689 for intramuscular administration. Sage Therapeutics, Inc. has a strategic collaboration with Shionogi & Co., Ltd. for the development and commercialization of SAGE-217; Biogen Inc. to develop and commercialize zuranolone (SAGE-217) for various depressive disorder, postpartum depression, and other psychiatric disorders, as well as SAGE-324 for essential tremor and other neurological disorders; and Biogen MA Inc. and Biogen International GmbH for the development, manufacture, and commercialization of products containing SAGE-217 molecule and products containing the SAGE-324 molecule. The company was formerly known as Sterogen Biopharma, Inc. and changed its name to Sage Therapeutics, Inc. in September 2011. Sage Therapeutics, Inc. was founded in 2010 and is headquartered in Cambridge, Massachusetts."
SAGE,2019-12-31,368815000,-680238000,NA,-680238000,345777000,-362347000,-708124000,-708124000,NA,0,6868000,714992000,369215000,27886000,NA,-680238000,-680238000,NA,income_statement,Biotechnology,"Sage Therapeutics, Inc.","Sage Therapeutics, Inc., a biopharmaceutical company, develops and commercializes novel medicines to treat central nervous system (CNS) disorders. Its lead product candidate is ZULRESSO, a proprietary intravenous formulation of brexanolone for the treatment of postpartum depression (PPD). The company's product pipeline also includes SAGE-217, a novel neuroactive steroid, which is in Phase III clinical trials for treating PPD, major depressive disorders, bipolar depression, and generalized anxiety disorders; and SAGE-324, a novel compound that is in Phase II clinical trial to treat essential tremors, as well as has completed Phase I clinical trial for epileptiform disorders and Parkinson's diseases. In addition, its product pipeline comprises SAGE-718, an oxysterol-based positive allosteric modulator of the NMDA receptor, which has completed Phase I clinical trial for the treatment of depression, Huntington's disease, Alzheimer's disease, attention deficit hyperactivity disorder, schizophrenia, and neuropathic pain. Further, the company is developing SAGE-904, an oral therapy that is in Phase I clinical trial for disorders associated with NMDA hypofunction; and SAGE-689 for intramuscular administration. Sage Therapeutics, Inc. has a strategic collaboration with Shionogi & Co., Ltd. for the development and commercialization of SAGE-217; Biogen Inc. to develop and commercialize zuranolone (SAGE-217) for various depressive disorder, postpartum depression, and other psychiatric disorders, as well as SAGE-324 for essential tremor and other neurological disorders; and Biogen MA Inc. and Biogen International GmbH for the development, manufacture, and commercialization of products containing SAGE-217 molecule and products containing the SAGE-324 molecule. The company was formerly known as Sterogen Biopharma, Inc. and changed its name to Sage Therapeutics, Inc. in September 2011. Sage Therapeutics, Inc. was founded in 2010 and is headquartered in Cambridge, Massachusetts."
SAIA,2017-12-31,NA,89751000,NA,91129000,NA,262121000,94527000,94527000,-5051000,-1378000,1404703000,1310176000,1142582000,-4776000,NA,91129000,91129000,80492000,income_statement,Trucking,"Saia, Inc.","Saia, Inc., through its subsidiaries, operates as a transportation company in North America. The company provides regional and interregional less-than-truckload services for shipments between 100 and 10,000 pounds; and other value-added services, including non-asset truckload, expedited, and logistics services. As of March 3, 2020, it operated 169 terminals in 44 states. The company was formerly known as SCS Transportation, Inc. and changed its name to Saia, Inc. in July 2006. Saia, Inc. was founded in 1924 and is headquartered in Johns Creek, Georgia."
SAIA,2018-12-31,NA,135833000,NA,104981000,NA,332223000,141556000,141556000,-5418000,30852000,1653849000,1512293000,1321626000,-5723000,NA,104981000,104981000,88514000,income_statement,Trucking,"Saia, Inc.","Saia, Inc., through its subsidiaries, operates as a transportation company in North America. The company provides regional and interregional less-than-truckload services for shipments between 100 and 10,000 pounds; and other value-added services, including non-asset truckload, expedited, and logistics services. As of March 3, 2020, it operated 169 terminals in 44 states. The company was formerly known as SCS Transportation, Inc. and changed its name to Saia, Inc. in July 2006. Saia, Inc. was founded in 1924 and is headquartered in Johns Creek, Georgia."
SAIA,2019-12-31,NA,146652000,NA,113719000,NA,368788000,152183000,152183000,-6688000,32933000,1786735000,1634552000,1417947000,-5531000,NA,113719000,113719000,97470000,income_statement,Trucking,"Saia, Inc.","Saia, Inc., through its subsidiaries, operates as a transportation company in North America. The company provides regional and interregional less-than-truckload services for shipments between 100 and 10,000 pounds; and other value-added services, including non-asset truckload, expedited, and logistics services. As of March 3, 2020, it operated 169 terminals in 44 states. The company was formerly known as SCS Transportation, Inc. and changed its name to Saia, Inc. in July 2006. Saia, Inc. was founded in 1924 and is headquartered in Johns Creek, Georgia."
SAIA,2020-12-31,NA,176278000,NA,138340000,NA,418503000,177793000,177793000,-5177000,37938000,1822366000,1644573000,1403863000,-1515000,NA,138340000,138340000,106055000,income_statement,Trucking,"Saia, Inc.","Saia, Inc., through its subsidiaries, operates as a transportation company in North America. The company provides regional and interregional less-than-truckload services for shipments between 100 and 10,000 pounds; and other value-added services, including non-asset truckload, expedited, and logistics services. As of March 3, 2020, it operated 169 terminals in 44 states. The company was formerly known as SCS Transportation, Inc. and changed its name to Saia, Inc. in July 2006. Saia, Inc. was founded in 1924 and is headquartered in Johns Creek, Georgia."
SAL,2017-12-31,NA,9170000,NA,6256000,24082000,38476000,0,12356000,NA,2914000,38476000,26120000,0,-3186000,NA,6256000,6201000,2038000,income_statement,Banks—Regional,"Salisbury Bancorp, Inc.","Salisbury Bancorp, Inc. operates as the bank holding company for Salisbury Bank and Trust Company that provides commercial banking, consumer financing, retail banking, and trust and wealth advisory services. It offers various retail and commercial deposit products. The company also provides loans, such as residential and commercial real estate loans; construction loans; commercial loans; and consumer loans, including home equity loans and lines of credit, and auto and personal installment loans. In addition, it offers a range of fiduciary services, including trust and estate administration, wealth advisory, and investment management services to individuals, families, businesses, and institutions. Further, the company provides additional depositor related services consisting of landlord/tenant lease security accounts and services, merchant services, payroll services, ATM services, bank-by-phone services, Internet banking services, Internet bill pay services, person to person payments, bank to bank transfers, mobile banking services with remote deposit, and Online financial management with account aggregation services, as well as cash management services, including remote deposit capture, ACH origination, wire transfers, and positive pay services. It operates through a network of fourteen banking offices and ten ATMs located in Litchfield County, Connecticut; Dutchess, Orange, and Ulster Counties, New York; and Berkshire County, Massachusetts. Salisbury Bancorp, Inc. was founded in 1998 and is headquartered in Lakeville, Connecticut."
SAL,2018-12-31,NA,10533000,NA,8824000,25722000,40027000,0,12344000,NA,1709000,40027000,27683000,0,-1811000,NA,8824000,8713000,1961000,income_statement,Banks—Regional,"Salisbury Bancorp, Inc.","Salisbury Bancorp, Inc. operates as the bank holding company for Salisbury Bank and Trust Company that provides commercial banking, consumer financing, retail banking, and trust and wealth advisory services. It offers various retail and commercial deposit products. The company also provides loans, such as residential and commercial real estate loans; construction loans; commercial loans; and consumer loans, including home equity loans and lines of credit, and auto and personal installment loans. In addition, it offers a range of fiduciary services, including trust and estate administration, wealth advisory, and investment management services to individuals, families, businesses, and institutions. Further, the company provides additional depositor related services consisting of landlord/tenant lease security accounts and services, merchant services, payroll services, ATM services, bank-by-phone services, Internet banking services, Internet bill pay services, person to person payments, bank to bank transfers, mobile banking services with remote deposit, and Online financial management with account aggregation services, as well as cash management services, including remote deposit capture, ACH origination, wire transfers, and positive pay services. It operates through a network of fourteen banking offices and ten ATMs located in Litchfield County, Connecticut; Dutchess, Orange, and Ulster Counties, New York; and Berkshire County, Massachusetts. Salisbury Bancorp, Inc. was founded in 1998 and is headquartered in Lakeville, Connecticut."
SAL,2019-12-31,NA,13495000,NA,11136000,25481000,42407000,0,14988000,NA,2359000,42407000,27419000,0,-1493000,NA,11136000,10976000,1938000,income_statement,Banks—Regional,"Salisbury Bancorp, Inc.","Salisbury Bancorp, Inc. operates as the bank holding company for Salisbury Bank and Trust Company that provides commercial banking, consumer financing, retail banking, and trust and wealth advisory services. It offers various retail and commercial deposit products. The company also provides loans, such as residential and commercial real estate loans; construction loans; commercial loans; and consumer loans, including home equity loans and lines of credit, and auto and personal installment loans. In addition, it offers a range of fiduciary services, including trust and estate administration, wealth advisory, and investment management services to individuals, families, businesses, and institutions. Further, the company provides additional depositor related services consisting of landlord/tenant lease security accounts and services, merchant services, payroll services, ATM services, bank-by-phone services, Internet banking services, Internet bill pay services, person to person payments, bank to bank transfers, mobile banking services with remote deposit, and Online financial management with account aggregation services, as well as cash management services, including remote deposit capture, ACH origination, wire transfers, and positive pay services. It operates through a network of fourteen banking offices and ten ATMs located in Litchfield County, Connecticut; Dutchess, Orange, and Ulster Counties, New York; and Berkshire County, Massachusetts. Salisbury Bancorp, Inc. was founded in 1998 and is headquartered in Lakeville, Connecticut."
SAL,2020-12-31,NA,14393000,NA,11940000,25905000,42830000,0,14902000,NA,2453000,42830000,27928000,0,-509000,NA,11940000,11775000,2023000,income_statement,Banks—Regional,"Salisbury Bancorp, Inc.","Salisbury Bancorp, Inc. operates as the bank holding company for Salisbury Bank and Trust Company that provides commercial banking, consumer financing, retail banking, and trust and wealth advisory services. It offers various retail and commercial deposit products. The company also provides loans, such as residential and commercial real estate loans; construction loans; commercial loans; and consumer loans, including home equity loans and lines of credit, and auto and personal installment loans. In addition, it offers a range of fiduciary services, including trust and estate administration, wealth advisory, and investment management services to individuals, families, businesses, and institutions. Further, the company provides additional depositor related services consisting of landlord/tenant lease security accounts and services, merchant services, payroll services, ATM services, bank-by-phone services, Internet banking services, Internet bill pay services, person to person payments, bank to bank transfers, mobile banking services with remote deposit, and Online financial management with account aggregation services, as well as cash management services, including remote deposit capture, ACH origination, wire transfers, and positive pay services. It operates through a network of fourteen banking offices and ten ATMs located in Litchfield County, Connecticut; Dutchess, Orange, and Ulster Counties, New York; and Berkshire County, Massachusetts. Salisbury Bancorp, Inc. was founded in 1998 and is headquartered in Lakeville, Connecticut."
SALM,2016-12-31,NA,13445000,NA,8873000,14494000,66039000,34269000,34269000,-14653000,4572000,274321000,240052000,208282000,-20824000,NA,8873000,8873000,NA,income_statement,Broadcasting,"Salem Media Group, Inc.","Salem Media Group, Inc. operates as a multimedia company in the United States. It operates through three segments: Broadcast, Digital Media, and Publishing. The company owns and operates radio networks, which produce and distribute talk, news, Website, satellite services, and music networking to radio stations, as well as sells commercial airtime. It also provides Christian, conservative, investing and health-themed content, e-commerce, audio and video streaming, and other resources digitally through Christian content Websites, including BibleStudyTools.com, Crosswalk.com, GodVine.com, iBelieve.com, GodTube.com, OnePlace.com, Christianity.com, GodUpdates.com, CrossCards.com, ChristianHeadlines.com, LightSource.com, AllCreated.com, ChristianRadio.com, CCMmagazine.com, SingingNews.com, and SouthernGospel.com; and conservative opinion Websites, such as Townhall.com, HotAir.com, Twitchy.com, RedState.com, BearingArms.com, ConservativeRadio.com, and pjmedia.com. In addition, the company publishes digital newsletters that provide market analysis and non-individualized investment strategies; and operates Church product Websites comprising SermonSearch.com, ChurchStaffing.com, WorshipHouseMedia.com, SermonSpice.com, WorshipHouseKids.com, Preaching.com, ChristianJobs.com, Youthworker.com, Childrens-Ministry-Deals.com, JourneyBoxMedia.com, and Playblackmedia.com that offer resources to churches and ministries. Further, it offers publication of conservative, Christian, and history books; Xulon Press, a print-on-demand self-publishing service; and Mill City Press that publishes books, as well as Singing News print magazine. The company was formerly known as Salem Communications Corporation and changed its name to Salem Media Group, Inc. in February 2015. Salem Media Group, Inc. was founded in 1986 and is headquartered in Camarillo, California."
SALM,2017-12-31,NA,3774000,NA,24644000,16155000,60092000,26975000,26975000,-16349000,-20870000,263736000,236761000,203644000,-23201000,NA,24644000,24644000,NA,income_statement,Broadcasting,"Salem Media Group, Inc.","Salem Media Group, Inc. operates as a multimedia company in the United States. It operates through three segments: Broadcast, Digital Media, and Publishing. The company owns and operates radio networks, which produce and distribute talk, news, Website, satellite services, and music networking to radio stations, as well as sells commercial airtime. It also provides Christian, conservative, investing and health-themed content, e-commerce, audio and video streaming, and other resources digitally through Christian content Websites, including BibleStudyTools.com, Crosswalk.com, GodVine.com, iBelieve.com, GodTube.com, OnePlace.com, Christianity.com, GodUpdates.com, CrossCards.com, ChristianHeadlines.com, LightSource.com, AllCreated.com, ChristianRadio.com, CCMmagazine.com, SingingNews.com, and SouthernGospel.com; and conservative opinion Websites, such as Townhall.com, HotAir.com, Twitchy.com, RedState.com, BearingArms.com, ConservativeRadio.com, and pjmedia.com. In addition, the company publishes digital newsletters that provide market analysis and non-individualized investment strategies; and operates Church product Websites comprising SermonSearch.com, ChurchStaffing.com, WorshipHouseMedia.com, SermonSpice.com, WorshipHouseKids.com, Preaching.com, ChristianJobs.com, Youthworker.com, Childrens-Ministry-Deals.com, JourneyBoxMedia.com, and Playblackmedia.com that offer resources to churches and ministries. Further, it offers publication of conservative, Christian, and history books; Xulon Press, a print-on-demand self-publishing service; and Mill City Press that publishes books, as well as Singing News print magazine. The company was formerly known as Salem Communications Corporation and changed its name to Salem Media Group, Inc. in February 2015. Salem Media Group, Inc. was founded in 1986 and is headquartered in Camarillo, California."
SALM,2018-12-31,NA,-719000,NA,-3192000,15486000,58477000,24765000,24765000,-18328000,2473000,262783000,238018000,204306000,-25484000,NA,-3192000,-3192000,NA,income_statement,Broadcasting,"Salem Media Group, Inc.","Salem Media Group, Inc. operates as a multimedia company in the United States. It operates through three segments: Broadcast, Digital Media, and Publishing. The company owns and operates radio networks, which produce and distribute talk, news, Website, satellite services, and music networking to radio stations, as well as sells commercial airtime. It also provides Christian, conservative, investing and health-themed content, e-commerce, audio and video streaming, and other resources digitally through Christian content Websites, including BibleStudyTools.com, Crosswalk.com, GodVine.com, iBelieve.com, GodTube.com, OnePlace.com, Christianity.com, GodUpdates.com, CrossCards.com, ChristianHeadlines.com, LightSource.com, AllCreated.com, ChristianRadio.com, CCMmagazine.com, SingingNews.com, and SouthernGospel.com; and conservative opinion Websites, such as Townhall.com, HotAir.com, Twitchy.com, RedState.com, BearingArms.com, ConservativeRadio.com, and pjmedia.com. In addition, the company publishes digital newsletters that provide market analysis and non-individualized investment strategies; and operates Church product Websites comprising SermonSearch.com, ChurchStaffing.com, WorshipHouseMedia.com, SermonSpice.com, WorshipHouseKids.com, Preaching.com, ChristianJobs.com, Youthworker.com, Childrens-Ministry-Deals.com, JourneyBoxMedia.com, and Playblackmedia.com that offer resources to churches and ministries. Further, it offers publication of conservative, Christian, and history books; Xulon Press, a print-on-demand self-publishing service; and Mill City Press that publishes books, as well as Singing News print magazine. The company was formerly known as Salem Communications Corporation and changed its name to Salem Media Group, Inc. in February 2015. Salem Media Group, Inc. was founded in 1986 and is headquartered in Camarillo, California."
SALM,2019-12-31,NA,-23862000,NA,-27839000,15840000,51310000,19536000,19536000,-17496000,3977000,253898000,234362000,202588000,-43398000,NA,-27839000,-27839000,NA,income_statement,Broadcasting,"Salem Media Group, Inc.","Salem Media Group, Inc. operates as a multimedia company in the United States. It operates through three segments: Broadcast, Digital Media, and Publishing. The company owns and operates radio networks, which produce and distribute talk, news, Website, satellite services, and music networking to radio stations, as well as sells commercial airtime. It also provides Christian, conservative, investing and health-themed content, e-commerce, audio and video streaming, and other resources digitally through Christian content Websites, including BibleStudyTools.com, Crosswalk.com, GodVine.com, iBelieve.com, GodTube.com, OnePlace.com, Christianity.com, GodUpdates.com, CrossCards.com, ChristianHeadlines.com, LightSource.com, AllCreated.com, ChristianRadio.com, CCMmagazine.com, SingingNews.com, and SouthernGospel.com; and conservative opinion Websites, such as Townhall.com, HotAir.com, Twitchy.com, RedState.com, BearingArms.com, ConservativeRadio.com, and pjmedia.com. In addition, the company publishes digital newsletters that provide market analysis and non-individualized investment strategies; and operates Church product Websites comprising SermonSearch.com, ChurchStaffing.com, WorshipHouseMedia.com, SermonSpice.com, WorshipHouseKids.com, Preaching.com, ChristianJobs.com, Youthworker.com, Childrens-Ministry-Deals.com, JourneyBoxMedia.com, and Playblackmedia.com that offer resources to churches and ministries. Further, it offers publication of conservative, Christian, and history books; Xulon Press, a print-on-demand self-publishing service; and Mill City Press that publishes books, as well as Singing News print magazine. The company was formerly known as Salem Communications Corporation and changed its name to Salem Media Group, Inc. in February 2015. Salem Media Group, Inc. was founded in 1986 and is headquartered in Camarillo, California."
SAMG,2016-12-31,NA,14668000,18779000,5015000,16465000,31253000,14788000,14788000,-228000,4686000,80262000,65474000,49009000,-120000,NA,9982000,5015000,NA,income_statement,Asset Management,Silvercrest Asset Management Gr,"Silvercrest Asset Management Group Inc., a wealth management firm, provides financial advisory and related family office services in the United States. The company serves ultra-high net worth individuals and families, as well as their trusts; endowments; foundations; and other institutional investors. It also manages funds of funds and other investment funds. The company was founded in 2002 and is headquartered in New York, New York."
SAMG,2017-12-31,NA,26265000,23024000,5337000,16884000,37215000,20331000,20331000,-112000,13734000,91358000,71027000,54143000,5934000,NA,12531000,5337000,NA,income_statement,Asset Management,Silvercrest Asset Management Gr,"Silvercrest Asset Management Group Inc., a wealth management firm, provides financial advisory and related family office services in the United States. The company serves ultra-high net worth individuals and families, as well as their trusts; endowments; foundations; and other institutional investors. It also manages funds of funds and other investment funds. The company was founded in 2002 and is headquartered in New York, New York."
SAMG,2018-12-31,NA,22826000,26352000,9630000,19477000,40735000,21258000,21258000,-62000,5458000,98673000,77415000,57938000,1568000,NA,17368000,9630000,NA,income_statement,Asset Management,Silvercrest Asset Management Gr,"Silvercrest Asset Management Group Inc., a wealth management firm, provides financial advisory and related family office services in the United States. The company serves ultra-high net worth individuals and families, as well as their trusts; endowments; foundations; and other institutional investors. It also manages funds of funds and other investment funds. The company was founded in 2002 and is headquartered in New York, New York."
SAMG,2019-12-31,NA,20590000,32771000,8646000,21987000,42114000,20127000,20127000,-481000,5178000,102152000,82025000,60038000,463000,NA,15412000,8646000,NA,income_statement,Asset Management,Silvercrest Asset Management Gr,"Silvercrest Asset Management Group Inc., a wealth management firm, provides financial advisory and related family office services in the United States. The company serves ultra-high net worth individuals and families, as well as their trusts; endowments; foundations; and other institutional investors. It also manages funds of funds and other investment funds. The company was founded in 2002 and is headquartered in New York, New York."
SANM,2017-09-30,33716000,213480000,NA,138833000,251568000,519911000,227806000,227806000,-21934000,74647000,6868619000,6640813000,6348708000,-14326000,NA,138833000,138833000,6821000,income_statement,Electronic Components,Sanmina Corporation,"Sanmina Corporation provides integrated manufacturing solutions, components, products and repair, logistics, and after-market services worldwide. It operates in two businesses, Integrated Manufacturing Solutions; and Components, Products and Services. The company offers product design and engineering, including concept development, detailed design, prototyping, validation, preproduction, manufacturing design release, and product industrialization; manufacturing of components, subassemblies, and complete systems; high-level assembly and test services; direct order fulfillment and logistics services; after-market product service and support; and supply chain management services. It also provides interconnect systems, such as printed circuit board fabrication, backplane, cable assemblies, and plastic injection moldings; mechanical systems comprising enclosures and precision machining; memory, enterprise, radio frequency, optical, and microelectronic solutions; defense and aerospace products; and cloud-based manufacturing execution software. The company sells its products and services primarily to original equipment manufacturers that serve the industrial, medical, defense and aerospace, automotive, communications networks, and cloud solutions industries. The company was formerly known as Sanmina-SCI Corporation and changed its name to Sanmina Corporation in November 2012. Sanmina Corporation was founded in 1980 and is headquartered in San Jose, California."
SANM,2018-09-29,30754000,97539000,NA,-95533000,250924000,463783000,179197000,179197000,-27734000,193072000,7110130000,6930933000,6646347000,-81658000,NA,-95533000,-95533000,2908000,income_statement,Electronic Components,Sanmina Corporation,"Sanmina Corporation provides integrated manufacturing solutions, components, products and repair, logistics, and after-market services worldwide. It operates in two businesses, Integrated Manufacturing Solutions; and Components, Products and Services. The company offers product design and engineering, including concept development, detailed design, prototyping, validation, preproduction, manufacturing design release, and product industrialization; manufacturing of components, subassemblies, and complete systems; high-level assembly and test services; direct order fulfillment and logistics services; after-market product service and support; and supply chain management services. It also provides interconnect systems, such as printed circuit board fabrication, backplane, cable assemblies, and plastic injection moldings; mechanical systems comprising enclosures and precision machining; memory, enterprise, radio frequency, optical, and microelectronic solutions; defense and aerospace products; and cloud-based manufacturing execution software. The company sells its products and services primarily to original equipment manufacturers that serve the industrial, medical, defense and aerospace, automotive, communications networks, and cloud solutions industries. The company was formerly known as Sanmina-SCI Corporation and changed its name to Sanmina Corporation in November 2012. Sanmina Corporation was founded in 1980 and is headquartered in San Jose, California."
SANM,2019-09-28,27552000,245619000,NA,141515000,260032000,591938000,299870000,299870000,-30763000,104104000,8233859000,7933989000,7641921000,-54251000,NA,141515000,141515000,4484000,income_statement,Electronic Components,Sanmina Corporation,"Sanmina Corporation provides integrated manufacturing solutions, components, products and repair, logistics, and after-market services worldwide. It operates in two businesses, Integrated Manufacturing Solutions; and Components, Products and Services. The company offers product design and engineering, including concept development, detailed design, prototyping, validation, preproduction, manufacturing design release, and product industrialization; manufacturing of components, subassemblies, and complete systems; high-level assembly and test services; direct order fulfillment and logistics services; after-market product service and support; and supply chain management services. It also provides interconnect systems, such as printed circuit board fabrication, backplane, cable assemblies, and plastic injection moldings; mechanical systems comprising enclosures and precision machining; memory, enterprise, radio frequency, optical, and microelectronic solutions; defense and aerospace products; and cloud-based manufacturing execution software. The company sells its products and services primarily to original equipment manufacturers that serve the industrial, medical, defense and aerospace, automotive, communications networks, and cloud solutions industries. The company was formerly known as Sanmina-SCI Corporation and changed its name to Sanmina Corporation in November 2012. Sanmina Corporation was founded in 1980 and is headquartered in San Jose, California."
SANM,2020-10-03,22564000,200758000,NA,139713000,240931000,525707000,263079000,263079000,-28903000,61045000,6960370000,6697291000,6434663000,-62321000,NA,139713000,139713000,-867000,income_statement,Electronic Components,Sanmina Corporation,"Sanmina Corporation provides integrated manufacturing solutions, components, products and repair, logistics, and after-market services worldwide. It operates in two businesses, Integrated Manufacturing Solutions; and Components, Products and Services. The company offers product design and engineering, including concept development, detailed design, prototyping, validation, preproduction, manufacturing design release, and product industrialization; manufacturing of components, subassemblies, and complete systems; high-level assembly and test services; direct order fulfillment and logistics services; after-market product service and support; and supply chain management services. It also provides interconnect systems, such as printed circuit board fabrication, backplane, cable assemblies, and plastic injection moldings; mechanical systems comprising enclosures and precision machining; memory, enterprise, radio frequency, optical, and microelectronic solutions; defense and aerospace products; and cloud-based manufacturing execution software. The company sells its products and services primarily to original equipment manufacturers that serve the industrial, medical, defense and aerospace, automotive, communications networks, and cloud solutions industries. The company was formerly known as Sanmina-SCI Corporation and changed its name to Sanmina Corporation in November 2012. Sanmina Corporation was founded in 1980 and is headquartered in San Jose, California."
SANW,2017-06-30,3032112,-4194337,-47685,-11822042,11794026,16140964,-2010917,-2010917,-2500968,7627705,75373810,77384727,59232846,-2183420,NA,-11822042,-11822042,NA,income_statement,Farm Products,S&W Seed Company,"S&W Seed Company, an agricultural company, engages in breeding, growing, processing, and selling alfalfa and sorghum seeds. It also offers sunflower, wheat germplasm, wheat, and pasture seeds. The company sells its seeds to distributors and dealers in 40 countries. S&W Seed Company was founded in 1980 and is headquartered in Longmont, Colorado."
SANW,2018-06-30,3887723,-4582041,-47685,-4725090,10503020,14753458,-3076572,-3076572,-2032333,143049,64085510,67162082,49332052,-1505469,NA,-4725090,-4725090,NA,income_statement,Farm Products,S&W Seed Company,"S&W Seed Company, an agricultural company, engages in breeding, growing, processing, and selling alfalfa and sorghum seeds. It also offers sunflower, wheat germplasm, wheat, and pasture seeds. The company sells its seeds to distributors and dealers in 40 countries. S&W Seed Company was founded in 1980 and is headquartered in Longmont, Colorado."
SANW,2019-06-30,6272758,-9501674,-47685,-9305242,16289595,40708021,14017122,14017122,-3226924,-148747,109722511,95705389,69014490,-23518796,NA,-9352927,-9305242,NA,income_statement,Farm Products,S&W Seed Company,"S&W Seed Company, an agricultural company, engages in breeding, growing, processing, and selling alfalfa and sorghum seeds. It also offers sunflower, wheat germplasm, wheat, and pasture seeds. The company sells its seeds to distributors and dealers in 40 countries. S&W Seed Company was founded in 1980 and is headquartered in Longmont, Colorado."
SANW,2020-06-30,7127614,-19361130,-120459,-19674324,21080778,14934262,-18310594,-18310594,-2525931,385968,79582198,97892792,64647936,-1050536,NA,-19747098,-19674324,NA,income_statement,Farm Products,S&W Seed Company,"S&W Seed Company, an agricultural company, engages in breeding, growing, processing, and selling alfalfa and sorghum seeds. It also offers sunflower, wheat germplasm, wheat, and pasture seeds. The company sells its seeds to distributors and dealers in 40 countries. S&W Seed Company was founded in 1980 and is headquartered in Longmont, Colorado."
SASR,2017-12-31,NA,87935000,NA,53209000,106297000,217034000,0,96868000,NA,34726000,217034000,120166000,0,-8933000,NA,53209000,53209000,13869000,income_statement,Banks—Regional,"Sandy Spring Bancorp, Inc.","Sandy Spring Bancorp, Inc. operates as the bank holding company for Sandy Spring Bank that provides commercial and retail banking, mortgage, private banking, and trust services to individuals and businesses in central Maryland, Northern Virginia, and Washington D.C. The company operates in three segments: Community Banking, Insurance, and Investment Management. The Community Banking segment provides financial products and services, including various loan and deposit products. This segment accepts deposits, such as demand, money market savings, regular savings, and time deposits. Its loan products include residential real estate loans; commercial real estate loans, commercial construction loans, and other commercial loans; and consumer loans comprising home equity loans and lines, installment loans, and personal lines of credit. The Insurance segment provides general insurance agency services and annuities. The Investment Management segment provides investment management and financial planning, including cash flow analysis, investment review, tax and retirement planning, insurance analysis, and estate planning to individuals, families, small businesses, and associations. The company also provides equipment leasing, personal trust, and wealth management services. As of February 16, 2021, it operated through a network of 61 branches. Sandy Spring Bancorp, Inc. was founded in 1868 and is headquartered in Olney, Maryland."
SASR,2018-12-31,NA,132688000,NA,100864000,141268000,310871000,0,150111000,NA,31824000,310871000,160760000,0,-17423000,NA,100864000,100864000,19492000,income_statement,Banks—Regional,"Sandy Spring Bancorp, Inc.","Sandy Spring Bancorp, Inc. operates as the bank holding company for Sandy Spring Bank that provides commercial and retail banking, mortgage, private banking, and trust services to individuals and businesses in central Maryland, Northern Virginia, and Washington D.C. The company operates in three segments: Community Banking, Insurance, and Investment Management. The Community Banking segment provides financial products and services, including various loan and deposit products. This segment accepts deposits, such as demand, money market savings, regular savings, and time deposits. Its loan products include residential real estate loans; commercial real estate loans, commercial construction loans, and other commercial loans; and consumer loans comprising home equity loans and lines, installment loans, and personal lines of credit. The Insurance segment provides general insurance agency services and annuities. The Investment Management segment provides investment management and financial planning, including cash flow analysis, investment review, tax and retirement planning, insurance analysis, and estate planning to individuals, families, small businesses, and associations. The company also provides equipment leasing, personal trust, and wealth management services. As of February 16, 2021, it operated through a network of 61 branches. Sandy Spring Bancorp, Inc. was founded in 1868 and is headquartered in Olney, Maryland."
SASR,2019-12-31,NA,152861000,NA,116433000,153141000,331346000,0,157779000,NA,36428000,331346000,173567000,0,-4918000,NA,116433000,116433000,20426000,income_statement,Banks—Regional,"Sandy Spring Bancorp, Inc.","Sandy Spring Bancorp, Inc. operates as the bank holding company for Sandy Spring Bank that provides commercial and retail banking, mortgage, private banking, and trust services to individuals and businesses in central Maryland, Northern Virginia, and Washington D.C. The company operates in three segments: Community Banking, Insurance, and Investment Management. The Community Banking segment provides financial products and services, including various loan and deposit products. This segment accepts deposits, such as demand, money market savings, regular savings, and time deposits. Its loan products include residential real estate loans; commercial real estate loans, commercial construction loans, and other commercial loans; and consumer loans comprising home equity loans and lines, installment loans, and personal lines of credit. The Insurance segment provides general insurance agency services and annuities. The Investment Management segment provides investment management and financial planning, including cash flow analysis, investment review, tax and retirement planning, insurance analysis, and estate planning to individuals, families, small businesses, and associations. The company also provides equipment leasing, personal trust, and wealth management services. As of February 16, 2021, it operated through a network of 61 branches. Sandy Spring Bancorp, Inc. was founded in 1868 and is headquartered in Olney, Maryland."
SASR,2020-12-31,NA,124424000,NA,96953000,189057000,380206000,0,160546000,NA,27471000,380206000,219660000,0,-36122000,NA,96953000,96953000,30603000,income_statement,Banks—Regional,"Sandy Spring Bancorp, Inc.","Sandy Spring Bancorp, Inc. operates as the bank holding company for Sandy Spring Bank that provides commercial and retail banking, mortgage, private banking, and trust services to individuals and businesses in central Maryland, Northern Virginia, and Washington D.C. The company operates in three segments: Community Banking, Insurance, and Investment Management. The Community Banking segment provides financial products and services, including various loan and deposit products. This segment accepts deposits, such as demand, money market savings, regular savings, and time deposits. Its loan products include residential real estate loans; commercial real estate loans, commercial construction loans, and other commercial loans; and consumer loans comprising home equity loans and lines, installment loans, and personal lines of credit. The Insurance segment provides general insurance agency services and annuities. The Investment Management segment provides investment management and financial planning, including cash flow analysis, investment review, tax and retirement planning, insurance analysis, and estate planning to individuals, families, small businesses, and associations. The company also provides equipment leasing, personal trust, and wealth management services. As of February 16, 2021, it operated through a network of 61 branches. Sandy Spring Bancorp, Inc. was founded in 1868 and is headquartered in Olney, Maryland."
SATS,2016-12-31,31170000,216626000,86740000,179930000,325044000,1085281000,296163000,296163000,-123481000,80254000,1810466000,1514303000,725185000,-79537000,44320000,136372000,181673000,NA,income_statement,Communication Equipment,EchoStar Corporation,"EchoStar Corporation, together with its subsidiaries, provides broadband satellite technologies and broadband Internet services worldwide. It operates in two segments, Hughes and EchoStar Satellite Services (ESS). The Hughes segments offers broadband satellite technologies and Internet services for home and small to medium-sized businesses, and satellite services; and broadband network technologies, managed services, equipment, hardware, satellite services, and communication solutions for aeronautical and government enterprises, as well as consumers. This segment also designs, provides, and installs gateways and terminal equipment for other satellite systems; and provides satellite ground segment systems and terminals to mobile system operators and enterprise customers. The ESS segment provides satellite services using its owned and leased in-orbit satellites and related licenses on a full-time and/or occasional-use basis to the United States government service providers, Internet service providers, broadcast news organizations, content providers, and private enterprise customers. EchoStar Corporation was founded in 2007 and is headquartered in Englewood, Colorado."
SATS,2017-12-31,31745000,-32200000,14822000,392561000,370500000,829231000,41324000,41324000,-184389000,-155107000,1525155000,1483831000,695924000,-73524000,270582000,122907000,393770000,NA,income_statement,Communication Equipment,EchoStar Corporation,"EchoStar Corporation, together with its subsidiaries, provides broadband satellite technologies and broadband Internet services worldwide. It operates in two segments, Hughes and EchoStar Satellite Services (ESS). The Hughes segments offers broadband satellite technologies and Internet services for home and small to medium-sized businesses, and satellite services; and broadband network technologies, managed services, equipment, hardware, satellite services, and communication solutions for aeronautical and government enterprises, as well as consumers. This segment also designs, provides, and installs gateways and terminal equipment for other satellite systems; and provides satellite ground segment systems and terminals to mobile system operators and enterprise customers. The ESS segment provides satellite services using its owned and leased in-orbit satellites and related licenses on a full-time and/or occasional-use basis to the United States government service providers, Internet service providers, broadcast news organizations, content providers, and private enterprise customers. EchoStar Corporation was founded in 2007 and is headquartered in Englewood, Colorado."
SATS,2018-12-31,27570000,-125786000,15275000,-40475000,436088000,1022131000,101357000,101357000,-219288000,6576000,1762638000,1661281000,740507000,-227143000,93729000,-132362000,-40475000,NA,income_statement,Communication Equipment,EchoStar Corporation,"EchoStar Corporation, together with its subsidiaries, provides broadband satellite technologies and broadband Internet services worldwide. It operates in two segments, Hughes and EchoStar Satellite Services (ESS). The Hughes segments offers broadband satellite technologies and Internet services for home and small to medium-sized businesses, and satellite services; and broadband network technologies, managed services, equipment, hardware, satellite services, and communication solutions for aeronautical and government enterprises, as well as consumers. This segment also designs, provides, and installs gateways and terminal equipment for other satellite systems; and provides satellite ground segment systems and terminals to mobile system operators and enterprise customers. The ESS segment provides satellite services using its owned and leased in-orbit satellites and related licenses on a full-time and/or occasional-use basis to the United States government service providers, Internet service providers, broadcast news organizations, content providers, and private enterprise customers. EchoStar Corporation was founded in 2007 and is headquartered in Englewood, Colorado."
SATS,2019-12-31,25739000,-93165000,75748000,-62917000,509145000,1098726000,73077000,73077000,-251016000,20488000,1886081000,1813004000,787355000,-166242000,39401000,-113653000,-62917000,NA,income_statement,Communication Equipment,EchoStar Corporation,"EchoStar Corporation, together with its subsidiaries, provides broadband satellite technologies and broadband Internet services worldwide. It operates in two segments, Hughes and EchoStar Satellite Services (ESS). The Hughes segments offers broadband satellite technologies and Internet services for home and small to medium-sized businesses, and satellite services; and broadband network technologies, managed services, equipment, hardware, satellite services, and communication solutions for aeronautical and government enterprises, as well as consumers. This segment also designs, provides, and installs gateways and terminal equipment for other satellite systems; and provides satellite ground segment systems and terminals to mobile system operators and enterprise customers. The ESS segment provides satellite services using its owned and leased in-orbit satellites and related licenses on a full-time and/or occasional-use basis to the United States government service providers, Internet service providers, broadcast news organizations, content providers, and private enterprise customers. EchoStar Corporation was founded in 2007 and is headquartered in Englewood, Colorado."
SAVA,2016-12-31,1568000,-14850000,NA,-14850000,5781000,-9176000,-14957000,-14957000,NA,0,0,14957000,9176000,107000,NA,-14850000,-14850000,NA,income_statement,Biotechnology,"Cassava Sciences, Inc.","Cassava Sciences, Inc., a clinical stage biotechnology company, develops drugs for nervous system disorders. Its lead therapeutic product candidate is PTI-125, a small molecule drug, which is completed Phase 2b clinical trial; and investigational diagnostic product candidate is SavaDx, a blood-based biomarker/diagnostic to detect Alzheimer's disease. The company was formerly known as Pain Therapeutics, Inc. and changed its name to Cassava Sciences, Inc. in March 2019. Cassava Sciences, Inc. was founded in 1998 and is based in Austin, Texas."
SAVA,2017-12-31,1568000,-11911000,NA,-11911000,4334000,-7615000,-11949000,-11949000,NA,0,0,11949000,7615000,38000,NA,-11911000,-11911000,NA,income_statement,Biotechnology,"Cassava Sciences, Inc.","Cassava Sciences, Inc., a clinical stage biotechnology company, develops drugs for nervous system disorders. Its lead therapeutic product candidate is PTI-125, a small molecule drug, which is completed Phase 2b clinical trial; and investigational diagnostic product candidate is SavaDx, a blood-based biomarker/diagnostic to detect Alzheimer's disease. The company was formerly known as Pain Therapeutics, Inc. and changed its name to Cassava Sciences, Inc. in March 2019. Cassava Sciences, Inc. was founded in 1998 and is based in Austin, Texas."
SAVA,2018-12-31,1568000,-6557000,NA,-6557000,3693000,-2969000,-6662000,-6662000,NA,0,0,6662000,2969000,105000,NA,-6557000,-6557000,NA,income_statement,Biotechnology,"Cassava Sciences, Inc.","Cassava Sciences, Inc., a clinical stage biotechnology company, develops drugs for nervous system disorders. Its lead therapeutic product candidate is PTI-125, a small molecule drug, which is completed Phase 2b clinical trial; and investigational diagnostic product candidate is SavaDx, a blood-based biomarker/diagnostic to detect Alzheimer's disease. The company was formerly known as Pain Therapeutics, Inc. and changed its name to Cassava Sciences, Inc. in March 2019. Cassava Sciences, Inc. was founded in 1998 and is based in Austin, Texas."
SAVA,2019-12-31,1568000,-4631000,NA,-4631000,3391000,-1568000,-4959000,-4959000,NA,0,0,4959000,1568000,328000,NA,-4631000,-4631000,NA,income_statement,Biotechnology,"Cassava Sciences, Inc.","Cassava Sciences, Inc., a clinical stage biotechnology company, develops drugs for nervous system disorders. Its lead therapeutic product candidate is PTI-125, a small molecule drug, which is completed Phase 2b clinical trial; and investigational diagnostic product candidate is SavaDx, a blood-based biomarker/diagnostic to detect Alzheimer's disease. The company was formerly known as Pain Therapeutics, Inc. and changed its name to Cassava Sciences, Inc. in March 2019. Cassava Sciences, Inc. was founded in 1998 and is based in Austin, Texas."
SBAC,2016-12-31,NA,87303000,16052000,76238000,125206000,1199088000,429418000,429418000,-352510000,11065000,1633125000,1203707000,434037000,-342115000,NA,76238000,76238000,6275000,income_statement,NA,NA,NA
SBAC,2017-12-31,NA,116891000,16052000,103654000,130697000,1268995000,490751000,490751000,-348568000,13237000,1727674000,1236923000,458679000,-373860000,NA,103654000,103654000,4447000,income_statement,NA,NA,NA
SBAC,2018-12-31,NA,51684000,16052000,47451000,141724000,1385939000,569311000,569311000,-399146000,4233000,1865695000,1296384000,479756000,-517627000,NA,47451000,47451000,2791000,income_statement,NA,NA,NA
SBAC,2019-12-31,NA,186889000,16052000,146991000,191774000,1506386000,613437000,613437000,-415695000,39605000,2014645000,1401208000,508259000,-426548000,NA,147284000,146991000,4097000,income_statement,NA,NA,NA
SBBP,2016-12-31,20023000,-51357000,NA,-48597000,14875000,0,-34898000,-34898000,-20000,-2638000,0,34898000,0,-16459000,NA,-48719000,-48597000,NA,income_statement,Biotechnology,Strongbridge Biopharma plc,"Strongbridge Biopharma plc, a commercial-stage biopharmaceutical company, focuses on the development and commercialization of therapies for rare diseases with unmet needs. The company offers Keveyis, an oral carbonic anhydrase inhibitor for treating hyperkalemic, hypokalemic, and related variants of primary periodic paralysis in the United States. Its clinical-stage product candidates include Recorlev, a cortisol synthesis inhibitor, which is in a Phase III clinical trials that for the treatment of endogenous Cushing's syndrome; and Veldoreotide, a somatostatin analog that completed Phase II clinical trial for the treatment of acromegaly. The company was formerly known as Cortendo plc and changed its name to Strongbridge Biopharma plc in September 2015. Strongbridge Biopharma plc was founded in 1996 and is headquartered in Trevose, Pennsylvania."
SBBP,2017-12-31,17268000,-111712000,NA,-113483000,36292000,5563000,-53019000,-53019000,-4313000,1771000,7046000,60065000,1483000,-58693000,NA,-113483000,-113483000,NA,income_statement,Biotechnology,Strongbridge Biopharma plc,"Strongbridge Biopharma plc, a commercial-stage biopharmaceutical company, focuses on the development and commercialization of therapies for rare diseases with unmet needs. The company offers Keveyis, an oral carbonic anhydrase inhibitor for treating hyperkalemic, hypokalemic, and related variants of primary periodic paralysis in the United States. Its clinical-stage product candidates include Recorlev, a cortisol synthesis inhibitor, which is in a Phase III clinical trials that for the treatment of endogenous Cushing's syndrome; and Veldoreotide, a somatostatin analog that completed Phase II clinical trial for the treatment of acromegaly. The company was formerly known as Cortendo plc and changed its name to Strongbridge Biopharma plc in September 2015. Strongbridge Biopharma plc was founded in 1996 and is headquartered in Trevose, Pennsylvania."
SBBP,2018-12-31,25441000,32387000,NA,31851000,63336000,14041000,-81923000,-81923000,-12515000,536000,18027000,99950000,3986000,114310000,NA,31851000,31851000,NA,income_statement,Biotechnology,Strongbridge Biopharma plc,"Strongbridge Biopharma plc, a commercial-stage biopharmaceutical company, focuses on the development and commercialization of therapies for rare diseases with unmet needs. The company offers Keveyis, an oral carbonic anhydrase inhibitor for treating hyperkalemic, hypokalemic, and related variants of primary periodic paralysis in the United States. Its clinical-stage product candidates include Recorlev, a cortisol synthesis inhibitor, which is in a Phase III clinical trials that for the treatment of endogenous Cushing's syndrome; and Veldoreotide, a somatostatin analog that completed Phase II clinical trial for the treatment of acromegaly. The company was formerly known as Cortendo plc and changed its name to Strongbridge Biopharma plc in September 2015. Strongbridge Biopharma plc was founded in 1996 and is headquartered in Trevose, Pennsylvania."
SBBP,2019-12-31,30321000,-47683000,NA,-49451000,45810000,17890000,-63263000,-63263000,NA,1768000,21712000,84975000,3822000,15580000,NA,-49451000,-49451000,NA,income_statement,Biotechnology,Strongbridge Biopharma plc,"Strongbridge Biopharma plc, a commercial-stage biopharmaceutical company, focuses on the development and commercialization of therapies for rare diseases with unmet needs. The company offers Keveyis, an oral carbonic anhydrase inhibitor for treating hyperkalemic, hypokalemic, and related variants of primary periodic paralysis in the United States. Its clinical-stage product candidates include Recorlev, a cortisol synthesis inhibitor, which is in a Phase III clinical trials that for the treatment of endogenous Cushing's syndrome; and Veldoreotide, a somatostatin analog that completed Phase II clinical trial for the treatment of acromegaly. The company was formerly known as Cortendo plc and changed its name to Strongbridge Biopharma plc in September 2015. Strongbridge Biopharma plc was founded in 1996 and is headquartered in Trevose, Pennsylvania."
SBCF,2017-12-31,NA,79201000,NA,42865000,123727000,229117000,0,84588000,NA,36336000,229117000,144529000,0,-7887000,NA,42865000,42865000,15535000,income_statement,Banks—Regional,Seacoast Banking Corporation of,"Seacoast Banking Corporation of Florida operates as the bank holding company for Seacoast National Bank that provides financial services to retail and commercial customers in Florida. The company offers commercial and retail banking, wealth management, and mortgage services; and brokerage and annuity services. It offers deposit products, including interest-bearing and noninterest demand deposits, money market and savings accounts, customer sweep accounts, and time certificates of deposit; construction and land development loans, commercial and residential real estate loans, and commercial and financial loans; and consumer loans, including installment loans and revolving lines, as well as loans for automobiles, boats, and other personal, family, and household purposes. As of October 27, 2020, the company operated 51 traditional branches and 9 commercial banking centers. Seacoast Banking Corporation of Florida was founded in 1926 and is headquartered in Stuart, Florida."
SBCF,2018-12-31,NA,87534000,NA,67275000,128172000,249527000,0,96310000,NA,20259000,249527000,153217000,0,-8776000,NA,67275000,67275000,17222000,income_statement,Banks—Regional,Seacoast Banking Corporation of,"Seacoast Banking Corporation of Florida operates as the bank holding company for Seacoast National Bank that provides financial services to retail and commercial customers in Florida. The company offers commercial and retail banking, wealth management, and mortgage services; and brokerage and annuity services. It offers deposit products, including interest-bearing and noninterest demand deposits, money market and savings accounts, customer sweep accounts, and time certificates of deposit; construction and land development loans, commercial and residential real estate loans, and commercial and financial loans; and consumer loans, including installment loans and revolving lines, as well as loans for automobiles, boats, and other personal, family, and household purposes. As of October 27, 2020, the company operated 51 traditional branches and 9 commercial banking centers. Seacoast Banking Corporation of Florida was founded in 1926 and is headquartered in Stuart, Florida."
SBCF,2019-12-31,NA,128612000,NA,98739000,130461000,288395000,0,135514000,NA,29873000,288395000,152881000,0,-6902000,NA,98739000,98739000,15177000,income_statement,Banks—Regional,Seacoast Banking Corporation of,"Seacoast Banking Corporation of Florida operates as the bank holding company for Seacoast National Bank that provides financial services to retail and commercial customers in Florida. The company offers commercial and retail banking, wealth management, and mortgage services; and brokerage and annuity services. It offers deposit products, including interest-bearing and noninterest demand deposits, money market and savings accounts, customer sweep accounts, and time certificates of deposit; construction and land development loans, commercial and residential real estate loans, and commercial and financial loans; and consumer loans, including installment loans and revolving lines, as well as loans for automobiles, boats, and other personal, family, and household purposes. As of October 27, 2020, the company operated 51 traditional branches and 9 commercial banking centers. Seacoast Banking Corporation of Florida was founded in 1926 and is headquartered in Stuart, Florida."
SBCF,2020-12-31,NA,100582000,NA,77764000,160144000,286134000,0,109970000,NA,22818000,286134000,176164000,0,-9388000,NA,77764000,77764000,16020000,income_statement,Banks—Regional,Seacoast Banking Corporation of,"Seacoast Banking Corporation of Florida operates as the bank holding company for Seacoast National Bank that provides financial services to retail and commercial customers in Florida. The company offers commercial and retail banking, wealth management, and mortgage services; and brokerage and annuity services. It offers deposit products, including interest-bearing and noninterest demand deposits, money market and savings accounts, customer sweep accounts, and time certificates of deposit; construction and land development loans, commercial and residential real estate loans, and commercial and financial loans; and consumer loans, including installment loans and revolving lines, as well as loans for automobiles, boats, and other personal, family, and household purposes. As of October 27, 2020, the company operated 51 traditional branches and 9 commercial banking centers. Seacoast Banking Corporation of Florida was founded in 1926 and is headquartered in Stuart, Florida."
SBFG,2017-12-31,NA,13625000,NA,11065000,29445000,45126000,0,13548000,NA,2560000,45126000,31578000,0,77000,NA,11065000,10077000,2133000,income_statement,Banks—Regional,"SB Financial Group, Inc.","SB Financial Group, Inc., through its subsidiaries, provides a range of commercial banking and wealth management services to individual and corporate customers primarily in Ohio, Indiana, and Michigan. The company offers checking accounts, savings accounts, money market accounts, and time certificates of deposit. It also provides commercial, consumer, agricultural, and residential mortgage loans. In addition, the company offers automatic teller machine, personal and corporate trust, commercial leasing, bank credit card, safe deposit box rental, internet banking, private client group, and other personalized banking services; and various trust and financial services comprising asset management services for individuals and corporate employee benefit plans, as well as brokerage services. Further, it sells insurance products to retail and commercial customers. The company operates a network of 19 banking centers located within the Ohio counties of Allen, Defiance, Franklin, Fulton, Hancock, Lucas, Paulding, Wood, and Williams; 1 banking center located in Allen County, Indiana; and 7 loan production offices located in Cuyahoga, Franklin, Lucas, and Seneca counties, Ohio, as well as Hamilton and Steuben counties, Indiana, and Monroe County, Michigan. The company was formerly known as Rurban Financial Corp. and changed its name to SB Financial Group, Inc. in April 2013. SB Financial Group, Inc. was founded in 1983 and is headquartered in Defiance, Ohio."
SBFG,2018-12-31,NA,14444000,NA,11638000,32142000,49352000,0,14505000,NA,2806000,49352000,34847000,0,-61000,NA,11638000,10648000,2705000,income_statement,Banks—Regional,"SB Financial Group, Inc.","SB Financial Group, Inc., through its subsidiaries, provides a range of commercial banking and wealth management services to individual and corporate customers primarily in Ohio, Indiana, and Michigan. The company offers checking accounts, savings accounts, money market accounts, and time certificates of deposit. It also provides commercial, consumer, agricultural, and residential mortgage loans. In addition, the company offers automatic teller machine, personal and corporate trust, commercial leasing, bank credit card, safe deposit box rental, internet banking, private client group, and other personalized banking services; and various trust and financial services comprising asset management services for individuals and corporate employee benefit plans, as well as brokerage services. Further, it sells insurance products to retail and commercial customers. The company operates a network of 19 banking centers located within the Ohio counties of Allen, Defiance, Franklin, Fulton, Hancock, Lucas, Paulding, Wood, and Williams; 1 banking center located in Allen County, Indiana; and 7 loan production offices located in Cuyahoga, Franklin, Lucas, and Seneca counties, Ohio, as well as Hamilton and Steuben counties, Indiana, and Monroe County, Michigan. The company was formerly known as Rurban Financial Corp. and changed its name to SB Financial Group, Inc. in April 2013. SB Financial Group, Inc. was founded in 1983 and is headquartered in Defiance, Ohio."
SBFG,2019-12-31,NA,14632000,NA,11973000,34440000,53136000,0,15726000,NA,2659000,53136000,37410000,0,-1094000,NA,11973000,11006000,2970000,income_statement,Banks—Regional,"SB Financial Group, Inc.","SB Financial Group, Inc., through its subsidiaries, provides a range of commercial banking and wealth management services to individual and corporate customers primarily in Ohio, Indiana, and Michigan. The company offers checking accounts, savings accounts, money market accounts, and time certificates of deposit. It also provides commercial, consumer, agricultural, and residential mortgage loans. In addition, the company offers automatic teller machine, personal and corporate trust, commercial leasing, bank credit card, safe deposit box rental, internet banking, private client group, and other personalized banking services; and various trust and financial services comprising asset management services for individuals and corporate employee benefit plans, as well as brokerage services. Further, it sells insurance products to retail and commercial customers. The company operates a network of 19 banking centers located within the Ohio counties of Allen, Defiance, Franklin, Fulton, Hancock, Lucas, Paulding, Wood, and Williams; 1 banking center located in Allen County, Indiana; and 7 loan production offices located in Cuyahoga, Franklin, Lucas, and Seneca counties, Ohio, as well as Hamilton and Steuben counties, Indiana, and Monroe County, Michigan. The company was formerly known as Rurban Financial Corp. and changed its name to SB Financial Group, Inc. in April 2013. SB Financial Group, Inc. was founded in 1983 and is headquartered in Defiance, Ohio."
SBFG,2020-12-31,NA,18439000,NA,14944000,39979000,65111000,0,22024000,NA,3495000,65111000,43087000,0,-3585000,NA,14944000,14944000,3108000,income_statement,Banks—Regional,"SB Financial Group, Inc.","SB Financial Group, Inc., through its subsidiaries, provides a range of commercial banking and wealth management services to individual and corporate customers primarily in Ohio, Indiana, and Michigan. The company offers checking accounts, savings accounts, money market accounts, and time certificates of deposit. It also provides commercial, consumer, agricultural, and residential mortgage loans. In addition, the company offers automatic teller machine, personal and corporate trust, commercial leasing, bank credit card, safe deposit box rental, internet banking, private client group, and other personalized banking services; and various trust and financial services comprising asset management services for individuals and corporate employee benefit plans, as well as brokerage services. Further, it sells insurance products to retail and commercial customers. The company operates a network of 19 banking centers located within the Ohio counties of Allen, Defiance, Franklin, Fulton, Hancock, Lucas, Paulding, Wood, and Williams; 1 banking center located in Allen County, Indiana; and 7 loan production offices located in Cuyahoga, Franklin, Lucas, and Seneca counties, Ohio, as well as Hamilton and Steuben counties, Indiana, and Monroe County, Michigan. The company was formerly known as Rurban Financial Corp. and changed its name to SB Financial Group, Inc. in April 2013. SB Financial Group, Inc. was founded in 1983 and is headquartered in Defiance, Ohio."
SBGI,2016-12-31,4085000,372890000,-30047000,245301000,573745000,1454293000,598224000,598224000,-211143000,122128000,2622510000,2024286000,1168217000,-225334000,NA,250762000,245301000,-1000000,income_statement,Broadcasting,"Sinclair Broadcast Group, Inc.","Sinclair Broadcast Group, Inc. operates as a diversified television media company in the United States. The company operates in two segments, Local News and Marketing Services; and Sports. It owns or provides various programming, operating, sales, and other non-programming operating services to television stations. The company broadcasts free over-the-air programming, such as network provided programs, locally-produced news, local sporting events, programming from program service arrangements, syndicated entertainment programs, and internally originated programming to television viewing audiences in the communities through its local television stations. As of December 31, 2019, it owned, operated, and/or provided services to 191 stations in 89 markets, which broadcast 629 channels. The company also owns and operates various networks carried on distribution platforms; and Tennis Channel, a cable network that includes coverage of various tennis' top tournaments and original professional sport, and tennis lifestyle shows. In addition, it owns regional sports network, which has the exclusive rights to air games of 45 professional sports teams and other sporting events. Further, the company offers digital agency services; and provides broadcast related technical services to the broadcast industry, as well as designs and manufactures broadcast systems, including transmitters and antennas. Additionally, it owns various non-media related investments, including private equity, mezzanine financing, and real estate investments. It also offers Tennis Magazine; and operates Tennis.com, an online tennis platform. Sinclair Broadcast Group, Inc. was founded in 1986 and is headquartered in Hunt Valley, Maryland."
SBGI,2017-12-31,10000000,519000000,-34372000,576000000,626000000,1381000000,480000000,480000000,-212000000,-75000000,2636000000,2156000000,1255000000,39000000,NA,594000000,576000000,-1000000,income_statement,Broadcasting,"Sinclair Broadcast Group, Inc.","Sinclair Broadcast Group, Inc. operates as a diversified television media company in the United States. The company operates in two segments, Local News and Marketing Services; and Sports. It owns or provides various programming, operating, sales, and other non-programming operating services to television stations. The company broadcasts free over-the-air programming, such as network provided programs, locally-produced news, local sporting events, programming from program service arrangements, syndicated entertainment programs, and internally originated programming to television viewing audiences in the communities through its local television stations. As of December 31, 2019, it owned, operated, and/or provided services to 191 stations in 89 markets, which broadcast 629 channels. The company also owns and operates various networks carried on distribution platforms; and Tennis Channel, a cable network that includes coverage of various tennis' top tournaments and original professional sport, and tennis lifestyle shows. In addition, it owns regional sports network, which has the exclusive rights to air games of 45 professional sports teams and other sporting events. Further, the company offers digital agency services; and provides broadcast related technical services to the broadcast industry, as well as designs and manufactures broadcast systems, including transmitters and antennas. Additionally, it owns various non-media related investments, including private equity, mezzanine financing, and real estate investments. It also offers Tennis Magazine; and operates Tennis.com, an online tennis platform. Sinclair Broadcast Group, Inc. was founded in 1986 and is headquartered in Hunt Valley, Maryland."
SBGI,2018-12-31,NA,310000000,-39000000,341000000,720000000,1641000000,658000000,658000000,-292000000,-36000000,3055000000,2397000000,1414000000,-348000000,NA,346000000,341000000,-17000000,income_statement,Broadcasting,"Sinclair Broadcast Group, Inc.","Sinclair Broadcast Group, Inc. operates as a diversified television media company in the United States. The company operates in two segments, Local News and Marketing Services; and Sports. It owns or provides various programming, operating, sales, and other non-programming operating services to television stations. The company broadcasts free over-the-air programming, such as network provided programs, locally-produced news, local sporting events, programming from program service arrangements, syndicated entertainment programs, and internally originated programming to television viewing audiences in the communities through its local television stations. As of December 31, 2019, it owned, operated, and/or provided services to 191 stations in 89 markets, which broadcast 629 channels. The company also owns and operates various networks carried on distribution platforms; and Tennis Channel, a cable network that includes coverage of various tennis' top tournaments and original professional sport, and tennis lifestyle shows. In addition, it owns regional sports network, which has the exclusive rights to air games of 45 professional sports teams and other sporting events. Further, the company offers digital agency services; and provides broadcast related technical services to the broadcast industry, as well as designs and manufactures broadcast systems, including transmitters and antennas. Additionally, it owns various non-media related investments, including private equity, mezzanine financing, and real estate investments. It also offers Tennis Magazine; and operates Tennis.com, an online tennis platform. Sinclair Broadcast Group, Inc. was founded in 1986 and is headquartered in Hunt Valley, Maryland."
SBGI,2019-12-31,NA,9000000,1270000000,47000000,1119000000,1921000000,440000000,440000000,-422000000,-96000000,4240000000,3800000000,2319000000,-431000000,NA,105000000,47000000,-62000000,income_statement,Broadcasting,"Sinclair Broadcast Group, Inc.","Sinclair Broadcast Group, Inc. operates as a diversified television media company in the United States. The company operates in two segments, Local News and Marketing Services; and Sports. It owns or provides various programming, operating, sales, and other non-programming operating services to television stations. The company broadcasts free over-the-air programming, such as network provided programs, locally-produced news, local sporting events, programming from program service arrangements, syndicated entertainment programs, and internally originated programming to television viewing audiences in the communities through its local television stations. As of December 31, 2019, it owned, operated, and/or provided services to 191 stations in 89 markets, which broadcast 629 channels. The company also owns and operates various networks carried on distribution platforms; and Tennis Channel, a cable network that includes coverage of various tennis' top tournaments and original professional sport, and tennis lifestyle shows. In addition, it owns regional sports network, which has the exclusive rights to air games of 45 professional sports teams and other sporting events. Further, the company offers digital agency services; and provides broadcast related technical services to the broadcast industry, as well as designs and manufactures broadcast systems, including transmitters and antennas. Additionally, it owns various non-media related investments, including private equity, mezzanine financing, and real estate investments. It also offers Tennis Magazine; and operates Tennis.com, an online tennis platform. Sinclair Broadcast Group, Inc. was founded in 1986 and is headquartered in Hunt Valley, Maryland."
SBLK,2017-12-31,NA,-9535000,NA,-9771000,30955000,151301000,34948000,34948000,-49657000,236000,331976000,297028000,180675000,-44483000,NA,-9771000,-9771000,2775000,income_statement,Marine Shipping,Star Bulk Carriers Corp.,"Star Bulk Carriers Corp., a shipping company, engages in the ocean transportation of dry bulk cargoes worldwide. The company's vessels transport a range of major bulks, including iron ores, coal, and grains, as well as minor bulks, such as bauxite, fertilizers, and steel products. As of February 29, 2020, it had a fleet of 116 vessels with an aggregate capacity of approximately 12.9 million deadweight ton, including consisting of Newcastlemax, Capesize, Post Panamax, Kamsarmax, Panamax, Ultramax, and Supramax vessels. It also provides vessel management services. The company was incorporated in 2006 and is based in Maroussi, Greece."
SBLK,2018-12-31,NA,58458000,NA,58397000,33972000,289412000,150169000,150169000,-70767000,61000,651561000,501392000,362149000,-91711000,NA,58397000,58397000,1697000,income_statement,Marine Shipping,Star Bulk Carriers Corp.,"Star Bulk Carriers Corp., a shipping company, engages in the ocean transportation of dry bulk cargoes worldwide. The company's vessels transport a range of major bulks, including iron ores, coal, and grains, as well as minor bulks, such as bauxite, fertilizers, and steel products. As of February 29, 2020, it had a fleet of 116 vessels with an aggregate capacity of approximately 12.9 million deadweight ton, including consisting of Newcastlemax, Capesize, Post Panamax, Kamsarmax, Panamax, Ultramax, and Supramax vessels. It also provides vessel management services. The company was incorporated in 2006 and is based in Maroussi, Greece."
SBLK,2019-12-31,NA,-16092000,NA,-16201000,34819000,238671000,75768000,75768000,-85965000,109000,821365000,745597000,582694000,-91860000,NA,-16201000,-16201000,2197000,income_statement,Marine Shipping,Star Bulk Carriers Corp.,"Star Bulk Carriers Corp., a shipping company, engages in the ocean transportation of dry bulk cargoes worldwide. The company's vessels transport a range of major bulks, including iron ores, coal, and grains, as well as minor bulks, such as bauxite, fertilizers, and steel products. As of February 29, 2020, it had a fleet of 116 vessels with an aggregate capacity of approximately 12.9 million deadweight ton, including consisting of Newcastlemax, Capesize, Post Panamax, Kamsarmax, Panamax, Ultramax, and Supramax vessels. It also provides vessel management services. The company was incorporated in 2006 and is based in Maroussi, Greece."
SBLK,2020-12-31,NA,9812000,NA,9660000,31881000,244161000,71332000,71332000,-69555000,152000,693241000,621909000,449080000,-61520000,NA,9660000,9660000,-1718000,income_statement,Marine Shipping,Star Bulk Carriers Corp.,"Star Bulk Carriers Corp., a shipping company, engages in the ocean transportation of dry bulk cargoes worldwide. The company's vessels transport a range of major bulks, including iron ores, coal, and grains, as well as minor bulks, such as bauxite, fertilizers, and steel products. As of February 29, 2020, it had a fleet of 116 vessels with an aggregate capacity of approximately 12.9 million deadweight ton, including consisting of Newcastlemax, Capesize, Post Panamax, Kamsarmax, Panamax, Ultramax, and Supramax vessels. It also provides vessel management services. The company was incorporated in 2006 and is based in Maroussi, Greece."
SBLKZ,2014-12-31,NA,-11723000,NA,-11723000,21523000,47789000,-12383000,-12383000,-10059000,0,147387000,159770000,99598000,660000,NA,-11723000,-11723000,1284000,income_statement,NA,NA,NA
SBLKZ,2015-12-31,NA,-458177000,NA,-458177000,23621000,27919000,-81447000,-81447000,-32306000,0,234286000,315733000,206367000,-376730000,NA,-458177000,-458177000,3675000,income_statement,NA,NA,NA
SBLKZ,2016-12-31,NA,-153961000,NA,-154228000,24602000,44516000,-64962000,-64962000,-42732000,267000,222106000,287068000,177590000,-88999000,NA,-154228000,-154228000,2941000,income_statement,NA,NA,NA
SBLKZ,2017-12-31,NA,-9535000,NA,-9771000,29955000,153601000,38248000,38248000,-49657000,236000,331976000,293728000,178375000,-47783000,NA,-9771000,-9771000,2775000,income_statement,NA,NA,NA
SBNY,2017-12-31,NA,575264000,NA,387209000,408070000,1010330000,0,602260000,NA,188055000,1010330000,408070000,0,-26996000,NA,387209000,387209000,NA,income_statement,Banks—Regional,Signature Bank,"Signature Bank provides various business and personal banking products and services. It accepts various deposit products, including commercial checking accounts, money market accounts, escrow deposit accounts, cash concentration accounts, interest-bearing and non-interest-bearing checking accounts, certificates of deposit, time deposits, and other cash management products. The company also offers loan products comprising commercial and industrial loans; real estate loans, such as loans secured by commercial and residential properties, and construction loans; temporary financing for commercial and residential properties; letters of credit; and personal lines of credit and loans to acquire personal assets, as well as asset-based lending, mortgages, home equity loans, and credit card accounts. In addition, it provides investment, brokerage, and asset management products and services; retirement products, such as individual retirement accounts and administrative services for retirement vehicles, which include pension, profit sharing, and 401(k) plans to its clients, as well as business retirement accounts; and a range of financing and leasing products consisting of equipment, transportation, taxi medallion, commercial marine, and municipal and national franchise financing services. Further, the company offers wealth management services to high net worth personal clients; and a range of individual and group insurance products that comprise health, life, disability, and long-term care insurance products as an agent. Additionally, it purchases, securitizes, and sells guaranteed portions of the U.S. small business administration loans. As of July 8, 2020, the company operated 32 private client offices located in the New York metropolitan area, including Greenwich, Connecticut, as well as in San Francisco and Charlotte, N.C. Signature Bank was incorporated in 2000 and is headquartered in New York, New York."
SBNY,2018-12-31,NA,673463000,NA,505342000,461022000,1159741000,0,698719000,NA,168121000,1159741000,461022000,0,-25256000,NA,505342000,504428000,NA,income_statement,Banks—Regional,Signature Bank,"Signature Bank provides various business and personal banking products and services. It accepts various deposit products, including commercial checking accounts, money market accounts, escrow deposit accounts, cash concentration accounts, interest-bearing and non-interest-bearing checking accounts, certificates of deposit, time deposits, and other cash management products. The company also offers loan products comprising commercial and industrial loans; real estate loans, such as loans secured by commercial and residential properties, and construction loans; temporary financing for commercial and residential properties; letters of credit; and personal lines of credit and loans to acquire personal assets, as well as asset-based lending, mortgages, home equity loans, and credit card accounts. In addition, it provides investment, brokerage, and asset management products and services; retirement products, such as individual retirement accounts and administrative services for retirement vehicles, which include pension, profit sharing, and 401(k) plans to its clients, as well as business retirement accounts; and a range of financing and leasing products consisting of equipment, transportation, taxi medallion, commercial marine, and municipal and national franchise financing services. Further, the company offers wealth management services to high net worth personal clients; and a range of individual and group insurance products that comprise health, life, disability, and long-term care insurance products as an agent. Additionally, it purchases, securitizes, and sells guaranteed portions of the U.S. small business administration loans. As of July 8, 2020, the company operated 32 private client offices located in the New York metropolitan area, including Greenwich, Connecticut, as well as in San Francisco and Charlotte, N.C. Signature Bank was incorporated in 2000 and is headquartered in New York, New York."
SBNY,2019-12-31,NA,787636000,NA,588926000,516837000,1316905000,0,800068000,NA,198710000,1316905000,516837000,0,-12432000,NA,588926000,587013000,NA,income_statement,Banks—Regional,Signature Bank,"Signature Bank provides various business and personal banking products and services. It accepts various deposit products, including commercial checking accounts, money market accounts, escrow deposit accounts, cash concentration accounts, interest-bearing and non-interest-bearing checking accounts, certificates of deposit, time deposits, and other cash management products. The company also offers loan products comprising commercial and industrial loans; real estate loans, such as loans secured by commercial and residential properties, and construction loans; temporary financing for commercial and residential properties; letters of credit; and personal lines of credit and loans to acquire personal assets, as well as asset-based lending, mortgages, home equity loans, and credit card accounts. In addition, it provides investment, brokerage, and asset management products and services; retirement products, such as individual retirement accounts and administrative services for retirement vehicles, which include pension, profit sharing, and 401(k) plans to its clients, as well as business retirement accounts; and a range of financing and leasing products consisting of equipment, transportation, taxi medallion, commercial marine, and municipal and national franchise financing services. Further, the company offers wealth management services to high net worth personal clients; and a range of individual and group insurance products that comprise health, life, disability, and long-term care insurance products as an agent. Additionally, it purchases, securitizes, and sells guaranteed portions of the U.S. small business administration loans. As of July 8, 2020, the company operated 32 private client offices located in the New York metropolitan area, including Greenwich, Connecticut, as well as in San Francisco and Charlotte, N.C. Signature Bank was incorporated in 2000 and is headquartered in New York, New York."
SBNY,2020-12-31,NA,732192000,NA,528359000,600312000,1346246000,0,745934000,NA,203833000,1346246000,600312000,0,-13742000,NA,528359000,528359000,NA,income_statement,Banks—Regional,Signature Bank,"Signature Bank provides various business and personal banking products and services. It accepts various deposit products, including commercial checking accounts, money market accounts, escrow deposit accounts, cash concentration accounts, interest-bearing and non-interest-bearing checking accounts, certificates of deposit, time deposits, and other cash management products. The company also offers loan products comprising commercial and industrial loans; real estate loans, such as loans secured by commercial and residential properties, and construction loans; temporary financing for commercial and residential properties; letters of credit; and personal lines of credit and loans to acquire personal assets, as well as asset-based lending, mortgages, home equity loans, and credit card accounts. In addition, it provides investment, brokerage, and asset management products and services; retirement products, such as individual retirement accounts and administrative services for retirement vehicles, which include pension, profit sharing, and 401(k) plans to its clients, as well as business retirement accounts; and a range of financing and leasing products consisting of equipment, transportation, taxi medallion, commercial marine, and municipal and national franchise financing services. Further, the company offers wealth management services to high net worth personal clients; and a range of individual and group insurance products that comprise health, life, disability, and long-term care insurance products as an agent. Additionally, it purchases, securitizes, and sells guaranteed portions of the U.S. small business administration loans. As of July 8, 2020, the company operated 32 private client offices located in the New York metropolitan area, including Greenwich, Connecticut, as well as in San Francisco and Charlotte, N.C. Signature Bank was incorporated in 2000 and is headquartered in New York, New York."
SBNYP,2017-12-31,NA,575264000,NA,387209000,408070000,1010330000,0,602260000,NA,188055000,1010330000,408070000,0,-26996000,NA,387209000,387209000,NA,income_statement,Banks—Regional,Signature Bank - Depositary sha,"Signature Bank provides various business and personal banking products and services. It accepts various deposit products, including commercial checking accounts, money market accounts, escrow deposit accounts, cash concentration accounts, interest-bearing and non-interest-bearing checking accounts, certificates of deposit, time deposits, and other cash management products. The company also offers loan products comprising commercial and industrial loans; real estate loans, such as loans secured by commercial and residential properties, and construction loans; temporary financing for commercial and residential properties; letters of credit; and personal lines of credit and loans to acquire personal assets, as well as asset-based lending, mortgages, home equity loans, and credit card accounts. In addition, it provides investment, brokerage, and asset management products and services; retirement products, such as individual retirement accounts and administrative services for retirement vehicles, which include pension, profit sharing, and 401(k) plans to its clients, as well as business retirement accounts; and a range of financing and leasing products consisting of equipment, transportation, taxi medallion, commercial marine, and municipal and national franchise financing services. Further, the company offers wealth management services to high net worth personal clients; and a range of individual and group insurance products that comprise health, life, disability, and long-term care insurance products as an agent. Additionally, it purchases, securitizes, and sells guaranteed portions of the U.S. small business administration loans. As of July 8, 2020, the company operated 32 private client offices located in the New York metropolitan area, including Greenwich, Connecticut, as well as in San Francisco and Charlotte, N.C. Signature Bank was incorporated in 2000 and is headquartered in New York, New York."
SBNYP,2018-12-31,NA,673463000,NA,505342000,461022000,1159741000,0,698719000,NA,168121000,1159741000,461022000,0,-25256000,NA,505342000,504428000,NA,income_statement,Banks—Regional,Signature Bank - Depositary sha,"Signature Bank provides various business and personal banking products and services. It accepts various deposit products, including commercial checking accounts, money market accounts, escrow deposit accounts, cash concentration accounts, interest-bearing and non-interest-bearing checking accounts, certificates of deposit, time deposits, and other cash management products. The company also offers loan products comprising commercial and industrial loans; real estate loans, such as loans secured by commercial and residential properties, and construction loans; temporary financing for commercial and residential properties; letters of credit; and personal lines of credit and loans to acquire personal assets, as well as asset-based lending, mortgages, home equity loans, and credit card accounts. In addition, it provides investment, brokerage, and asset management products and services; retirement products, such as individual retirement accounts and administrative services for retirement vehicles, which include pension, profit sharing, and 401(k) plans to its clients, as well as business retirement accounts; and a range of financing and leasing products consisting of equipment, transportation, taxi medallion, commercial marine, and municipal and national franchise financing services. Further, the company offers wealth management services to high net worth personal clients; and a range of individual and group insurance products that comprise health, life, disability, and long-term care insurance products as an agent. Additionally, it purchases, securitizes, and sells guaranteed portions of the U.S. small business administration loans. As of July 8, 2020, the company operated 32 private client offices located in the New York metropolitan area, including Greenwich, Connecticut, as well as in San Francisco and Charlotte, N.C. Signature Bank was incorporated in 2000 and is headquartered in New York, New York."
SBNYP,2019-12-31,NA,787636000,NA,588926000,516837000,1316905000,0,800068000,NA,198710000,1316905000,516837000,0,-12432000,NA,588926000,587013000,NA,income_statement,Banks—Regional,Signature Bank - Depositary sha,"Signature Bank provides various business and personal banking products and services. It accepts various deposit products, including commercial checking accounts, money market accounts, escrow deposit accounts, cash concentration accounts, interest-bearing and non-interest-bearing checking accounts, certificates of deposit, time deposits, and other cash management products. The company also offers loan products comprising commercial and industrial loans; real estate loans, such as loans secured by commercial and residential properties, and construction loans; temporary financing for commercial and residential properties; letters of credit; and personal lines of credit and loans to acquire personal assets, as well as asset-based lending, mortgages, home equity loans, and credit card accounts. In addition, it provides investment, brokerage, and asset management products and services; retirement products, such as individual retirement accounts and administrative services for retirement vehicles, which include pension, profit sharing, and 401(k) plans to its clients, as well as business retirement accounts; and a range of financing and leasing products consisting of equipment, transportation, taxi medallion, commercial marine, and municipal and national franchise financing services. Further, the company offers wealth management services to high net worth personal clients; and a range of individual and group insurance products that comprise health, life, disability, and long-term care insurance products as an agent. Additionally, it purchases, securitizes, and sells guaranteed portions of the U.S. small business administration loans. As of July 8, 2020, the company operated 32 private client offices located in the New York metropolitan area, including Greenwich, Connecticut, as well as in San Francisco and Charlotte, N.C. Signature Bank was incorporated in 2000 and is headquartered in New York, New York."
SBNYP,2020-12-31,NA,732192000,NA,528359000,600312000,1346246000,0,745934000,NA,203833000,1346246000,600312000,0,-13742000,NA,528359000,528359000,NA,income_statement,Banks—Regional,Signature Bank - Depositary sha,"Signature Bank provides various business and personal banking products and services. It accepts various deposit products, including commercial checking accounts, money market accounts, escrow deposit accounts, cash concentration accounts, interest-bearing and non-interest-bearing checking accounts, certificates of deposit, time deposits, and other cash management products. The company also offers loan products comprising commercial and industrial loans; real estate loans, such as loans secured by commercial and residential properties, and construction loans; temporary financing for commercial and residential properties; letters of credit; and personal lines of credit and loans to acquire personal assets, as well as asset-based lending, mortgages, home equity loans, and credit card accounts. In addition, it provides investment, brokerage, and asset management products and services; retirement products, such as individual retirement accounts and administrative services for retirement vehicles, which include pension, profit sharing, and 401(k) plans to its clients, as well as business retirement accounts; and a range of financing and leasing products consisting of equipment, transportation, taxi medallion, commercial marine, and municipal and national franchise financing services. Further, the company offers wealth management services to high net worth personal clients; and a range of individual and group insurance products that comprise health, life, disability, and long-term care insurance products as an agent. Additionally, it purchases, securitizes, and sells guaranteed portions of the U.S. small business administration loans. As of July 8, 2020, the company operated 32 private client offices located in the New York metropolitan area, including Greenwich, Connecticut, as well as in San Francisco and Charlotte, N.C. Signature Bank was incorporated in 2000 and is headquartered in New York, New York."
SBRA,2016-12-31,NA,71254000,35000,70276000,17672000,254823000,163136000,163136000,-64073000,1049000,260526000,97390000,5703000,-91882000,NA,70205000,60034000,NA,income_statement,REIT—Healthcare Facilities,"Sabra Health Care REIT, Inc.","As of September 30, 2020, Sabra's investment portfolio included 425 real estate properties held for investment (consisting of (i) 287 Skilled Nursing/Transitional Care facilities, (ii) 64 Senior Housing communities (ÂSenior Housing - LeasedÂ), (iii) 47 Senior Housing communities operated by third-party property managers pursuant to property management agreements (ÂSenior Housing - ManagedÂ) and (iv) 27 Specialty Hospitals and Other facilities), one asset held for sale, one investment in a direct financing lease, 19 investments in loans receivable (consisting of (i) one mortgage loan, (ii) one construction loan and (iii) 17 other loans), six preferred equity investments and one investment in an unconsolidated joint venture that owns 158 Senior Housing - Managed communities. As of September 30, 2020, Sabra's real estate properties held for investment included 42,378 beds/units and its unconsolidated joint venture included 7,056 beds/units, spread across the United States and Canada."
SBRA,2017-12-31,NA,159016000,4442000,158383000,26901000,390421000,232525000,232525000,-88426000,651000,408281000,175756000,17860000,-73509000,NA,158365000,148141000,NA,income_statement,REIT—Healthcare Facilities,"Sabra Health Care REIT, Inc.","As of September 30, 2020, Sabra's investment portfolio included 425 real estate properties held for investment (consisting of (i) 287 Skilled Nursing/Transitional Care facilities, (ii) 64 Senior Housing communities (ÂSenior Housing - LeasedÂ), (iii) 47 Senior Housing communities operated by third-party property managers pursuant to property management agreements (ÂSenior Housing - ManagedÂ) and (iv) 27 Specialty Hospitals and Other facilities), one asset held for sale, one investment in a direct financing lease, 19 investments in loans receivable (consisting of (i) one mortgage loan, (ii) one construction loan and (iii) 17 other loans), six preferred equity investments and one investment in an unconsolidated joint venture that owns 158 Senior Housing - Managed communities. As of September 30, 2020, Sabra's real estate properties held for investment included 42,378 beds/units and its unconsolidated joint venture included 7,056 beds/units, spread across the United States and Canada."
SBRA,2018-12-31,NA,282126000,4333000,279082000,34958000,568432000,303020000,303020000,-147072000,3011000,617978000,314958000,49546000,-20894000,NA,279115000,269314000,NA,income_statement,REIT—Healthcare Facilities,"Sabra Health Care REIT, Inc.","As of September 30, 2020, Sabra's investment portfolio included 425 real estate properties held for investment (consisting of (i) 287 Skilled Nursing/Transitional Care facilities, (ii) 64 Senior Housing communities (ÂSenior Housing - LeasedÂ), (iii) 47 Senior Housing communities operated by third-party property managers pursuant to property management agreements (ÂSenior Housing - ManagedÂ) and (iv) 27 Specialty Hospitals and Other facilities), one asset held for sale, one investment in a direct financing lease, 19 investments in loans receivable (consisting of (i) one mortgage loan, (ii) one construction loan and (iii) 17 other loans), six preferred equity investments and one investment in an unconsolidated joint venture that owns 158 Senior Housing - Managed communities. As of September 30, 2020, Sabra's real estate properties held for investment included 42,378 beds/units and its unconsolidated joint venture included 7,056 beds/units, spread across the United States and Canada."
SBRA,2019-12-31,NA,72420000,NA,68996000,30262000,481268000,273919000,273919000,-126605000,3402000,589740000,315821000,108472000,-201499000,NA,69018000,68996000,NA,income_statement,REIT—Healthcare Facilities,"Sabra Health Care REIT, Inc.","As of September 30, 2020, Sabra's investment portfolio included 425 real estate properties held for investment (consisting of (i) 287 Skilled Nursing/Transitional Care facilities, (ii) 64 Senior Housing communities (ÂSenior Housing - LeasedÂ), (iii) 47 Senior Housing communities operated by third-party property managers pursuant to property management agreements (ÂSenior Housing - ManagedÂ) and (iv) 27 Specialty Hospitals and Other facilities), one asset held for sale, one investment in a direct financing lease, 19 investments in loans receivable (consisting of (i) one mortgage loan, (ii) one construction loan and (iii) 17 other loans), six preferred equity investments and one investment in an unconsolidated joint venture that owns 158 Senior Housing - Managed communities. As of September 30, 2020, Sabra's real estate properties held for investment included 42,378 beds/units and its unconsolidated joint venture included 7,056 beds/units, spread across the United States and Canada."
SBSI,2017-12-31,NA,70433000,NA,54312000,83842000,176768000,0,78509000,NA,16121000,176768000,98259000,0,-8076000,NA,54312000,54312000,14417000,income_statement,Banks—Regional,"Southside Bancshares, Inc.","Southside Bancshares, Inc. operates as the bank holding company for Southside Bank that provides a range of financial services to individuals, businesses, municipal entities, and nonprofit organizations. Its deposit products include savings, money market, and interest and noninterest bearing checking accounts, as well as certificates of deposit. The company's loan portfolio comprises consumer loans that include 1-4 family residential loans, home equity loans, home improvement loans, automobile loans, and other consumer related loans; commercial loans, such as short-term working capital loans for inventory and accounts receivable, short and medium-term loans for equipment or other business capital expansion, commercial real estate loans, and municipal loans; and construction loans for 1-4 family residential and commercial real estate. It also offers trust services consisting of investment management, administration, and advisory services for individuals, partnerships, and corporations; safe deposit services; and brokerage services. As of September 30, 2020, the company operated through 57 banking facilities and 80 ATMs/ITMs. Southside Bancshares, Inc. was founded in 1960 and is headquartered in Tyler, Texas."
SBSI,2018-12-31,NA,84301000,NA,74138000,97229000,204400000,0,93798000,NA,10163000,204400000,110602000,0,-9497000,NA,74138000,74138000,13373000,income_statement,Banks—Regional,"Southside Bancshares, Inc.","Southside Bancshares, Inc. operates as the bank holding company for Southside Bank that provides a range of financial services to individuals, businesses, municipal entities, and nonprofit organizations. Its deposit products include savings, money market, and interest and noninterest bearing checking accounts, as well as certificates of deposit. The company's loan portfolio comprises consumer loans that include 1-4 family residential loans, home equity loans, home improvement loans, automobile loans, and other consumer related loans; commercial loans, such as short-term working capital loans for inventory and accounts receivable, short and medium-term loans for equipment or other business capital expansion, commercial real estate loans, and municipal loans; and construction loans for 1-4 family residential and commercial real estate. It also offers trust services consisting of investment management, administration, and advisory services for individuals, partnerships, and corporations; safe deposit services; and brokerage services. As of September 30, 2020, the company operated through 57 banking facilities and 80 ATMs/ITMs. Southside Bancshares, Inc. was founded in 1960 and is headquartered in Tyler, Texas."
SBSI,2019-12-31,NA,87775000,NA,74554000,101018000,207072000,0,93052000,NA,13221000,207072000,114020000,0,-5277000,NA,74554000,74554000,13002000,income_statement,Banks—Regional,"Southside Bancshares, Inc.","Southside Bancshares, Inc. operates as the bank holding company for Southside Bank that provides a range of financial services to individuals, businesses, municipal entities, and nonprofit organizations. Its deposit products include savings, money market, and interest and noninterest bearing checking accounts, as well as certificates of deposit. The company's loan portfolio comprises consumer loans that include 1-4 family residential loans, home equity loans, home improvement loans, automobile loans, and other consumer related loans; commercial loans, such as short-term working capital loans for inventory and accounts receivable, short and medium-term loans for equipment or other business capital expansion, commercial real estate loans, and municipal loans; and construction loans for 1-4 family residential and commercial real estate. It also offers trust services consisting of investment management, administration, and advisory services for individuals, partnerships, and corporations; safe deposit services; and brokerage services. As of September 30, 2020, the company operated through 57 banking facilities and 80 ATMs/ITMs. Southside Bancshares, Inc. was founded in 1960 and is headquartered in Tyler, Texas."
SBSI,2020-12-31,NA,93489000,NA,82153000,104906000,216796000,0,98230000,NA,11336000,216796000,118566000,0,-4741000,NA,82153000,82153000,13660000,income_statement,Banks—Regional,"Southside Bancshares, Inc.","Southside Bancshares, Inc. operates as the bank holding company for Southside Bank that provides a range of financial services to individuals, businesses, municipal entities, and nonprofit organizations. Its deposit products include savings, money market, and interest and noninterest bearing checking accounts, as well as certificates of deposit. The company's loan portfolio comprises consumer loans that include 1-4 family residential loans, home equity loans, home improvement loans, automobile loans, and other consumer related loans; commercial loans, such as short-term working capital loans for inventory and accounts receivable, short and medium-term loans for equipment or other business capital expansion, commercial real estate loans, and municipal loans; and construction loans for 1-4 family residential and commercial real estate. It also offers trust services consisting of investment management, administration, and advisory services for individuals, partnerships, and corporations; safe deposit services; and brokerage services. As of September 30, 2020, the company operated through 57 banking facilities and 80 ATMs/ITMs. Southside Bancshares, Inc. was founded in 1960 and is headquartered in Tyler, Texas."
SBT,2017-12-31,NA,70448000,NA,37977000,33521000,111209000,0,71744000,NA,32471000,111209000,39465000,0,-1296000,NA,37977000,37977000,5944000,income_statement,Banks—Regional,"Sterling Bancorp, Inc.","Sterling Bancorp, Inc. (Southfield, MI) operates as the unitary thrift holding company for Sterling Bank and Trust, F.S.B. that provides community banking services to individual and business customers. It offers checking, savings, and money market accounts, as well as IRAs and certificates of deposit; and one- to four-family residential, commercial, commercial real estate, construction, and consumer loans, as well as commercial lines of credit. The company also provides investment management, wealth management, and retail banking services. As of December 31, 2019, it operated through a network of 30 branches in San Francisco and Los Angeles, California; New York, New York; Southfield, Michigan; and the greater Seattle market. The company was founded in 1984 and is headquartered in Southfield, Michigan."
SBT,2018-12-31,NA,88572000,NA,63468000,41669000,138908000,0,90019000,NA,25104000,138908000,48889000,0,-1447000,NA,63468000,63468000,7220000,income_statement,Banks—Regional,"Sterling Bancorp, Inc.","Sterling Bancorp, Inc. (Southfield, MI) operates as the unitary thrift holding company for Sterling Bank and Trust, F.S.B. that provides community banking services to individual and business customers. It offers checking, savings, and money market accounts, as well as IRAs and certificates of deposit; and one- to four-family residential, commercial, commercial real estate, construction, and consumer loans, as well as commercial lines of credit. The company also provides investment management, wealth management, and retail banking services. As of December 31, 2019, it operated through a network of 30 branches in San Francisco and Los Angeles, California; New York, New York; Southfield, Michigan; and the greater Seattle market. The company was founded in 1984 and is headquartered in Southfield, Michigan."
SBT,2019-12-31,NA,44891000,NA,29248000,47072000,132564000,0,70327000,NA,15643000,132564000,62237000,0,-25436000,NA,29248000,29248000,15165000,income_statement,Banks—Regional,"Sterling Bancorp, Inc.","Sterling Bancorp, Inc. (Southfield, MI) operates as the unitary thrift holding company for Sterling Bank and Trust, F.S.B. that provides community banking services to individual and business customers. It offers checking, savings, and money market accounts, as well as IRAs and certificates of deposit; and one- to four-family residential, commercial, commercial real estate, construction, and consumer loans, as well as commercial lines of credit. The company also provides investment management, wealth management, and retail banking services. As of December 31, 2019, it operated through a network of 30 branches in San Francisco and Los Angeles, California; New York, New York; Southfield, Michigan; and the greater Seattle market. The company was founded in 1984 and is headquartered in Southfield, Michigan."
SBT,2020-12-31,NA,-18876000,NA,-12967000,74076000,55236000,0,-17108000,NA,-5909000,55236000,72344000,0,-1768000,NA,-12967000,-12967000,-1732000,income_statement,Banks—Regional,"Sterling Bancorp, Inc.","Sterling Bancorp, Inc. (Southfield, MI) operates as the unitary thrift holding company for Sterling Bank and Trust, F.S.B. that provides community banking services to individual and business customers. It offers checking, savings, and money market accounts, as well as IRAs and certificates of deposit; and one- to four-family residential, commercial, commercial real estate, construction, and consumer loans, as well as commercial lines of credit. The company also provides investment management, wealth management, and retail banking services. As of December 31, 2019, it operated through a network of 30 branches in San Francisco and Los Angeles, California; New York, New York; Southfield, Michigan; and the greater Seattle market. The company was founded in 1984 and is headquartered in Southfield, Michigan."
SBTX,2018-12-31,14804000,-17579000,NA,-17579000,3516000,0,-18320000,-18320000,NA,0,0,18320000,0,741000,NA,-17579000,-17579000,NA,income_statement,Biotechnology,"Silverback Therapeutics, Inc.","Silverback Therapeutics, Inc., a clinical-stage biopharmaceutical company, develops tissue targeted therapeutics for the treatment of cancer, chronic viral infections, and other serious diseases. Its lead product candidate is SBT6050, which is in a Phase I/Ib clinical trial, a TLR8 agonist linker-payload conjugated to a HER2-directed monoclonal antibody that targets tumors, such as breast, gastric, and non-small cell lung cancers. The company also focuses on developing SBT6290, a product candidate that is in preclinical stage, which is a TLR8 linker-payload conjugated to a monoclonal antibody that targets Nectin4, which is expressed in bladder, triple negative breast, head and neck, and non-small cell lung cancers. In addition, it engages in developing SBT8230, a TLR8 linker-payload conjugated to an ASGR1 monoclonal antibody that is under development for the treatment of chronic hepatitis B virus infection; and agents that localize therapies to modulate pathways in additional oncology and fibrosis indications using TLR8 and other linker-payloads. Silverback Therapeutics, Inc. was founded in 2016 and is headquartered in Seattle, Washington."
SBTX,2019-12-31,21505000,-23967000,NA,-23967000,2562000,0,-24067000,-24067000,NA,0,0,24067000,0,100000,NA,-23967000,-23967000,NA,income_statement,Biotechnology,"Silverback Therapeutics, Inc.","Silverback Therapeutics, Inc., a clinical-stage biopharmaceutical company, develops tissue targeted therapeutics for the treatment of cancer, chronic viral infections, and other serious diseases. Its lead product candidate is SBT6050, which is in a Phase I/Ib clinical trial, a TLR8 agonist linker-payload conjugated to a HER2-directed monoclonal antibody that targets tumors, such as breast, gastric, and non-small cell lung cancers. The company also focuses on developing SBT6290, a product candidate that is in preclinical stage, which is a TLR8 linker-payload conjugated to a monoclonal antibody that targets Nectin4, which is expressed in bladder, triple negative breast, head and neck, and non-small cell lung cancers. In addition, it engages in developing SBT8230, a TLR8 linker-payload conjugated to an ASGR1 monoclonal antibody that is under development for the treatment of chronic hepatitis B virus infection; and agents that localize therapies to modulate pathways in additional oncology and fibrosis indications using TLR8 and other linker-payloads. Silverback Therapeutics, Inc. was founded in 2016 and is headquartered in Seattle, Washington."
SBUX,2017-10-01,NA,4317500000,6900000,2884700000,1408400000,6834600000,3896800000,3896800000,-92500000,1432600000,22386800000,18490000000,15552200000,420700000,NA,2884900000,2884700000,518000000,income_statement,NA,NA,NA
SBUX,2018-09-30,NA,5780000000,6300000,4518300000,1704600000,7316600000,3810100000,3810100000,-170300000,1262000000,24719500000,20909400000,17402900000,1969900000,NA,4518000000,4518300000,554900000,income_statement,NA,NA,NA
SBUX,2019-09-29,NA,4466200000,1200000,3599200000,1824100000,7488100000,3915700000,3915700000,-331000000,871600000,26508600000,22592900000,19020500000,550500000,NA,3594600000,3599200000,371000000,income_statement,NA,NA,NA
SBUX,2020-09-27,NA,1164400000,5700000,928300000,1679600000,5141100000,1599900000,1599900000,-437000000,239700000,23518000000,21918100000,18376900000,-435500000,NA,924700000,928300000,430300000,income_statement,NA,NA,NA
SCHL,2017-05-31,NA,87900000,1300000,52300000,777800000,927600000,111100000,111100000,-2400000,35400000,1741600000,1630500000,814000000,-23200000,-200000,52500000,52200000,NA,income_statement,Publishing,Scholastic Corporation,"Scholastic Corporation publishes and distributes children's books worldwide. It operates in three segments: Children's Book Publishing and Distribution, Education, and International. The Children's Book Publishing and Distribution segment publishes and distributes children's books, e-books, media, and interactive products through its school book club and school book fair channels, as well as through its trade channel. Its original publications include the Harry Potter, Hunger Games, Bad Guys, Baby-Sitters Club graphic novels, Magic School Bus, I Spy, Captain Underpants, Dog Man, Wings of Fire, Goosebumps, and Clifford The Big Red Dog; and licensed properties comprise the Peppa Pig, Five Nights at Freddy's, Pokemon, and Geronimo Stilton. In addition, this segment publishes and creates books plus products for children, including titles, such as the Mini Grocery Store, Rocks, Gems & Geodes Maker Lab, LEGO Chain Reactions, Hope the Rainbow Fairy, and other titles under the Klutz and the Make Believe Ideas names. The Education segment publishes and distributes classroom magazines under the Scholastic News, Scope, Storyworks, Let's Find Out, and Junior Scholastic names; non-fiction books under the Children's Press and Franklin Watts names; and literacy curriculum products under the Scholastic Literacy name, as well as provides children's books, other print and online references, fiction focused products, classroom materials, and consulting services. The International segment offers original trade and educational publishing programs; distributes children's books, digital educational resources, and other materials through school-based book clubs, school-based book fairs, and trade channels; produces and distributes magazines; and offers online subscription services. The company distributes its products and services directly to schools and libraries through retail stores and the Internet. Scholastic Corporation was founded in 1920 and is headquartered in New York, New York."
SCHL,2018-05-31,NA,-1500000,1300000,-5000000,766600000,883900000,75900000,75900000,-2000000,3500000,1628400000,1552500000,744500000,-77400000,NA,-5000000,-5000000,NA,income_statement,Publishing,Scholastic Corporation,"Scholastic Corporation publishes and distributes children's books worldwide. It operates in three segments: Children's Book Publishing and Distribution, Education, and International. The Children's Book Publishing and Distribution segment publishes and distributes children's books, e-books, media, and interactive products through its school book club and school book fair channels, as well as through its trade channel. Its original publications include the Harry Potter, Hunger Games, Bad Guys, Baby-Sitters Club graphic novels, Magic School Bus, I Spy, Captain Underpants, Dog Man, Wings of Fire, Goosebumps, and Clifford The Big Red Dog; and licensed properties comprise the Peppa Pig, Five Nights at Freddy's, Pokemon, and Geronimo Stilton. In addition, this segment publishes and creates books plus products for children, including titles, such as the Mini Grocery Store, Rocks, Gems & Geodes Maker Lab, LEGO Chain Reactions, Hope the Rainbow Fairy, and other titles under the Klutz and the Make Believe Ideas names. The Education segment publishes and distributes classroom magazines under the Scholastic News, Scope, Storyworks, Let's Find Out, and Junior Scholastic names; non-fiction books under the Children's Press and Franklin Watts names; and literacy curriculum products under the Scholastic Literacy name, as well as provides children's books, other print and online references, fiction focused products, classroom materials, and consulting services. The International segment offers original trade and educational publishing programs; distributes children's books, digital educational resources, and other materials through school-based book clubs, school-based book fairs, and trade channels; produces and distributes magazines; and offers online subscription services. The company distributes its products and services directly to schools and libraries through retail stores and the Internet. Scholastic Corporation was founded in 1920 and is headquartered in New York, New York."
SCHL,2019-05-31,NA,26000000,1300000,15600000,782300000,874000000,35600000,35600000,-2200000,10400000,1653900000,1618300000,779900000,-9600000,NA,15600000,15500000,NA,income_statement,Publishing,Scholastic Corporation,"Scholastic Corporation publishes and distributes children's books worldwide. It operates in three segments: Children's Book Publishing and Distribution, Education, and International. The Children's Book Publishing and Distribution segment publishes and distributes children's books, e-books, media, and interactive products through its school book club and school book fair channels, as well as through its trade channel. Its original publications include the Harry Potter, Hunger Games, Bad Guys, Baby-Sitters Club graphic novels, Magic School Bus, I Spy, Captain Underpants, Dog Man, Wings of Fire, Goosebumps, and Clifford The Big Red Dog; and licensed properties comprise the Peppa Pig, Five Nights at Freddy's, Pokemon, and Geronimo Stilton. In addition, this segment publishes and creates books plus products for children, including titles, such as the Mini Grocery Store, Rocks, Gems & Geodes Maker Lab, LEGO Chain Reactions, Hope the Rainbow Fairy, and other titles under the Klutz and the Make Believe Ideas names. The Education segment publishes and distributes classroom magazines under the Scholastic News, Scope, Storyworks, Let's Find Out, and Junior Scholastic names; non-fiction books under the Children's Press and Franklin Watts names; and literacy curriculum products under the Scholastic Literacy name, as well as provides children's books, other print and online references, fiction focused products, classroom materials, and consulting services. The International segment offers original trade and educational publishing programs; distributes children's books, digital educational resources, and other materials through school-based book clubs, school-based book fairs, and trade channels; produces and distributes magazines; and offers online subscription services. The company distributes its products and services directly to schools and libraries through retail stores and the Internet. Scholastic Corporation was founded in 1920 and is headquartered in New York, New York."
SCHL,2020-05-31,NA,-89700000,1400000,-43800000,705100000,736100000,-30500000,-30500000,-3000000,-46000000,1487100000,1517600000,751000000,-59200000,NA,-43700000,-43800000,NA,income_statement,Publishing,Scholastic Corporation,"Scholastic Corporation publishes and distributes children's books worldwide. It operates in three segments: Children's Book Publishing and Distribution, Education, and International. The Children's Book Publishing and Distribution segment publishes and distributes children's books, e-books, media, and interactive products through its school book club and school book fair channels, as well as through its trade channel. Its original publications include the Harry Potter, Hunger Games, Bad Guys, Baby-Sitters Club graphic novels, Magic School Bus, I Spy, Captain Underpants, Dog Man, Wings of Fire, Goosebumps, and Clifford The Big Red Dog; and licensed properties comprise the Peppa Pig, Five Nights at Freddy's, Pokemon, and Geronimo Stilton. In addition, this segment publishes and creates books plus products for children, including titles, such as the Mini Grocery Store, Rocks, Gems & Geodes Maker Lab, LEGO Chain Reactions, Hope the Rainbow Fairy, and other titles under the Klutz and the Make Believe Ideas names. The Education segment publishes and distributes classroom magazines under the Scholastic News, Scope, Storyworks, Let's Find Out, and Junior Scholastic names; non-fiction books under the Children's Press and Franklin Watts names; and literacy curriculum products under the Scholastic Literacy name, as well as provides children's books, other print and online references, fiction focused products, classroom materials, and consulting services. The International segment offers original trade and educational publishing programs; distributes children's books, digital educational resources, and other materials through school-based book clubs, school-based book fairs, and trade channels; produces and distributes magazines; and offers online subscription services. The company distributes its products and services directly to schools and libraries through retail stores and the Internet. Scholastic Corporation was founded in 1920 and is headquartered in New York, New York."
SCHN,2017-08-31,NA,48690000,3907000,44511000,171570000,223083000,51513000,51513000,-8081000,1322000,1687591000,1636078000,1464508000,-2823000,-390000,47368000,44511000,NA,income_statement,Steel,"Schnitzer Steel Industries, Inc","Schnitzer Steel Industries, Inc. recycles ferrous and nonferrous scrap metals; and manufactures finished steel products worldwide. The company operates in two segments, Auto and Metals Recycling (AMR), and Cascade Steel and Scrap (CSS). The AMR segment acquires, processes, and recycles scrap metals, as well as processes mixed and large pieces of scrap metal into smaller pieces by crushing, torching, shearing, shredding, and sorting. This segment offers ferrous recycled scrap metal, a feedstock used in the production of finished steel products; and nonferrous products, including mixed metal joint products recovered from the shredding process, such as zorba, zurik, and shredded insulated wires, as well as aluminum, copper, stainless steel, nickel, brass, titanium, lead, and high temperature alloys. It sells catalytic converters to specialty processors that extract the nonferrous precious metals, including platinum, palladium, and rhodium; and ferrous and nonferrous recycled metal products to steel mills, foundries, refineries, smelters, wholesalers, and recycled metal processors. This segment also procures salvaged vehicles and sells serviceable used auto parts from these vehicles through its 50 self-service auto parts stores in the United States and Western Canada, as well as sells auto bodies. The CSS segment produces various finished steel products using ferrous recycled scrap metal and other raw materials. It provides semi-finished goods, which include billets; and finished goods consisting of rebar, coiled rebar, wire rods, merchant bars, and other specialty products. This segment serves steel service centers, construction industry subcontractors, steel fabricators, wire drawers, and farm and wood products suppliers. Schnitzer Steel Industries, Inc. was founded in 1906 and is headquartered in Portland, Oregon."
SCHN,2018-08-31,NA,141853000,4032000,156451000,210877000,354230000,143353000,143353000,-8983000,-17590000,2364715000,2221362000,2010485000,-1500000,346000,159443000,156451000,NA,income_statement,Steel,"Schnitzer Steel Industries, Inc","Schnitzer Steel Industries, Inc. recycles ferrous and nonferrous scrap metals; and manufactures finished steel products worldwide. The company operates in two segments, Auto and Metals Recycling (AMR), and Cascade Steel and Scrap (CSS). The AMR segment acquires, processes, and recycles scrap metals, as well as processes mixed and large pieces of scrap metal into smaller pieces by crushing, torching, shearing, shredding, and sorting. This segment offers ferrous recycled scrap metal, a feedstock used in the production of finished steel products; and nonferrous products, including mixed metal joint products recovered from the shredding process, such as zorba, zurik, and shredded insulated wires, as well as aluminum, copper, stainless steel, nickel, brass, titanium, lead, and high temperature alloys. It sells catalytic converters to specialty processors that extract the nonferrous precious metals, including platinum, palladium, and rhodium; and ferrous and nonferrous recycled metal products to steel mills, foundries, refineries, smelters, wholesalers, and recycled metal processors. This segment also procures salvaged vehicles and sells serviceable used auto parts from these vehicles through its 50 self-service auto parts stores in the United States and Western Canada, as well as sells auto bodies. The CSS segment produces various finished steel products using ferrous recycled scrap metal and other raw materials. It provides semi-finished goods, which include billets; and finished goods consisting of rebar, coiled rebar, wire rods, merchant bars, and other specialty products. This segment serves steel service centers, construction industry subcontractors, steel fabricators, wire drawers, and farm and wood products suppliers. Schnitzer Steel Industries, Inc. was founded in 1906 and is headquartered in Portland, Oregon."
SCHN,2019-08-31,NA,76240000,4332000,56345000,191405000,274246000,82841000,82841000,-8266000,17670000,2132781000,2049940000,1858535000,-6601000,-248000,58570000,56345000,NA,income_statement,Steel,"Schnitzer Steel Industries, Inc","Schnitzer Steel Industries, Inc. recycles ferrous and nonferrous scrap metals; and manufactures finished steel products worldwide. The company operates in two segments, Auto and Metals Recycling (AMR), and Cascade Steel and Scrap (CSS). The AMR segment acquires, processes, and recycles scrap metals, as well as processes mixed and large pieces of scrap metal into smaller pieces by crushing, torching, shearing, shredding, and sorting. This segment offers ferrous recycled scrap metal, a feedstock used in the production of finished steel products; and nonferrous products, including mixed metal joint products recovered from the shredding process, such as zorba, zurik, and shredded insulated wires, as well as aluminum, copper, stainless steel, nickel, brass, titanium, lead, and high temperature alloys. It sells catalytic converters to specialty processors that extract the nonferrous precious metals, including platinum, palladium, and rhodium; and ferrous and nonferrous recycled metal products to steel mills, foundries, refineries, smelters, wholesalers, and recycled metal processors. This segment also procures salvaged vehicles and sells serviceable used auto parts from these vehicles through its 50 self-service auto parts stores in the United States and Western Canada, as well as sells auto bodies. The CSS segment produces various finished steel products using ferrous recycled scrap metal and other raw materials. It provides semi-finished goods, which include billets; and finished goods consisting of rebar, coiled rebar, wire rods, merchant bars, and other specialty products. This segment serves steel service centers, construction industry subcontractors, steel fabricators, wire drawers, and farm and wood products suppliers. Schnitzer Steel Industries, Inc. was founded in 1906 and is headquartered in Portland, Oregon."
SCHN,2020-08-31,NA,-1939000,3729000,-4145000,187876000,208618000,20742000,20742000,-8669000,166000,1712343000,1691601000,1503725000,-22681000,-95000,-2105000,-4145000,NA,income_statement,Steel,"Schnitzer Steel Industries, Inc","Schnitzer Steel Industries, Inc. recycles ferrous and nonferrous scrap metals; and manufactures finished steel products worldwide. The company operates in two segments, Auto and Metals Recycling (AMR), and Cascade Steel and Scrap (CSS). The AMR segment acquires, processes, and recycles scrap metals, as well as processes mixed and large pieces of scrap metal into smaller pieces by crushing, torching, shearing, shredding, and sorting. This segment offers ferrous recycled scrap metal, a feedstock used in the production of finished steel products; and nonferrous products, including mixed metal joint products recovered from the shredding process, such as zorba, zurik, and shredded insulated wires, as well as aluminum, copper, stainless steel, nickel, brass, titanium, lead, and high temperature alloys. It sells catalytic converters to specialty processors that extract the nonferrous precious metals, including platinum, palladium, and rhodium; and ferrous and nonferrous recycled metal products to steel mills, foundries, refineries, smelters, wholesalers, and recycled metal processors. This segment also procures salvaged vehicles and sells serviceable used auto parts from these vehicles through its 50 self-service auto parts stores in the United States and Western Canada, as well as sells auto bodies. The CSS segment produces various finished steel products using ferrous recycled scrap metal and other raw materials. It provides semi-finished goods, which include billets; and finished goods consisting of rebar, coiled rebar, wire rods, merchant bars, and other specialty products. This segment serves steel service centers, construction industry subcontractors, steel fabricators, wire drawers, and farm and wood products suppliers. Schnitzer Steel Industries, Inc. was founded in 1906 and is headquartered in Portland, Oregon."
SCHW,2017-12-31,NA,3650000000,NA,2354000000,4200000000,8387000000,0,3650000000,NA,1296000000,8618000000,4968000000,231000000,0,NA,2354000000,2180000000,268000000,income_statement,NA,NA,NA
SCHW,2018-12-31,NA,4562000000,NA,3507000000,4709000000,9890000000,0,4562000000,NA,1055000000,10132000000,5570000000,242000000,0,NA,3507000000,3329000000,313000000,income_statement,NA,NA,NA
SCHW,2019-12-31,NA,4848000000,NA,3704000000,4948000000,10468000000,0,4910000000,NA,1144000000,10721000000,5811000000,253000000,-62000000,NA,3704000000,3526000000,261000000,income_statement,NA,NA,NA
SCHW,2020-12-31,NA,4300000000,NA,3299000000,5596000000,11338000000,0,4693000000,NA,1001000000,11691000000,6998000000,353000000,-393000000,NA,3299000000,3043000000,445000000,income_statement,NA,NA,NA
SCKT,2016-12-31,2453500,2431666,NA,12147088,5417702,10434218,2563016,2563016,-131349,-9715422,20787588,18224572,10353370,-131350,NA,12147088,12147088,NA,income_statement,Computer Hardware,"Socket Mobile, Inc.","Socket Mobile, Inc. produces data capture products for mobile applications used in business mobility markets in the United States, Europe, Asia, and internationally. The company's products are incorporated into mobile applications used in point of sale, enterprise mobility, asset tracking, manufacturing process and quality control, transportation and logistics, event management, medical, and education. It provides cordless data capture devices that connect over Bluetooth and work with applications running on smartphones, mobile computers, and tablets; and software developer kits to application developers to enable them to provide their users with its advanced barcode scanning features. The company's cordless data capture devices include DuraScan 700 and 730 series linear barcode scanners; D740, D750, and D760 universal barcode scanners that reads all common 1D, stacked, 2D, and postal codes; SocketScan 700 series barcode scanners, which include S700, S730, and S740 barcode scanners; and SocketScan 800 series cordless barcode scanners, including S800, a 1D linear imaging scanner, and S840 and S860 2D scanner that are attachable to smartphones, tablets, and other mobile devices. It also provides D600 contactless RFID/ Near Field Communications reader writer that can read and write various types of electronic SmartTags or transfer data with near field communication; and S550, a contactless membership card reader/writer. In addition, the company offers SocketCare services program, which provides extended warranty and accidental breakage coverage for various products. It markets its products through a network of distributors and online resellers, application developers, and value-added resellers. The company was formerly known as Socket Communications, Inc. and changed its name to Socket Mobile, Inc. in April 2008. Socket Mobile, Inc. was founded in 1992 and is headquartered in Newark, California."
SCKT,2017-12-31,3037924,2338272,NA,-1430731,5934370,11390009,2417715,2417715,-79443,3769003,21285800,18868085,9895791,-79443,NA,-1430731,-1430731,NA,income_statement,Computer Hardware,"Socket Mobile, Inc.","Socket Mobile, Inc. produces data capture products for mobile applications used in business mobility markets in the United States, Europe, Asia, and internationally. The company's products are incorporated into mobile applications used in point of sale, enterprise mobility, asset tracking, manufacturing process and quality control, transportation and logistics, event management, medical, and education. It provides cordless data capture devices that connect over Bluetooth and work with applications running on smartphones, mobile computers, and tablets; and software developer kits to application developers to enable them to provide their users with its advanced barcode scanning features. The company's cordless data capture devices include DuraScan 700 and 730 series linear barcode scanners; D740, D750, and D760 universal barcode scanners that reads all common 1D, stacked, 2D, and postal codes; SocketScan 700 series barcode scanners, which include S700, S730, and S740 barcode scanners; and SocketScan 800 series cordless barcode scanners, including S800, a 1D linear imaging scanner, and S840 and S860 2D scanner that are attachable to smartphones, tablets, and other mobile devices. It also provides D600 contactless RFID/ Near Field Communications reader writer that can read and write various types of electronic SmartTags or transfer data with near field communication; and S550, a contactless membership card reader/writer. In addition, the company offers SocketCare services program, which provides extended warranty and accidental breakage coverage for various products. It markets its products through a network of distributors and online resellers, application developers, and value-added resellers. The company was formerly known as Socket Communications, Inc. and changed its name to Socket Mobile, Inc. in April 2008. Socket Mobile, Inc. was founded in 1992 and is headquartered in Newark, California."
SCKT,2018-12-31,3227463,-714600,NA,-571141,5814933,8456408,-585988,-585988,-128612,-143459,16454426,17040414,7998018,-128612,NA,-571141,-571141,NA,income_statement,Computer Hardware,"Socket Mobile, Inc.","Socket Mobile, Inc. produces data capture products for mobile applications used in business mobility markets in the United States, Europe, Asia, and internationally. The company's products are incorporated into mobile applications used in point of sale, enterprise mobility, asset tracking, manufacturing process and quality control, transportation and logistics, event management, medical, and education. It provides cordless data capture devices that connect over Bluetooth and work with applications running on smartphones, mobile computers, and tablets; and software developer kits to application developers to enable them to provide their users with its advanced barcode scanning features. The company's cordless data capture devices include DuraScan 700 and 730 series linear barcode scanners; D740, D750, and D760 universal barcode scanners that reads all common 1D, stacked, 2D, and postal codes; SocketScan 700 series barcode scanners, which include S700, S730, and S740 barcode scanners; and SocketScan 800 series cordless barcode scanners, including S800, a 1D linear imaging scanner, and S840 and S860 2D scanner that are attachable to smartphones, tablets, and other mobile devices. It also provides D600 contactless RFID/ Near Field Communications reader writer that can read and write various types of electronic SmartTags or transfer data with near field communication; and S550, a contactless membership card reader/writer. In addition, the company offers SocketCare services program, which provides extended warranty and accidental breakage coverage for various products. It markets its products through a network of distributors and online resellers, application developers, and value-added resellers. The company was formerly known as Socket Communications, Inc. and changed its name to Socket Mobile, Inc. in April 2008. Socket Mobile, Inc. was founded in 1992 and is headquartered in Newark, California."
SCKT,2019-12-31,3480730,505714,NA,286586,6013543,10100643,606370,606370,-100656,219128,19253105,18646735,9152462,-100656,NA,286586,286586,NA,income_statement,Computer Hardware,"Socket Mobile, Inc.","Socket Mobile, Inc. produces data capture products for mobile applications used in business mobility markets in the United States, Europe, Asia, and internationally. The company's products are incorporated into mobile applications used in point of sale, enterprise mobility, asset tracking, manufacturing process and quality control, transportation and logistics, event management, medical, and education. It provides cordless data capture devices that connect over Bluetooth and work with applications running on smartphones, mobile computers, and tablets; and software developer kits to application developers to enable them to provide their users with its advanced barcode scanning features. The company's cordless data capture devices include DuraScan 700 and 730 series linear barcode scanners; D740, D750, and D760 universal barcode scanners that reads all common 1D, stacked, 2D, and postal codes; SocketScan 700 series barcode scanners, which include S700, S730, and S740 barcode scanners; and SocketScan 800 series cordless barcode scanners, including S800, a 1D linear imaging scanner, and S840 and S860 2D scanner that are attachable to smartphones, tablets, and other mobile devices. It also provides D600 contactless RFID/ Near Field Communications reader writer that can read and write various types of electronic SmartTags or transfer data with near field communication; and S550, a contactless membership card reader/writer. In addition, the company offers SocketCare services program, which provides extended warranty and accidental breakage coverage for various products. It markets its products through a network of distributors and online resellers, application developers, and value-added resellers. The company was formerly known as Socket Communications, Inc. and changed its name to Socket Mobile, Inc. in April 2008. Socket Mobile, Inc. was founded in 1992 and is headquartered in Newark, California."
SCOR,2016-12-31,86975000,-121180000,NA,-117173000,270045000,226380000,-162536000,-162536000,-478000,-4007000,399460000,561996000,173080000,41356000,NA,-117173000,-117173000,NA,income_statement,Advertising Agencies,"comScore, Inc.","comScore, Inc. operates as an information and analytics company that measures audiences, consumer behavior, and advertising across media platforms worldwide. The company offers ratings and planning products and services, including Media Metrix and Mobile Metrix, which measure Websites and apps on computers, smartphones, and tablets; Video Metrix that delivers unduplicated measurement of digital video consumption, as well as provides TV-comparable reach and engagement metrics, and audience demographics; Plan Metrix, which offers an understanding of consumer lifestyle; validated Campaign Essentials (vCE) that validates whether digital ad impressions are visible to humans, identifies those that are fraudulent, and verifies that ads are shown in brand safe content and delivered to the right audience targets; and Campaign Ratings, which expands upon vCE's verification, as well as provides unduplicated reporting to negotiate and evaluate campaigns across media platforms. Its ratings and planning products and services also comprises TV Essentials that combines TV viewing information with marketing segmentation and consumer databases; StationView Essentials to understand consumer viewing patterns and characteristics; OnDemand Essentials that provides transactional tracking and reporting; and Cross-Platform Suite, which integrates person-level linear TV viewership with digital audience data. The company also offers analytics and optimization products and services that provide end-to-end solutions for planning, optimization, and evaluation of advertising campaigns and brand protection. In addition, it offers movies reporting and analytics products and services to measure movie viewership and box office results by capturing movie ticket sales in real time or near real time, which include box office analytics, trend analysis, and insights for movie studios and movie theater operators. The company was founded in 1999 and is headquartered in Reston, Virginia."
SCOR,2017-12-31,89023000,-284110000,NA,-281393000,288558000,209944000,-202460000,-202460000,-661000,-2717000,403549000,606009000,193605000,-81650000,NA,-281393000,-281393000,NA,income_statement,Advertising Agencies,"comScore, Inc.","comScore, Inc. operates as an information and analytics company that measures audiences, consumer behavior, and advertising across media platforms worldwide. The company offers ratings and planning products and services, including Media Metrix and Mobile Metrix, which measure Websites and apps on computers, smartphones, and tablets; Video Metrix that delivers unduplicated measurement of digital video consumption, as well as provides TV-comparable reach and engagement metrics, and audience demographics; Plan Metrix, which offers an understanding of consumer lifestyle; validated Campaign Essentials (vCE) that validates whether digital ad impressions are visible to humans, identifies those that are fraudulent, and verifies that ads are shown in brand safe content and delivered to the right audience targets; and Campaign Ratings, which expands upon vCE's verification, as well as provides unduplicated reporting to negotiate and evaluate campaigns across media platforms. Its ratings and planning products and services also comprises TV Essentials that combines TV viewing information with marketing segmentation and consumer databases; StationView Essentials to understand consumer viewing patterns and characteristics; OnDemand Essentials that provides transactional tracking and reporting; and Cross-Platform Suite, which integrates person-level linear TV viewership with digital audience data. The company also offers analytics and optimization products and services that provide end-to-end solutions for planning, optimization, and evaluation of advertising campaigns and brand protection. In addition, it offers movies reporting and analytics products and services to measure movie viewership and box office results by capturing movie ticket sales in real time or near real time, which include box office analytics, trend analysis, and insights for movie studios and movie theater operators. The company was founded in 1999 and is headquartered in Reston, Virginia."
SCOR,2018-12-31,76979000,-155562000,NA,-159268000,231268000,219262000,-121849000,-121849000,-16465000,3706000,419482000,541331000,200220000,-33713000,NA,-159268000,-159268000,NA,income_statement,Advertising Agencies,"comScore, Inc.","comScore, Inc. operates as an information and analytics company that measures audiences, consumer behavior, and advertising across media platforms worldwide. The company offers ratings and planning products and services, including Media Metrix and Mobile Metrix, which measure Websites and apps on computers, smartphones, and tablets; Video Metrix that delivers unduplicated measurement of digital video consumption, as well as provides TV-comparable reach and engagement metrics, and audience demographics; Plan Metrix, which offers an understanding of consumer lifestyle; validated Campaign Essentials (vCE) that validates whether digital ad impressions are visible to humans, identifies those that are fraudulent, and verifies that ads are shown in brand safe content and delivered to the right audience targets; and Campaign Ratings, which expands upon vCE's verification, as well as provides unduplicated reporting to negotiate and evaluate campaigns across media platforms. Its ratings and planning products and services also comprises TV Essentials that combines TV viewing information with marketing segmentation and consumer databases; StationView Essentials to understand consumer viewing patterns and characteristics; OnDemand Essentials that provides transactional tracking and reporting; and Cross-Platform Suite, which integrates person-level linear TV viewership with digital audience data. The company also offers analytics and optimization products and services that provide end-to-end solutions for planning, optimization, and evaluation of advertising campaigns and brand protection. In addition, it offers movies reporting and analytics products and services to measure movie viewership and box office results by capturing movie ticket sales in real time or near real time, which include box office analytics, trend analysis, and insights for movie studios and movie theater operators. The company was founded in 1999 and is headquartered in Reston, Virginia."
SCOR,2019-12-31,59207000,-340003000,NA,-338996000,166349000,192908000,-62724000,-62724000,-31526000,-1007000,388645000,451369000,195737000,-277279000,NA,-338996000,-338996000,NA,income_statement,Advertising Agencies,"comScore, Inc.","comScore, Inc. operates as an information and analytics company that measures audiences, consumer behavior, and advertising across media platforms worldwide. The company offers ratings and planning products and services, including Media Metrix and Mobile Metrix, which measure Websites and apps on computers, smartphones, and tablets; Video Metrix that delivers unduplicated measurement of digital video consumption, as well as provides TV-comparable reach and engagement metrics, and audience demographics; Plan Metrix, which offers an understanding of consumer lifestyle; validated Campaign Essentials (vCE) that validates whether digital ad impressions are visible to humans, identifies those that are fraudulent, and verifies that ads are shown in brand safe content and delivered to the right audience targets; and Campaign Ratings, which expands upon vCE's verification, as well as provides unduplicated reporting to negotiate and evaluate campaigns across media platforms. Its ratings and planning products and services also comprises TV Essentials that combines TV viewing information with marketing segmentation and consumer databases; StationView Essentials to understand consumer viewing patterns and characteristics; OnDemand Essentials that provides transactional tracking and reporting; and Cross-Platform Suite, which integrates person-level linear TV viewership with digital audience data. The company also offers analytics and optimization products and services that provide end-to-end solutions for planning, optimization, and evaluation of advertising campaigns and brand protection. In addition, it offers movies reporting and analytics products and services to measure movie viewership and box office results by capturing movie ticket sales in real time or near real time, which include box office analytics, trend analysis, and insights for movie studios and movie theater operators. The company was founded in 1999 and is headquartered in Reston, Virginia."
SCPH,2016-12-31,11856000,-24377000,NA,-24377000,6054000,0,-17910000,-17910000,-6512000,0,0,17910000,0,-6467000,NA,-24377000,-24377000,NA,income_statement,Biotechnology,scPharmaceuticals Inc.,"scPharmaceuticals Inc., a pharmaceutical company, engages in the development and commercialization of various pharmaceutical products. The company's lead product candidate is Furoscix that consists of proprietary buffered formulation of furosemide, which is delivered through the SmartDose drug delivery system for treatment of congestion in decompensated heart failure patients. Its product pipeline also includes scCeftriaxone, an antibiotic to treat infections caused by gram-positive and gram-negative organisms; and scCarbapenem program, an antibiotic for treating infections caused by gram-negative organisms. The company has a development agreement with West Pharmaceutical Services, Inc. to incorporate SmartDose drug delivery system with Furoscix. The company was founded in 2013 and is headquartered in Burlington, Massachusetts."
SCPH,2017-12-31,14331000,-23817000,NA,-23817000,9105000,0,-23436000,-23436000,-797000,0,0,23436000,0,-381000,NA,-23817000,-23817000,NA,income_statement,Biotechnology,scPharmaceuticals Inc.,"scPharmaceuticals Inc., a pharmaceutical company, engages in the development and commercialization of various pharmaceutical products. The company's lead product candidate is Furoscix that consists of proprietary buffered formulation of furosemide, which is delivered through the SmartDose drug delivery system for treatment of congestion in decompensated heart failure patients. Its product pipeline also includes scCeftriaxone, an antibiotic to treat infections caused by gram-positive and gram-negative organisms; and scCarbapenem program, an antibiotic for treating infections caused by gram-negative organisms. The company has a development agreement with West Pharmaceutical Services, Inc. to incorporate SmartDose drug delivery system with Furoscix. The company was founded in 2013 and is headquartered in Burlington, Massachusetts."
SCPH,2018-12-31,15948000,-29443000,NA,-29443000,13719000,0,-29667000,-29667000,-1432000,0,0,29667000,0,224000,NA,-29443000,-29443000,NA,income_statement,Biotechnology,scPharmaceuticals Inc.,"scPharmaceuticals Inc., a pharmaceutical company, engages in the development and commercialization of various pharmaceutical products. The company's lead product candidate is Furoscix that consists of proprietary buffered formulation of furosemide, which is delivered through the SmartDose drug delivery system for treatment of congestion in decompensated heart failure patients. Its product pipeline also includes scCeftriaxone, an antibiotic to treat infections caused by gram-positive and gram-negative organisms; and scCarbapenem program, an antibiotic for treating infections caused by gram-negative organisms. The company has a development agreement with West Pharmaceutical Services, Inc. to incorporate SmartDose drug delivery system with Furoscix. The company was founded in 2013 and is headquartered in Burlington, Massachusetts."
SCPH,2019-12-31,24632000,-32996000,NA,-32996000,8273000,0,-32905000,-32905000,-1767000,0,0,32905000,0,-91000,NA,-32996000,-32996000,NA,income_statement,Biotechnology,scPharmaceuticals Inc.,"scPharmaceuticals Inc., a pharmaceutical company, engages in the development and commercialization of various pharmaceutical products. The company's lead product candidate is Furoscix that consists of proprietary buffered formulation of furosemide, which is delivered through the SmartDose drug delivery system for treatment of congestion in decompensated heart failure patients. Its product pipeline also includes scCeftriaxone, an antibiotic to treat infections caused by gram-positive and gram-negative organisms; and scCarbapenem program, an antibiotic for treating infections caused by gram-negative organisms. The company has a development agreement with West Pharmaceutical Services, Inc. to incorporate SmartDose drug delivery system with Furoscix. The company was founded in 2013 and is headquartered in Burlington, Massachusetts."
SCPL,2017-12-31,26500000,45200000,223400000,23100000,131200000,222800000,52300000,52300000,NA,22100000,361400000,309100000,138600000,-7100000,NA,23100000,23100000,NA,income_statement,Electronic Gaming & Multimedia,SciPlay Corporation,"SciPlay Corporation develops and publishes digital games on mobile and Web platforms worldwide. The company offers seven games, which include social casino games, such as Jackpot Party Casino, Gold Fish Casino, Hot Shot Casino, and Quick Hit Slots, as well as casual games comprising MONOPOLY Slots, Bingo Showdown, and 88 Fortunes Slots. Its social casino games include slots-style game play, as well as table games-style game play; and casual games blend slots-style or bingo game play with adventure game features. The company was formerly known as SG Social Games Corporation and changed its name to SciPlay Corporation in March 2019. SciPlay Corporation was founded in 1997 and is based in Las Vegas, Nevada. SciPlay Corporation is a subsidiary of Scientific Games Corporation."
SCPL,2018-12-31,25600000,49400000,223400000,39000000,140200000,255800000,79100000,79100000,NA,10400000,416200000,337100000,160400000,-29700000,NA,39000000,39000000,NA,income_statement,Electronic Gaming & Multimedia,SciPlay Corporation,"SciPlay Corporation develops and publishes digital games on mobile and Web platforms worldwide. The company offers seven games, which include social casino games, such as Jackpot Party Casino, Gold Fish Casino, Hot Shot Casino, and Quick Hit Slots, as well as casual games comprising MONOPOLY Slots, Bingo Showdown, and 88 Fortunes Slots. Its social casino games include slots-style game play, as well as table games-style game play; and casual games blend slots-style or bingo game play with adventure game features. The company was formerly known as SG Social Games Corporation and changed its name to SciPlay Corporation in March 2019. SciPlay Corporation was founded in 1997 and is based in Las Vegas, Nevada. SciPlay Corporation is a subsidiary of Scientific Games Corporation."
SCPL,2019-12-31,23600000,102200000,223400000,32400000,170300000,307300000,106400000,106400000,NA,8700000,465800000,359400000,158500000,-4200000,NA,93500000,32400000,NA,income_statement,Electronic Gaming & Multimedia,SciPlay Corporation,"SciPlay Corporation develops and publishes digital games on mobile and Web platforms worldwide. The company offers seven games, which include social casino games, such as Jackpot Party Casino, Gold Fish Casino, Hot Shot Casino, and Quick Hit Slots, as well as casual games comprising MONOPOLY Slots, Bingo Showdown, and 88 Fortunes Slots. Its social casino games include slots-style game play, as well as table games-style game play; and casual games blend slots-style or bingo game play with adventure game features. The company was formerly known as SG Social Games Corporation and changed its name to SciPlay Corporation in March 2019. SciPlay Corporation was founded in 1997 and is based in Las Vegas, Nevada. SciPlay Corporation is a subsidiary of Scientific Games Corporation."
SCPS,2017-12-31,197759,-395301,NA,-395301,197543,0,-395301,-395301,NA,0,0,395301,0,0,NA,-395301,-395301,NA,income_statement,Biotechnology,Scopus BioPharma Inc.,"Scopus BioPharma Inc. develops therapeutics drugs targeting the endocannabinoid system. The company was formerly known as Project18 Inc. and changed its name to Scopus BioPharma Inc. in December, 2017. The company was incorporated in 2017 and is based in New York, New York."
SCPS,2018-12-31,277539,-685964,NA,-685964,408425,0,-685964,-685964,NA,0,0,685964,0,0,NA,-685964,-685964,NA,income_statement,Biotechnology,Scopus BioPharma Inc.,"Scopus BioPharma Inc. develops therapeutics drugs targeting the endocannabinoid system. The company was formerly known as Project18 Inc. and changed its name to Scopus BioPharma Inc. in December, 2017. The company was incorporated in 2017 and is based in New York, New York."
SCPS,2019-12-31,463111,-2689949,NA,-2689949,2226837,0,-2689948,-2689948,NA,0,0,2689948,0,-1,NA,-2689949,-2689949,NA,income_statement,Biotechnology,Scopus BioPharma Inc.,"Scopus BioPharma Inc. develops therapeutics drugs targeting the endocannabinoid system. The company was formerly known as Project18 Inc. and changed its name to Scopus BioPharma Inc. in December, 2017. The company was incorporated in 2017 and is based in New York, New York."
SCSC,2017-06-30,NA,101495000,NA,69246000,265178000,383596000,93450000,93450000,-3215000,32249000,3568186000,3474736000,3184590000,8045000,-2303000,69246000,69246000,NA,income_statement,Electronics & Computer Distribution,"ScanSource, Inc.","ScanSource, Inc. distributes technology products and solutions in the United States, Canada, and internationally. It operates in two segments, Worldwide Barcode, Networking & Security; and Worldwide Communications & Services. The Worldwide Barcode, Networking & Security segment offers a portfolio of solutions primarily for enterprise mobile computing, data capture, barcode printing, point of sale (POS), payments, networking, electronic physical security, cyber security, and other technologies. This segment offers data capture and POS solutions to automate the collection, processing, and communication of information for commercial and industrial applications, including retail sales, distribution, shipping, inventory control, materials handling, warehouse management, and health care applications. It also provides electronic physical security products, such as identification, access control, video surveillance, intrusion-related, and wireless and networking infrastructure products. The Worldwide Communications & Services segment offers a portfolio of solutions primarily for communications technologies and services comprising voice, video conferencing, wireless, data networking, cable, unified communications and collaboration, cloud, and technology services, as well as IP networks and other solutions for various vertical markets comprising education, healthcare, and government. The company also provides contact center, and infrastructure services. ScanSource, Inc. was founded in 1992 and is headquartered in Greenville, South Carolina."
SCSC,2018-06-30,NA,63049000,NA,33153000,232291000,369306000,106049000,106049000,-9121000,27593000,3164709000,3058660000,2795403000,-43000000,-2303000,35456000,33153000,NA,income_statement,Electronics & Computer Distribution,"ScanSource, Inc.","ScanSource, Inc. distributes technology products and solutions in the United States, Canada, and internationally. It operates in two segments, Worldwide Barcode, Networking & Security; and Worldwide Communications & Services. The Worldwide Barcode, Networking & Security segment offers a portfolio of solutions primarily for enterprise mobile computing, data capture, barcode printing, point of sale (POS), payments, networking, electronic physical security, cyber security, and other technologies. This segment offers data capture and POS solutions to automate the collection, processing, and communication of information for commercial and industrial applications, including retail sales, distribution, shipping, inventory control, materials handling, warehouse management, and health care applications. It also provides electronic physical security products, such as identification, access control, video surveillance, intrusion-related, and wireless and networking infrastructure products. The Worldwide Communications & Services segment offers a portfolio of solutions primarily for communications technologies and services comprising voice, video conferencing, wireless, data networking, cable, unified communications and collaboration, cloud, and technology services, as well as IP networks and other solutions for various vertical markets comprising education, healthcare, and government. The company also provides contact center, and infrastructure services. ScanSource, Inc. was founded in 1992 and is headquartered in Greenville, South Carolina."
SCSC,2019-06-30,NA,83637000,NA,57597000,251730000,392803000,111152000,111152000,-13162000,18778000,3249799000,3138647000,2856996000,-27515000,-7262000,64859000,57597000,NA,income_statement,Electronics & Computer Distribution,"ScanSource, Inc.","ScanSource, Inc. distributes technology products and solutions in the United States, Canada, and internationally. It operates in two segments, Worldwide Barcode, Networking & Security; and Worldwide Communications & Services. The Worldwide Barcode, Networking & Security segment offers a portfolio of solutions primarily for enterprise mobile computing, data capture, barcode printing, point of sale (POS), payments, networking, electronic physical security, cyber security, and other technologies. This segment offers data capture and POS solutions to automate the collection, processing, and communication of information for commercial and industrial applications, including retail sales, distribution, shipping, inventory control, materials handling, warehouse management, and health care applications. It also provides electronic physical security products, such as identification, access control, video surveillance, intrusion-related, and wireless and networking infrastructure products. The Worldwide Communications & Services segment offers a portfolio of solutions primarily for communications technologies and services comprising voice, video conferencing, wireless, data networking, cable, unified communications and collaboration, cloud, and technology services, as well as IP networks and other solutions for various vertical markets comprising education, healthcare, and government. The company also provides contact center, and infrastructure services. ScanSource, Inc. was founded in 1992 and is headquartered in Greenville, South Carolina."
SCSC,2020-06-30,NA,-71776000,NA,-192654000,257839000,355569000,64744000,64744000,-12224000,7451000,3047734000,2982990000,2692165000,-136520000,-113427000,-79227000,-192654000,NA,income_statement,Electronics & Computer Distribution,"ScanSource, Inc.","ScanSource, Inc. distributes technology products and solutions in the United States, Canada, and internationally. It operates in two segments, Worldwide Barcode, Networking & Security; and Worldwide Communications & Services. The Worldwide Barcode, Networking & Security segment offers a portfolio of solutions primarily for enterprise mobile computing, data capture, barcode printing, point of sale (POS), payments, networking, electronic physical security, cyber security, and other technologies. This segment offers data capture and POS solutions to automate the collection, processing, and communication of information for commercial and industrial applications, including retail sales, distribution, shipping, inventory control, materials handling, warehouse management, and health care applications. It also provides electronic physical security products, such as identification, access control, video surveillance, intrusion-related, and wireless and networking infrastructure products. The Worldwide Communications & Services segment offers a portfolio of solutions primarily for communications technologies and services comprising voice, video conferencing, wireless, data networking, cable, unified communications and collaboration, cloud, and technology services, as well as IP networks and other solutions for various vertical markets comprising education, healthcare, and government. The company also provides contact center, and infrastructure services. ScanSource, Inc. was founded in 1992 and is headquartered in Greenville, South Carolina."
SCVL,2017-01-28,NA,37749000,NA,23517000,245937000,289235000,42412000,42412000,-169000,14232000,1001102000,958690000,711867000,-4663000,NA,23517000,23030000,NA,income_statement,Apparel Retail,"Shoe Carnival, Inc.","Shoe Carnival, Inc., together with its subsidiaries, operates as a family footwear retailer in the United States. The company offers various dress, casual, and athletic footwear products for men, women, and children; and accessories, such as socks, belts, shoe care items, handbags, sport bags, backpacks, and wallets. As of February 1, 2020, it operated 392 stores in 35 states and Puerto Rico. The company also sells its products through online shopping at shoecarnival.com. Shoe Carnival, Inc. was founded in 1978 and is based in Evansville, Indiana."
SCVL,2018-02-03,NA,37413000,NA,18933000,252641000,296269000,42801000,42801000,-292000,18480000,1019154000,976353000,722885000,-5388000,NA,18933000,18683000,NA,income_statement,Apparel Retail,"Shoe Carnival, Inc.","Shoe Carnival, Inc., together with its subsidiaries, operates as a family footwear retailer in the United States. The company offers various dress, casual, and athletic footwear products for men, women, and children; and accessories, such as socks, belts, shoe care items, handbags, sport bags, backpacks, and wallets. As of February 1, 2020, it operated 392 stores in 35 states and Puerto Rico. The company also sells its products through online shopping at shoecarnival.com. Shoe Carnival, Inc. was founded in 1978 and is based in Evansville, Indiana."
SCVL,2019-02-02,NA,50357000,NA,38135000,259024000,308992000,49760000,49760000,-150000,12222000,1029650000,979890000,720658000,597000,NA,38135000,37983000,NA,income_statement,Apparel Retail,"Shoe Carnival, Inc.","Shoe Carnival, Inc., together with its subsidiaries, operates as a family footwear retailer in the United States. The company offers various dress, casual, and athletic footwear products for men, women, and children; and accessories, such as socks, belts, shoe care items, handbags, sport bags, backpacks, and wallets. As of February 1, 2020, it operated 392 stores in 35 states and Puerto Rico. The company also sells its products through online shopping at shoecarnival.com. Shoe Carnival, Inc. was founded in 1978 and is based in Evansville, Indiana."
SCVL,2020-02-01,NA,54748000,NA,42914000,256417000,311869000,55409000,55409000,-191000,11834000,1036551000,981142000,724682000,-661000,NA,42914000,42851000,NA,income_statement,Apparel Retail,"Shoe Carnival, Inc.","Shoe Carnival, Inc., together with its subsidiaries, operates as a family footwear retailer in the United States. The company offers various dress, casual, and athletic footwear products for men, women, and children; and accessories, such as socks, belts, shoe care items, handbags, sport bags, backpacks, and wallets. As of February 1, 2020, it operated 392 stores in 35 states and Puerto Rico. The company also sells its products through online shopping at shoecarnival.com. Shoe Carnival, Inc. was founded in 1978 and is based in Evansville, Indiana."
SCWX,2017-02-03,71030000,-53389000,NA,-31641000,205111000,220262000,-55879000,-55879000,NA,-21748000,432751000,488630000,212489000,2490000,NA,-31641000,-31641000,NA,income_statement,Software—Infrastructure,SecureWorks Corp.,"SecureWorks Corp., through its subsidiaries, provides technology-driven information security solutions for protecting its customers from cyber attacks in the United States and internationally. The company's solutions include managed security, threat intelligence, security and risk consulting, and incident response. Its solutions enable organizations to prevent security breaches by fortifying their cyber defenses, detect malicious activity, respond rapidly to security breaches, and predict emerging threats. The company sells its solutions primarily through its direct sales organization, as well as through referral agents, regional value-added resellers, and trade associations. It serves customers in a range of industries, including financial services, manufacturing, technology, retail, insurance, utility, and healthcare sectors. The company was formerly known as SecureWorks Holding Corporation and changed its name to SecureWorks Corp. in November 2015. SecureWorks Corp. was founded in 1999 and is headquartered in Atlanta, Georgia. SecureWorks Corp. is a subsidiary of Dell Inc."
SCWX,2018-02-02,80164000,-72716000,NA,-10417000,232663000,242846000,-69981000,-69981000,NA,-62299000,467930000,537911000,225084000,-2735000,NA,-10417000,-10417000,NA,income_statement,Software—Infrastructure,SecureWorks Corp.,"SecureWorks Corp., through its subsidiaries, provides technology-driven information security solutions for protecting its customers from cyber attacks in the United States and internationally. The company's solutions include managed security, threat intelligence, security and risk consulting, and incident response. Its solutions enable organizations to prevent security breaches by fortifying their cyber defenses, detect malicious activity, respond rapidly to security breaches, and predict emerging threats. The company sells its solutions primarily through its direct sales organization, as well as through referral agents, regional value-added resellers, and trade associations. It serves customers in a range of industries, including financial services, manufacturing, technology, retail, insurance, utility, and healthcare sectors. The company was formerly known as SecureWorks Holding Corporation and changed its name to SecureWorks Corp. in November 2015. SecureWorks Corp. was founded in 1999 and is headquartered in Atlanta, Georgia. SecureWorks Corp. is a subsidiary of Dell Inc."
SCWX,2019-02-01,87608000,-45954000,NA,-39101000,233716000,272592000,-48732000,-48732000,NA,-6853000,518709000,567441000,246117000,2778000,NA,-39101000,-39101000,NA,income_statement,Software—Infrastructure,SecureWorks Corp.,"SecureWorks Corp., through its subsidiaries, provides technology-driven information security solutions for protecting its customers from cyber attacks in the United States and internationally. The company's solutions include managed security, threat intelligence, security and risk consulting, and incident response. Its solutions enable organizations to prevent security breaches by fortifying their cyber defenses, detect malicious activity, respond rapidly to security breaches, and predict emerging threats. The company sells its solutions primarily through its direct sales organization, as well as through referral agents, regional value-added resellers, and trade associations. It serves customers in a range of industries, including financial services, manufacturing, technology, retail, insurance, utility, and healthcare sectors. The company was formerly known as SecureWorks Holding Corporation and changed its name to SecureWorks Corp. in November 2015. SecureWorks Corp. was founded in 1999 and is headquartered in Atlanta, Georgia. SecureWorks Corp. is a subsidiary of Dell Inc."
SCWX,2020-01-31,94964000,-51324000,NA,-31666000,257179000,299969000,-52174000,-52174000,NA,-19658000,552765000,604939000,252796000,850000,NA,-31666000,-31666000,NA,income_statement,Software—Infrastructure,SecureWorks Corp.,"SecureWorks Corp., through its subsidiaries, provides technology-driven information security solutions for protecting its customers from cyber attacks in the United States and internationally. The company's solutions include managed security, threat intelligence, security and risk consulting, and incident response. Its solutions enable organizations to prevent security breaches by fortifying their cyber defenses, detect malicious activity, respond rapidly to security breaches, and predict emerging threats. The company sells its solutions primarily through its direct sales organization, as well as through referral agents, regional value-added resellers, and trade associations. It serves customers in a range of industries, including financial services, manufacturing, technology, retail, insurance, utility, and healthcare sectors. The company was formerly known as SecureWorks Holding Corporation and changed its name to SecureWorks Corp. in November 2015. SecureWorks Corp. was founded in 1999 and is headquartered in Atlanta, Georgia. SecureWorks Corp. is a subsidiary of Dell Inc."
SCYX,2016-12-31,20076000,-29989000,NA,-29989000,7798000,257000,-27617000,-27617000,-451000,0,257000,27874000,0,-2372000,NA,-29989000,-29989000,NA,income_statement,Drug Manufacturers—Specialty & Generic,"SCYNEXIS, Inc.","SCYNEXIS, Inc., a biotechnology company, delivers therapies for the treatment fungal infections in the United States. It is developing its lead product candidate, ibrexafungerp, as a novel oral and intravenous drug for the treatment of various fungal infections, including vulvovaginal candidiasis, invasive aspergillosis, invasive candidiasis, and refractory invasive fungal infections. The company develops ibrexafungerp, which has completed Phase 2 clinical trials for the treatment of vulvovaginal candidiasis. It has research collaborations with Merck Sharp & Dohme Corp. and R-Pharm, CJSC to develop and commercialize rights for ibrexafungerp. The company was formerly known as SCYNEXIS Chemistry & Automation, Inc. and changed its name to SCYNEXIS, Inc. in June 2002. SCYNEXIS, Inc. was founded in 1999 and is headquartered in Jersey City, New Jersey."
SCYX,2017-12-31,18326000,-25060000,NA,-25060000,8251000,257000,-26320000,-26320000,-1855000,0,257000,26577000,0,1260000,NA,-25060000,-25060000,NA,income_statement,Drug Manufacturers—Specialty & Generic,"SCYNEXIS, Inc.","SCYNEXIS, Inc., a biotechnology company, delivers therapies for the treatment fungal infections in the United States. It is developing its lead product candidate, ibrexafungerp, as a novel oral and intravenous drug for the treatment of various fungal infections, including vulvovaginal candidiasis, invasive aspergillosis, invasive candidiasis, and refractory invasive fungal infections. The company develops ibrexafungerp, which has completed Phase 2 clinical trials for the treatment of vulvovaginal candidiasis. It has research collaborations with Merck Sharp & Dohme Corp. and R-Pharm, CJSC to develop and commercialize rights for ibrexafungerp. The company was formerly known as SCYNEXIS Chemistry & Automation, Inc. and changed its name to SCYNEXIS, Inc. in June 2002. SCYNEXIS, Inc. was founded in 1999 and is headquartered in Jersey City, New Jersey."
SCYX,2018-12-31,21560000,-19204000,NA,-12468000,8680000,257000,-29983000,-29983000,-2054000,-6736000,257000,30240000,0,10779000,NA,-12468000,-12468000,NA,income_statement,Drug Manufacturers—Specialty & Generic,"SCYNEXIS, Inc.","SCYNEXIS, Inc., a biotechnology company, delivers therapies for the treatment fungal infections in the United States. It is developing its lead product candidate, ibrexafungerp, as a novel oral and intravenous drug for the treatment of various fungal infections, including vulvovaginal candidiasis, invasive aspergillosis, invasive candidiasis, and refractory invasive fungal infections. The company develops ibrexafungerp, which has completed Phase 2 clinical trials for the treatment of vulvovaginal candidiasis. It has research collaborations with Merck Sharp & Dohme Corp. and R-Pharm, CJSC to develop and commercialize rights for ibrexafungerp. The company was formerly known as SCYNEXIS Chemistry & Automation, Inc. and changed its name to SCYNEXIS, Inc. in June 2002. SCYNEXIS, Inc. was founded in 1999 and is headquartered in Jersey City, New Jersey."
SCYX,2019-12-31,38394000,-53710000,NA,-53710000,10648000,121000,-48921000,-48921000,-2157000,0,121000,49042000,0,-4789000,NA,-53710000,-53710000,NA,income_statement,Drug Manufacturers—Specialty & Generic,"SCYNEXIS, Inc.","SCYNEXIS, Inc., a biotechnology company, delivers therapies for the treatment fungal infections in the United States. It is developing its lead product candidate, ibrexafungerp, as a novel oral and intravenous drug for the treatment of various fungal infections, including vulvovaginal candidiasis, invasive aspergillosis, invasive candidiasis, and refractory invasive fungal infections. The company develops ibrexafungerp, which has completed Phase 2 clinical trials for the treatment of vulvovaginal candidiasis. It has research collaborations with Merck Sharp & Dohme Corp. and R-Pharm, CJSC to develop and commercialize rights for ibrexafungerp. The company was formerly known as SCYNEXIS Chemistry & Automation, Inc. and changed its name to SCYNEXIS, Inc. in June 2002. SCYNEXIS, Inc. was founded in 1999 and is headquartered in Jersey City, New Jersey."
SDC,2017-12-31,NA,-32650000,125166000,-32778000,112445000,76257000,-36188000,-36188000,-2148000,128000,140268000,176456000,64011000,3538000,NA,-32778000,-32778000,NA,income_statement,Medical Devices,"SmileDirectClub, Inc.","SmileDirectClub, Inc. operates a teledentistry platform that provides member's with a customized clear aligner therapy treatment in the United States and internationally. The company manages the end-to-end process, which include marketing, aligner manufacturing, fulfillment, treatment by a doctor, and monitoring through completion of their treatment proprietary with a network of 250 state licensed orthodontists and general dentists through its teledentistry platform, SmileCheck. It offers aligners, impression kits, whitening gels, and retainers. The company was founded in 2014 and is headquartered in Nashville, Tennessee."
SDC,2018-12-31,NA,-74410000,125166000,-74771000,334823000,264159000,-70664000,-70664000,-13705000,361000,398127000,468791000,133968000,-3746000,NA,-74771000,-74771000,NA,income_statement,Medical Devices,"SmileDirectClub, Inc.","SmileDirectClub, Inc. operates a teledentistry platform that provides member's with a customized clear aligner therapy treatment in the United States and internationally. The company manages the end-to-end process, which include marketing, aligner manufacturing, fulfillment, treatment by a doctor, and monitoring through completion of their treatment proprietary with a network of 250 state licensed orthodontists and general dentists through its teledentistry platform, SmileCheck. It offers aligners, impression kits, whitening gels, and retainers. The company was founded in 2014 and is headquartered in Nashville, Tennessee."
SDC,2019-12-31,NA,-535537000,125166000,-114513000,1062311000,528139000,-534172000,-534172000,-15734000,2268000,706529000,1240701000,178390000,-1365000,NA,-537805000,-114513000,NA,income_statement,Medical Devices,"SmileDirectClub, Inc.","SmileDirectClub, Inc. operates a teledentistry platform that provides member's with a customized clear aligner therapy treatment in the United States and internationally. The company manages the end-to-end process, which include marketing, aligner manufacturing, fulfillment, treatment by a doctor, and monitoring through completion of their treatment proprietary with a network of 250 state licensed orthodontists and general dentists through its teledentistry platform, SmileCheck. It offers aligners, impression kits, whitening gels, and retainers. The company was founded in 2014 and is headquartered in Nashville, Tennessee."
SDGR,2017-12-31,27669000,-17060000,41000,-17392000,31152000,39800000,-19021000,-19021000,NA,332000,55693000,74714000,15893000,1961000,NA,-17392000,-17392000,NA,income_statement,Health Information Services,"Schrodinger, Inc.","SchrÃ¶dinger, Inc. provides computational platform to accelerate drug discovery and materials design for biopharmaceutical and industrial companies, academic institutions, and government laboratories worldwide. The company operates through two segments, Software and Drug Discovery. Its segment is focused on selling its software for drug discovery in the life sciences industry, as well as to customers in materials science industries. The Drug Discovery segment develops a pipeline of preclinical and clinical drug discovery programs through its computational platform in collaboration with pharmaceutical companies. SchrÃ¶dinger, Inc. has strategic collaborations with Twist Bioscience Corporation; Thermo Fisher Scientific to extend the use of cryo-EM in connection within silico compound screening to accelerate drug discovery; and Bristol Myers Squibb Company to discover, develop, and commercialize therapeutics in multiple disease areas. The company was founded in 1990 and is based in New York."
SDGR,2018-12-31,34523000,-28348000,41000,-28425000,36383000,42937000,-27969000,-27969000,NA,77000,66639000,94608000,23702000,-379000,NA,-28425000,-28425000,NA,income_statement,Health Information Services,"Schrodinger, Inc.","SchrÃ¶dinger, Inc. provides computational platform to accelerate drug discovery and materials design for biopharmaceutical and industrial companies, academic institutions, and government laboratories worldwide. The company operates through two segments, Software and Drug Discovery. Its segment is focused on selling its software for drug discovery in the life sciences industry, as well as to customers in materials science industries. The Drug Discovery segment develops a pipeline of preclinical and clinical drug discovery programs through its computational platform in collaboration with pharmaceutical companies. SchrÃ¶dinger, Inc. has strategic collaborations with Twist Bioscience Corporation; Thermo Fisher Scientific to extend the use of cryo-EM in connection within silico compound screening to accelerate drug discovery; and Bristol Myers Squibb Company to discover, develop, and commercialize therapeutics in multiple disease areas. The company was founded in 1990 and is based in New York."
SDGR,2019-12-31,39404000,-25972000,41000,-24571000,48404000,49093000,-38715000,-38715000,NA,-291000,85543000,124258000,36450000,12743000,NA,-25681000,-24571000,NA,income_statement,Health Information Services,"Schrodinger, Inc.","SchrÃ¶dinger, Inc. provides computational platform to accelerate drug discovery and materials design for biopharmaceutical and industrial companies, academic institutions, and government laboratories worldwide. The company operates through two segments, Software and Drug Discovery. Its segment is focused on selling its software for drug discovery in the life sciences industry, as well as to customers in materials science industries. The Drug Discovery segment develops a pipeline of preclinical and clinical drug discovery programs through its computational platform in collaboration with pharmaceutical companies. SchrÃ¶dinger, Inc. has strategic collaborations with Twist Bioscience Corporation; Thermo Fisher Scientific to extend the use of cryo-EM in connection within silico compound screening to accelerate drug discovery; and Bristol Myers Squibb Company to discover, develop, and commercialize therapeutics in multiple disease areas. The company was founded in 1990 and is based in New York."
SDH,2017-12-31,255424,-819177,43734,-674679,2077583,1506819,-826188,-826188,NA,-149447,2287160,3113348,780341,7011,NA,-669730,-674679,NA,income_statement,Consulting Services,"Global Internet of People, Inc.","Global Internet of People, Inc., a consulting company, provides enterprise services to small and medium-sized enterprises in the People's Republic of China. It operates a peer-to-peer knowledge sharing and enterprise service platform, where knowledge is shared, and services are requested and provided. The company offers its services online; through its Shidonghui App mobile application; and offline through directly operated local offices and 51 local centers operated by its members. Global Internet of People, Inc. was founded in 2014 and is headquartered in Beijing, the People's Republic of China."
SDH,2018-12-31,665378,8810938,331277,7477066,3031886,12396403,8699139,8699139,NA,1158465,13538999,4839860,1142596,111799,NA,7652473,7477066,NA,income_statement,Consulting Services,"Global Internet of People, Inc.","Global Internet of People, Inc., a consulting company, provides enterprise services to small and medium-sized enterprises in the People's Republic of China. It operates a peer-to-peer knowledge sharing and enterprise service platform, where knowledge is shared, and services are requested and provided. The company offers its services online; through its Shidonghui App mobile application; and offline through directly operated local offices and 51 local centers operated by its members. Global Internet of People, Inc. was founded in 2014 and is headquartered in Beijing, the People's Republic of China."
SDH,2019-12-31,795540,10969869,203013,9746385,4247973,15815827,10772314,10772314,NA,1589101,17925476,7153162,2109649,197555,NA,9380768,9746385,NA,income_statement,Consulting Services,"Global Internet of People, Inc.","Global Internet of People, Inc., a consulting company, provides enterprise services to small and medium-sized enterprises in the People's Republic of China. It operates a peer-to-peer knowledge sharing and enterprise service platform, where knowledge is shared, and services are requested and provided. The company offers its services online; through its Shidonghui App mobile application; and offline through directly operated local offices and 51 local centers operated by its members. Global Internet of People, Inc. was founded in 2014 and is headquartered in Beijing, the People's Republic of China."
SEAC,2017-01-31,30093000,-56618000,NA,-71249000,32331000,41470000,-22627000,-22627000,NA,14631000,83795000,106422000,42325000,-33991000,NA,-71249000,-71249000,-4118000,income_statement,Software—Application,"SeaChange International, Inc.","SeaChange International, Inc. provides multiscreen, advertising, and premium over the top (OTT) video products and services that facilitate the aggregation, licensing, management, and distribution of video and television advertising content worldwide. It offers video products, including SeaChange Adrenalin, a multiscreen video back office platform that enables service providers to manage, monetize, and deliver a seamless viewing experience across televisions, personal computers (PCs), tablets, smartphones, and other IP-enabled devices; and SeaChange AssetFlow, a content management solution, which is used to receive, manage, and publish content for viewing on televisions, tablets, PCs, and other consumer devices. The company also provides advertising products, such as SeaChange Infusion, an advertising platform to maximize advertising revenue across multiscreen, broadcast, on-demand, and OTT viewing. In addition, it offers SeaChange NitroX, an user experience product that empower service providers and content owners to optimize live and on-demand video consumption on multiscreen and OTT services. Further, the company provides professional, and maintenance and support services, as well as managed services. It sells and markets its products and services through a direct sales organization, and sales representatives and partners, as well as to systems integrators and value-added resellers. The company serves cable system, telecommunications companies, and satellite operators, as well as media companies. SeaChange International, Inc. was founded in 1993 and is headquartered in Acton, Massachusetts."
SEAC,2018-01-31,23444000,1226000,NA,13498000,31170000,53944000,-670000,-670000,NA,-12272000,80267000,80937000,26323000,1896000,NA,13498000,13498000,NA,income_statement,Software—Application,"SeaChange International, Inc.","SeaChange International, Inc. provides multiscreen, advertising, and premium over the top (OTT) video products and services that facilitate the aggregation, licensing, management, and distribution of video and television advertising content worldwide. It offers video products, including SeaChange Adrenalin, a multiscreen video back office platform that enables service providers to manage, monetize, and deliver a seamless viewing experience across televisions, personal computers (PCs), tablets, smartphones, and other IP-enabled devices; and SeaChange AssetFlow, a content management solution, which is used to receive, manage, and publish content for viewing on televisions, tablets, PCs, and other consumer devices. The company also provides advertising products, such as SeaChange Infusion, an advertising platform to maximize advertising revenue across multiscreen, broadcast, on-demand, and OTT viewing. In addition, it offers SeaChange NitroX, an user experience product that empower service providers and content owners to optimize live and on-demand video consumption on multiscreen and OTT services. Further, the company provides professional, and maintenance and support services, as well as managed services. It sells and markets its products and services through a direct sales organization, and sales representatives and partners, as well as to systems integrators and value-added resellers. The company serves cable system, telecommunications companies, and satellite operators, as well as media companies. SeaChange International, Inc. was founded in 1993 and is headquartered in Acton, Massachusetts."
SEAC,2019-01-31,19705000,-40020000,NA,-38002000,34032000,37330000,-16407000,-16407000,NA,-2018000,62402000,78809000,25072000,-23613000,NA,-38002000,-38002000,NA,income_statement,Software—Application,"SeaChange International, Inc.","SeaChange International, Inc. provides multiscreen, advertising, and premium over the top (OTT) video products and services that facilitate the aggregation, licensing, management, and distribution of video and television advertising content worldwide. It offers video products, including SeaChange Adrenalin, a multiscreen video back office platform that enables service providers to manage, monetize, and deliver a seamless viewing experience across televisions, personal computers (PCs), tablets, smartphones, and other IP-enabled devices; and SeaChange AssetFlow, a content management solution, which is used to receive, manage, and publish content for viewing on televisions, tablets, PCs, and other consumer devices. The company also provides advertising products, such as SeaChange Infusion, an advertising platform to maximize advertising revenue across multiscreen, broadcast, on-demand, and OTT viewing. In addition, it offers SeaChange NitroX, an user experience product that empower service providers and content owners to optimize live and on-demand video consumption on multiscreen and OTT services. Further, the company provides professional, and maintenance and support services, as well as managed services. It sells and markets its products and services through a direct sales organization, and sales representatives and partners, as well as to systems integrators and value-added resellers. The company serves cable system, telecommunications companies, and satellite operators, as well as media companies. SeaChange International, Inc. was founded in 1993 and is headquartered in Acton, Massachusetts."
SEAC,2020-01-31,16050000,-8873000,NA,-8921000,27390000,43502000,62000,62000,NA,48000,67154000,67092000,23652000,-8935000,NA,-8921000,-8921000,NA,income_statement,Software—Application,"SeaChange International, Inc.","SeaChange International, Inc. provides multiscreen, advertising, and premium over the top (OTT) video products and services that facilitate the aggregation, licensing, management, and distribution of video and television advertising content worldwide. It offers video products, including SeaChange Adrenalin, a multiscreen video back office platform that enables service providers to manage, monetize, and deliver a seamless viewing experience across televisions, personal computers (PCs), tablets, smartphones, and other IP-enabled devices; and SeaChange AssetFlow, a content management solution, which is used to receive, manage, and publish content for viewing on televisions, tablets, PCs, and other consumer devices. The company also provides advertising products, such as SeaChange Infusion, an advertising platform to maximize advertising revenue across multiscreen, broadcast, on-demand, and OTT viewing. In addition, it offers SeaChange NitroX, an user experience product that empower service providers and content owners to optimize live and on-demand video consumption on multiscreen and OTT services. Further, the company provides professional, and maintenance and support services, as well as managed services. It sells and markets its products and services through a direct sales organization, and sales representatives and partners, as well as to systems integrators and value-added resellers. The company serves cable system, telecommunications companies, and satellite operators, as well as media companies. SeaChange International, Inc. was founded in 1993 and is headquartered in Acton, Massachusetts."
SECO,2016-12-31,54262000,-44573000,7119000,-44617000,375116000,400146000,-29232000,-29232000,-3923000,0,2593822000,2623054000,2193676000,-15341000,NA,-44573000,-640359000,NA,income_statement,Internet Retail,Secoo Holding Limited,"Secoo Holding Limited, through its subsidiaries, operates an integrated online and offline shopping platform in the People's Republic of China, Hong Kong, and internationally. The company provides upscale brand products and services, including bags, watches, women's and men's wear, footwear, children's wear, sportswear, cosmetics and skin care products, jewelry, accessories, home goods, fine food and beverage products, arts, 3C electronic devices, and Chinese original products, as well as lifestyle services through its Website, mobile applications, and offline experience centers. It also offers its Website as a marketplace to third party merchants to facilitate their sales of upscale products and services. Secoo Holding Limited has a strategic alliance with Parkson Group. The company was founded in 2011 and is headquartered in Beijing, China."
SECO,2017-12-31,62081000,101884000,7336000,133258000,455112000,612014000,94821000,94821000,-8901000,-31525000,3740455000,3645634000,3128441000,7063000,NA,133409000,-69421000,NA,income_statement,Internet Retail,Secoo Holding Limited,"Secoo Holding Limited, through its subsidiaries, operates an integrated online and offline shopping platform in the People's Republic of China, Hong Kong, and internationally. The company provides upscale brand products and services, including bags, watches, women's and men's wear, footwear, children's wear, sportswear, cosmetics and skin care products, jewelry, accessories, home goods, fine food and beverage products, arts, 3C electronic devices, and Chinese original products, as well as lifestyle services through its Website, mobile applications, and offline experience centers. It also offers its Website as a marketplace to third party merchants to facilitate their sales of upscale products and services. Secoo Holding Limited has a strategic alliance with Parkson Group. The company was founded in 2011 and is headquartered in Beijing, China."
SECO,2018-12-31,80398000,196274000,28148000,151833000,660060000,959733000,219275000,219275000,-55403000,40728000,5387577000,5168302000,4427844000,-23001000,NA,155546000,151833000,NA,income_statement,Internet Retail,Secoo Holding Limited,"Secoo Holding Limited, through its subsidiaries, operates an integrated online and offline shopping platform in the People's Republic of China, Hong Kong, and internationally. The company provides upscale brand products and services, including bags, watches, women's and men's wear, footwear, children's wear, sportswear, cosmetics and skin care products, jewelry, accessories, home goods, fine food and beverage products, arts, 3C electronic devices, and Chinese original products, as well as lifestyle services through its Website, mobile applications, and offline experience centers. It also offers its Website as a marketplace to third party merchants to facilitate their sales of upscale products and services. Secoo Holding Limited has a strategic alliance with Parkson Group. The company was founded in 2011 and is headquartered in Beijing, China."
SECO,2019-12-31,101477000,193097000,37320000,154423000,872797000,1196947000,222673000,222673000,-118867000,31426000,6845580000,6622907000,5648633000,-29576000,NA,161671000,154423000,NA,income_statement,Internet Retail,Secoo Holding Limited,"Secoo Holding Limited, through its subsidiaries, operates an integrated online and offline shopping platform in the People's Republic of China, Hong Kong, and internationally. The company provides upscale brand products and services, including bags, watches, women's and men's wear, footwear, children's wear, sportswear, cosmetics and skin care products, jewelry, accessories, home goods, fine food and beverage products, arts, 3C electronic devices, and Chinese original products, as well as lifestyle services through its Website, mobile applications, and offline experience centers. It also offers its Website as a marketplace to third party merchants to facilitate their sales of upscale products and services. Secoo Holding Limited has a strategic alliance with Parkson Group. The company was founded in 2011 and is headquartered in Beijing, China."
SEDG,2017-12-31,54966000,100244000,8318000,84172000,68714000,214766000,91086000,91086000,-2536000,16072000,607045000,515959000,392279000,9158000,NA,84172000,84172000,NA,income_statement,Solar,"SolarEdge Technologies, Inc.","SolarEdge Technologies, Inc., together with its subsidiaries, designs, develops, and sells direct current (DC) optimized inverter systems for solar photovoltaic (PV) installations worldwide. Its SolarEdge system consists of inverters, power optimizers, communication devices, smart energy management solutions, and a cloud-based monitoring platform. The company's products are used in a range of solar market segments, such as residential, commercial, and small utility-scale solar installations. It also provides pre-sales support, ongoing trainings, and technical support and after installation services; and lithium-ion cells, batteries, and energy storage solutions for various industries, including energy storage systems, residential and commercial solar systems, uninterruptible power supplies, electric vehicles, aerospace, marine, and others. The company sells its products to the providers of solar PV systems; and solar installers and distributors, electrical equipment wholesalers, and PV module manufacturers, as well as engineering, procurement, and construction firms. SolarEdge Technologies, Inc. partnership with Schneider Electric to develop the residential solar market and provide homeowners with seamless energy management for smart homes of the future. SolarEdge Technologies, Inc. was founded in 2006 and is headquartered in Herzliya, Israel."
SEDG,2018-12-31,82245000,137123000,8318000,128833000,97571000,319236000,139420000,139420000,-2536000,9077000,937237000,797817000,618001000,-2297000,NA,128046000,128833000,NA,income_statement,Solar,"SolarEdge Technologies, Inc.","SolarEdge Technologies, Inc., together with its subsidiaries, designs, develops, and sells direct current (DC) optimized inverter systems for solar photovoltaic (PV) installations worldwide. Its SolarEdge system consists of inverters, power optimizers, communication devices, smart energy management solutions, and a cloud-based monitoring platform. The company's products are used in a range of solar market segments, such as residential, commercial, and small utility-scale solar installations. It also provides pre-sales support, ongoing trainings, and technical support and after installation services; and lithium-ion cells, batteries, and energy storage solutions for various industries, including energy storage systems, residential and commercial solar systems, uninterruptible power supplies, electric vehicles, aerospace, marine, and others. The company sells its products to the providers of solar PV systems; and solar installers and distributors, electrical equipment wholesalers, and PV module manufacturers, as well as engineering, procurement, and construction firms. SolarEdge Technologies, Inc. partnership with Schneider Electric to develop the residential solar market and provide homeowners with seamless energy management for smart homes of the future. SolarEdge Technologies, Inc. was founded in 2006 and is headquartered in Herzliya, Israel."
SEDG,2019-12-31,121351000,178603000,NA,146549000,137345000,479338000,220642000,220642000,-4805000,33646000,1425660000,1205018000,946322000,-42039000,NA,144957000,146549000,NA,income_statement,Solar,"SolarEdge Technologies, Inc.","SolarEdge Technologies, Inc., together with its subsidiaries, designs, develops, and sells direct current (DC) optimized inverter systems for solar photovoltaic (PV) installations worldwide. Its SolarEdge system consists of inverters, power optimizers, communication devices, smart energy management solutions, and a cloud-based monitoring platform. The company's products are used in a range of solar market segments, such as residential, commercial, and small utility-scale solar installations. It also provides pre-sales support, ongoing trainings, and technical support and after installation services; and lithium-ion cells, batteries, and energy storage solutions for various industries, including energy storage systems, residential and commercial solar systems, uninterruptible power supplies, electric vehicles, aerospace, marine, and others. The company sells its products to the providers of solar PV systems; and solar installers and distributors, electrical equipment wholesalers, and PV module manufacturers, as well as engineering, procurement, and construction firms. SolarEdge Technologies, Inc. partnership with Schneider Electric to develop the residential solar market and provide homeowners with seamless energy management for smart homes of the future. SolarEdge Technologies, Inc. was founded in 2006 and is headquartered in Herzliya, Israel."
SEDG,2020-12-31,163123000,163666000,NA,140322000,159104000,461359000,139132000,139132000,-3185000,23344000,1459271000,1320139000,997912000,24534000,NA,140322000,140322000,NA,income_statement,Solar,"SolarEdge Technologies, Inc.","SolarEdge Technologies, Inc., together with its subsidiaries, designs, develops, and sells direct current (DC) optimized inverter systems for solar photovoltaic (PV) installations worldwide. Its SolarEdge system consists of inverters, power optimizers, communication devices, smart energy management solutions, and a cloud-based monitoring platform. The company's products are used in a range of solar market segments, such as residential, commercial, and small utility-scale solar installations. It also provides pre-sales support, ongoing trainings, and technical support and after installation services; and lithium-ion cells, batteries, and energy storage solutions for various industries, including energy storage systems, residential and commercial solar systems, uninterruptible power supplies, electric vehicles, aerospace, marine, and others. The company sells its products to the providers of solar PV systems; and solar installers and distributors, electrical equipment wholesalers, and PV module manufacturers, as well as engineering, procurement, and construction firms. SolarEdge Technologies, Inc. partnership with Schneider Electric to develop the residential solar market and provide homeowners with seamless energy management for smart homes of the future. SolarEdge Technologies, Inc. was founded in 2006 and is headquartered in Herzliya, Israel."
SEE,2017-12-31,NA,393300000,NA,814900000,743900000,1412100000,655100000,655100000,-201800000,330500000,4461600000,3806500000,3049500000,-261800000,752100000,62800000,810000000,NA,income_statement,NA,NA,NA
SEE,2018-12-31,NA,457800000,NA,193100000,757400000,1502100000,729000000,729000000,-193000000,307500000,4732700000,4003700000,3230600000,-271200000,42800000,150300000,192200000,NA,income_statement,NA,NA,NA
SEE,2019-12-31,NA,370300000,NA,263000000,852200000,1564800000,683700000,683700000,-196000000,76600000,4791100000,4107400000,3226300000,-313400000,-30700000,293700000,262500000,NA,income_statement,NA,NA,NA
SEE,2020-12-31,NA,626200000,NA,502900000,772700000,1609300000,799100000,799100000,-174400000,142100000,4903200000,4104100000,3293900000,-172900000,18800000,484100000,502900000,NA,income_statement,NA,NA,NA
SEED,2017-09-30,38682000,-121841000,490000,-75674000,36094000,-18641000,-88062000,-88062000,-9006000,0,870000,88932000,19511000,-33779000,15580000,-121841000,-75674000,-5355000,income_statement,Agricultural Inputs,Origin Agritech Limited,"Origin Agritech Limited, together with its subsidiaries, operates an agricultural biotechnology and an e-commerce platform in the People's Republic of China. The company engages in crop seed breeding and genetic improvement activities. It develops, produces, and distributes hybrid crop seeds, as well as develops hybrid seed technology. The company also operates an e-commerce platform, which provides range of products, including agricultural seed products that comprise corn, rice, and vegetable seeds; other agricultural inputs, such as fertilizers and agricultural chemicals; foods; household products; and other consumer products to farmers through online and mobile ordering. Origin Agritech Limited was founded in 1997 and is headquartered in Beijing, China."
SEED,2018-09-30,27132000,-152790000,1363000,-153663000,32558000,5880000,-44972000,-44972000,-22781000,0,12927000,57899000,7047000,-107818000,NA,-152790000,-153663000,-8838000,income_statement,Agricultural Inputs,Origin Agritech Limited,"Origin Agritech Limited, together with its subsidiaries, operates an agricultural biotechnology and an e-commerce platform in the People's Republic of China. The company engages in crop seed breeding and genetic improvement activities. It develops, produces, and distributes hybrid crop seeds, as well as develops hybrid seed technology. The company also operates an e-commerce platform, which provides range of products, including agricultural seed products that comprise corn, rice, and vegetable seeds; other agricultural inputs, such as fertilizers and agricultural chemicals; foods; household products; and other consumer products to farmers through online and mobile ordering. Origin Agritech Limited was founded in 1997 and is headquartered in Beijing, China."
SEED,2019-09-30,13267000,-65143000,7209000,-62120000,31267000,-12830000,-57364000,-57364000,-4677000,510000,92440000,149804000,105270000,-7779000,NA,-65653000,-62120000,NA,income_statement,Agricultural Inputs,Origin Agritech Limited,"Origin Agritech Limited, together with its subsidiaries, operates an agricultural biotechnology and an e-commerce platform in the People's Republic of China. The company engages in crop seed breeding and genetic improvement activities. It develops, produces, and distributes hybrid crop seeds, as well as develops hybrid seed technology. The company also operates an e-commerce platform, which provides range of products, including agricultural seed products that comprise corn, rice, and vegetable seeds; other agricultural inputs, such as fertilizers and agricultural chemicals; foods; household products; and other consumer products to farmers through online and mobile ordering. Origin Agritech Limited was founded in 1997 and is headquartered in Beijing, China."
SEED,2020-09-30,4116000,-102417000,-8272000,-85261000,62889000,3513000,-63492000,-63492000,-5796000,425000,52513000,116005000,49000000,-38925000,NA,-102842000,-85261000,NA,income_statement,Agricultural Inputs,Origin Agritech Limited,"Origin Agritech Limited, together with its subsidiaries, operates an agricultural biotechnology and an e-commerce platform in the People's Republic of China. The company engages in crop seed breeding and genetic improvement activities. It develops, produces, and distributes hybrid crop seeds, as well as develops hybrid seed technology. The company also operates an e-commerce platform, which provides range of products, including agricultural seed products that comprise corn, rice, and vegetable seeds; other agricultural inputs, such as fertilizers and agricultural chemicals; foods; household products; and other consumer products to farmers through online and mobile ordering. Origin Agritech Limited was founded in 1997 and is headquartered in Beijing, China."
SEEL,2016-12-31,42857,-437143,NA,-437143,394286,0,-437143,-437143,-83000,0,0,437143,0,0,12070000,-437143,-437143,NA,income_statement,Biotechnology,"Seelos Therapeutics, Inc.","Seelos Therapeutics, Inc., a clinical-stage biopharmaceutical company, focuses on developing and commercializing of novel technologies and therapeutics for the treatment of central nervous system, respiratory, and other disorders. The company's lead programs are SLS-002, an intranasal racemic ketamine for the treatment of acute suicidal ideation and behavior in patients with major depressive disorder and post-traumatic stress disorder; SLS-005, a protein stabilizer for the treatment of Sanfilippo syndrome; and SLS-006, a partial dopamine agonist for the treatment of patients with Parkinson's disease (PD). Its preclinical programs include SLS-007, an anti-alpha-synuclein peptidic inhibitor to treat patients with PD; SLS-008, an orally available antagonist for chemoattractant receptor-homologous molecule for the treatment of chronic inflammation in asthma and pediatric orphan indications; SLS-004 for the treatment of PD; SLS-010, an oral histamine H3A receptor antagonist for narcolepsy and related disorders; and SLS-012, an injectable therapy for post-operative pain management. Seelos Therapeutics, Inc. was founded in 2016 and is headquartered in New York, New York."
SEEL,2017-12-31,3463000,-11749000,NA,321000,7210000,0,-10673000,-10673000,-83000,0,0,10673000,0,-1076000,12070000,-11749000,321000,NA,income_statement,Biotechnology,"Seelos Therapeutics, Inc.","Seelos Therapeutics, Inc., a clinical-stage biopharmaceutical company, focuses on developing and commercializing of novel technologies and therapeutics for the treatment of central nervous system, respiratory, and other disorders. The company's lead programs are SLS-002, an intranasal racemic ketamine for the treatment of acute suicidal ideation and behavior in patients with major depressive disorder and post-traumatic stress disorder; SLS-005, a protein stabilizer for the treatment of Sanfilippo syndrome; and SLS-006, a partial dopamine agonist for the treatment of patients with Parkinson's disease (PD). Its preclinical programs include SLS-007, an anti-alpha-synuclein peptidic inhibitor to treat patients with PD; SLS-008, an orally available antagonist for chemoattractant receptor-homologous molecule for the treatment of chronic inflammation in asthma and pediatric orphan indications; SLS-004 for the treatment of PD; SLS-010, an oral histamine H3A receptor antagonist for narcolepsy and related disorders; and SLS-012, an injectable therapy for post-operative pain management. Seelos Therapeutics, Inc. was founded in 2016 and is headquartered in New York, New York."
SEEL,2018-12-31,553000,-3475000,NA,-3475000,2631000,0,-3184000,-3184000,-131000,0,0,3184000,0,-68000,-24000,-3475000,-3475000,NA,income_statement,Biotechnology,"Seelos Therapeutics, Inc.","Seelos Therapeutics, Inc., a clinical-stage biopharmaceutical company, focuses on developing and commercializing of novel technologies and therapeutics for the treatment of central nervous system, respiratory, and other disorders. The company's lead programs are SLS-002, an intranasal racemic ketamine for the treatment of acute suicidal ideation and behavior in patients with major depressive disorder and post-traumatic stress disorder; SLS-005, a protein stabilizer for the treatment of Sanfilippo syndrome; and SLS-006, a partial dopamine agonist for the treatment of patients with Parkinson's disease (PD). Its preclinical programs include SLS-007, an anti-alpha-synuclein peptidic inhibitor to treat patients with PD; SLS-008, an orally available antagonist for chemoattractant receptor-homologous molecule for the treatment of chronic inflammation in asthma and pediatric orphan indications; SLS-004 for the treatment of PD; SLS-010, an oral histamine H3A receptor antagonist for narcolepsy and related disorders; and SLS-012, an injectable therapy for post-operative pain management. Seelos Therapeutics, Inc. was founded in 2016 and is headquartered in New York, New York."
SEEL,2019-12-31,22563000,-51255000,NA,-51255000,5559000,375000,-27747000,-27747000,-29000,0,375000,28122000,0,-23508000,NA,-51255000,-51255000,NA,income_statement,Biotechnology,"Seelos Therapeutics, Inc.","Seelos Therapeutics, Inc., a clinical-stage biopharmaceutical company, focuses on developing and commercializing of novel technologies and therapeutics for the treatment of central nervous system, respiratory, and other disorders. The company's lead programs are SLS-002, an intranasal racemic ketamine for the treatment of acute suicidal ideation and behavior in patients with major depressive disorder and post-traumatic stress disorder; SLS-005, a protein stabilizer for the treatment of Sanfilippo syndrome; and SLS-006, a partial dopamine agonist for the treatment of patients with Parkinson's disease (PD). Its preclinical programs include SLS-007, an anti-alpha-synuclein peptidic inhibitor to treat patients with PD; SLS-008, an orally available antagonist for chemoattractant receptor-homologous molecule for the treatment of chronic inflammation in asthma and pediatric orphan indications; SLS-004 for the treatment of PD; SLS-010, an oral histamine H3A receptor antagonist for narcolepsy and related disorders; and SLS-012, an injectable therapy for post-operative pain management. Seelos Therapeutics, Inc. was founded in 2016 and is headquartered in New York, New York."
SEER,2018-12-31,NA,-6307000,NA,-6307000,2982000,-3776000,-6758000,-6758000,-5000,0,0,6758000,3776000,451000,NA,-6307000,-6307000,NA,income_statement,Biotechnology,"Seer, Inc.","Seer, Inc., a life sciences company, engages in developing and commercializing products for researchers to unlock biological information. The company develops Proteograph Product Suite, an integrated solution that comprises consumables, an automation instrumentation, and software that provides workflow to make proteomic profiling, and the analysis of the samples needed to characterize the nature of the proteome. It intends to sell its products for research purposes, which cover academic institutions, life sciences, and research laboratories, as well as biopharmaceutical and biotechnology companies for non-diagnostic and non-clinical purposes. Seer, Inc. has a collaboration program agreement with Discovery Life Sciences, LLC; and commercial agreements with Bruker Scientific LLC and Thermo Electron North America LLC. The company was formerly known as Seer Biosciences, Inc. and changed its name to Seer, Inc. in July 2018. Seer, Inc. was incorporated in 2017 and is headquartered in Redwood City, California."
SEER,2019-12-31,NA,-16038000,NA,-16038000,4606000,-12277000,-16883000,-16883000,-5000,0,116000,16999000,12393000,845000,NA,-16038000,-16038000,NA,income_statement,Biotechnology,"Seer, Inc.","Seer, Inc., a life sciences company, engages in developing and commercializing products for researchers to unlock biological information. The company develops Proteograph Product Suite, an integrated solution that comprises consumables, an automation instrumentation, and software that provides workflow to make proteomic profiling, and the analysis of the samples needed to characterize the nature of the proteome. It intends to sell its products for research purposes, which cover academic institutions, life sciences, and research laboratories, as well as biopharmaceutical and biotechnology companies for non-diagnostic and non-clinical purposes. Seer, Inc. has a collaboration program agreement with Discovery Life Sciences, LLC; and commercial agreements with Bruker Scientific LLC and Thermo Electron North America LLC. The company was formerly known as Seer Biosciences, Inc. and changed its name to Seer, Inc. in July 2018. Seer, Inc. was incorporated in 2017 and is headquartered in Redwood City, California."
SEIC,2017-12-31,NA,557039000,NA,404389000,645094000,1153990000,396944000,396944000,-781000,152650000,1526552000,1129608000,372562000,160095000,NA,404389000,404389000,NA,income_statement,Asset Management,SEI Investments Company,"SEI Investments Company is a publicly owned asset management holding company. Through its subsidiaries, the firm provides wealth management, retirement and investment solutions, asset management, asset administration, investment processing outsourcing solutions, financial services, and investment advisory services to its clients. It provides its services to private banks, independent financial advisers, institutional investors, investment managers, investment advisors, wealth management organizations, corporations, retirement scheme sponsors, not-for-profit organizations, hedge fund managers, registered investment advisers, independent broker-dealers, financial planners, life insurance agents, defined-benefit schemes, defined-contribution schemes, endowments, foundations, and board-designated fund, through its subsidiaries. Through its subsidiaries, the firm manages separate client-focused portfolios. It also launches and manages equity, fixed income, and balanced mutual funds, through its subsidiaries. Through its subsidiaries, the firm invests in public equity and fixed income markets. It employs fundamental and quantitative analysis with a focus on top-down and bottom-up analysis to make its investments, through its subsidiaries. SEI Investments Company was founded in 1968 and is based in Oaks, Pennsylvania."
SEIC,2018-12-31,NA,614206000,NA,505868000,712120000,1255600000,441988000,441988000,-645000,108338000,1624167000,1182179000,368567000,172218000,NA,505868000,505868000,NA,income_statement,Asset Management,SEI Investments Company,"SEI Investments Company is a publicly owned asset management holding company. Through its subsidiaries, the firm provides wealth management, retirement and investment solutions, asset management, asset administration, investment processing outsourcing solutions, financial services, and investment advisory services to its clients. It provides its services to private banks, independent financial advisers, institutional investors, investment managers, investment advisors, wealth management organizations, corporations, retirement scheme sponsors, not-for-profit organizations, hedge fund managers, registered investment advisers, independent broker-dealers, financial planners, life insurance agents, defined-benefit schemes, defined-contribution schemes, endowments, foundations, and board-designated fund, through its subsidiaries. Through its subsidiaries, the firm manages separate client-focused portfolios. It also launches and manages equity, fixed income, and balanced mutual funds, through its subsidiaries. Through its subsidiaries, the firm invests in public equity and fixed income markets. It employs fundamental and quantitative analysis with a focus on top-down and bottom-up analysis to make its investments, through its subsidiaries. SEI Investments Company was founded in 1968 and is based in Oaks, Pennsylvania."
SEIC,2019-12-31,NA,631441000,NA,501426000,722636000,1287929000,459856000,459856000,-630000,130015000,1649885000,1190029000,361956000,171585000,NA,501426000,501426000,NA,income_statement,Asset Management,SEI Investments Company,"SEI Investments Company is a publicly owned asset management holding company. Through its subsidiaries, the firm provides wealth management, retirement and investment solutions, asset management, asset administration, investment processing outsourcing solutions, financial services, and investment advisory services to its clients. It provides its services to private banks, independent financial advisers, institutional investors, investment managers, investment advisors, wealth management organizations, corporations, retirement scheme sponsors, not-for-profit organizations, hedge fund managers, registered investment advisers, independent broker-dealers, financial planners, life insurance agents, defined-benefit schemes, defined-contribution schemes, endowments, foundations, and board-designated fund, through its subsidiaries. Through its subsidiaries, the firm manages separate client-focused portfolios. It also launches and manages equity, fixed income, and balanced mutual funds, through its subsidiaries. Through its subsidiaries, the firm invests in public equity and fixed income markets. It employs fundamental and quantitative analysis with a focus on top-down and bottom-up analysis to make its investments, through its subsidiaries. SEI Investments Company was founded in 1968 and is based in Oaks, Pennsylvania."
SEIC,2020-12-31,NA,568694000,NA,447286000,755425000,1312260000,445887000,445887000,-609000,121408000,1684058000,1238171000,371798000,122807000,NA,447286000,447286000,NA,income_statement,Asset Management,SEI Investments Company,"SEI Investments Company is a publicly owned asset management holding company. Through its subsidiaries, the firm provides wealth management, retirement and investment solutions, asset management, asset administration, investment processing outsourcing solutions, financial services, and investment advisory services to its clients. It provides its services to private banks, independent financial advisers, institutional investors, investment managers, investment advisors, wealth management organizations, corporations, retirement scheme sponsors, not-for-profit organizations, hedge fund managers, registered investment advisers, independent broker-dealers, financial planners, life insurance agents, defined-benefit schemes, defined-contribution schemes, endowments, foundations, and board-designated fund, through its subsidiaries. Through its subsidiaries, the firm manages separate client-focused portfolios. It also launches and manages equity, fixed income, and balanced mutual funds, through its subsidiaries. Through its subsidiaries, the firm invests in public equity and fixed income markets. It employs fundamental and quantitative analysis with a focus on top-down and bottom-up analysis to make its investments, through its subsidiaries. SEI Investments Company was founded in 1968 and is based in Oaks, Pennsylvania."
SELB,2016-12-31,14402000,-36210000,NA,-36210000,13051000,-7217000,-34670000,-34670000,-1253000,0,8083000,42753000,15300000,-1540000,NA,-36210000,-40776000,NA,income_statement,Biotechnology,"Selecta Biosciences, Inc.","Selecta Biosciences, Inc., a clinical-stage biopharmaceutical company, researches and develops nanoparticle immunomodulatory drugs for the treatment and prevention of human diseases. Its proprietary pipeline includes therapeutic enzymes, gene therapies, and other products and product candidates affected by undesired immune responses. The company's lead product is SEL-212 that has completed Phase II clinical trials for the treatment of chronic refractory gout. It also engages in the development of gene therapy product candidates that are in preclinical development for rare inborn errors of metabolism, including SEL-302, a therapy program for the treatment methylmalonic academia; and SEL-313, a product candidate to treat ornithine transcarbamylase deficiency. Selecta Biosciences, Inc. has license and collaboration agreements with Spark Therapeutics; Massachusetts Institute of Technology; Shenyang Sunshine Pharmaceutical Co., Ltd.; BIND Therapeutics, Inc.; Asklepios BioPharmaceutical, Inc. Sarepta Therapeutics, Inc.; and IGAN Biosciences, Inc. Selecta Biosciences, Inc. was founded in 2007 and is headquartered in Watertown, Massachusetts."
SELB,2017-12-31,17412000,-65321000,NA,-65321000,18826000,-27546000,-63784000,-63784000,-1206000,0,207000,63991000,27753000,-1537000,NA,-65321000,-65321000,NA,income_statement,Biotechnology,"Selecta Biosciences, Inc.","Selecta Biosciences, Inc., a clinical-stage biopharmaceutical company, researches and develops nanoparticle immunomodulatory drugs for the treatment and prevention of human diseases. Its proprietary pipeline includes therapeutic enzymes, gene therapies, and other products and product candidates affected by undesired immune responses. The company's lead product is SEL-212 that has completed Phase II clinical trials for the treatment of chronic refractory gout. It also engages in the development of gene therapy product candidates that are in preclinical development for rare inborn errors of metabolism, including SEL-302, a therapy program for the treatment methylmalonic academia; and SEL-313, a product candidate to treat ornithine transcarbamylase deficiency. Selecta Biosciences, Inc. has license and collaboration agreements with Spark Therapeutics; Massachusetts Institute of Technology; Shenyang Sunshine Pharmaceutical Co., Ltd.; BIND Therapeutics, Inc.; Asklepios BioPharmaceutical, Inc. Sarepta Therapeutics, Inc.; and IGAN Biosciences, Inc. Selecta Biosciences, Inc. was founded in 2007 and is headquartered in Watertown, Massachusetts."
SELB,2018-12-31,20692000,-65336000,NA,-65336000,18238000,-26092000,-65022000,-65022000,-1494000,0,903000,65925000,26995000,-314000,NA,-65336000,-65336000,NA,income_statement,Biotechnology,"Selecta Biosciences, Inc.","Selecta Biosciences, Inc., a clinical-stage biopharmaceutical company, researches and develops nanoparticle immunomodulatory drugs for the treatment and prevention of human diseases. Its proprietary pipeline includes therapeutic enzymes, gene therapies, and other products and product candidates affected by undesired immune responses. The company's lead product is SEL-212 that has completed Phase II clinical trials for the treatment of chronic refractory gout. It also engages in the development of gene therapy product candidates that are in preclinical development for rare inborn errors of metabolism, including SEL-302, a therapy program for the treatment methylmalonic academia; and SEL-313, a product candidate to treat ornithine transcarbamylase deficiency. Selecta Biosciences, Inc. has license and collaboration agreements with Spark Therapeutics; Massachusetts Institute of Technology; Shenyang Sunshine Pharmaceutical Co., Ltd.; BIND Therapeutics, Inc.; Asklepios BioPharmaceutical, Inc. Sarepta Therapeutics, Inc.; and IGAN Biosciences, Inc. Selecta Biosciences, Inc. was founded in 2007 and is headquartered in Watertown, Massachusetts."
SELB,2019-12-31,15594000,-55350000,NA,-55350000,16389000,-20472000,-52455000,-52455000,-1519000,0,6677000,59132000,27149000,-2895000,NA,-55350000,-55350000,NA,income_statement,Biotechnology,"Selecta Biosciences, Inc.","Selecta Biosciences, Inc., a clinical-stage biopharmaceutical company, researches and develops nanoparticle immunomodulatory drugs for the treatment and prevention of human diseases. Its proprietary pipeline includes therapeutic enzymes, gene therapies, and other products and product candidates affected by undesired immune responses. The company's lead product is SEL-212 that has completed Phase II clinical trials for the treatment of chronic refractory gout. It also engages in the development of gene therapy product candidates that are in preclinical development for rare inborn errors of metabolism, including SEL-302, a therapy program for the treatment methylmalonic academia; and SEL-313, a product candidate to treat ornithine transcarbamylase deficiency. Selecta Biosciences, Inc. has license and collaboration agreements with Spark Therapeutics; Massachusetts Institute of Technology; Shenyang Sunshine Pharmaceutical Co., Ltd.; BIND Therapeutics, Inc.; Asklepios BioPharmaceutical, Inc. Sarepta Therapeutics, Inc.; and IGAN Biosciences, Inc. Selecta Biosciences, Inc. was founded in 2007 and is headquartered in Watertown, Massachusetts."
SELF,2016-12-31,NA,310908,NA,310908,1460518,2879553,466528,466528,-456719,0,4981529,4515001,2101976,-155620,NA,310908,384135,NA,income_statement,REIT—Industrial,"Global Self Storage, Inc.","Global Self Storage is a self-administered and self-managed REIT that owns, operates, manages, acquires, develops and redevelops self-storage properties. The company's self-storage properties are designed to offer affordable, easily accessible and secure storage space for residential and commercial customers. Through its wholly owned subsidiaries, the company owns and/or manages 13 self-storage properties in Connecticut, Illinois, Indiana, New York, Ohio, Pennsylvania, South Carolina, and Oklahoma."
SELF,2017-12-31,NA,-146290,NA,-146290,1941880,4318906,677471,677471,-880834,0,7472793,6795322,3153887,-823761,NA,-146290,-146290,NA,income_statement,REIT—Industrial,"Global Self Storage, Inc.","Global Self Storage is a self-administered and self-managed REIT that owns, operates, manages, acquires, develops and redevelops self-storage properties. The company's self-storage properties are designed to offer affordable, easily accessible and secure storage space for residential and commercial customers. Through its wholly owned subsidiaries, the company owns and/or manages 13 self-storage properties in Connecticut, Illinois, Indiana, New York, Ohio, Pennsylvania, South Carolina, and Oklahoma."
SELF,2018-12-31,NA,619448,NA,619448,2024446,4848376,1425572,1425572,-897937,0,8110979,6685407,3262603,-806124,NA,619448,619448,NA,income_statement,REIT—Industrial,"Global Self Storage, Inc.","Global Self Storage is a self-administered and self-managed REIT that owns, operates, manages, acquires, develops and redevelops self-storage properties. The company's self-storage properties are designed to offer affordable, easily accessible and secure storage space for residential and commercial customers. Through its wholly owned subsidiaries, the company owns and/or manages 13 self-storage properties in Connecticut, Illinois, Indiana, New York, Ohio, Pennsylvania, South Carolina, and Oklahoma."
SELF,2019-12-31,NA,590619,NA,590619,2251232,5090964,1400824,1400824,-1075576,0,8668322,7267498,3577358,-810205,NA,590619,590619,NA,income_statement,REIT—Industrial,"Global Self Storage, Inc.","Global Self Storage is a self-administered and self-managed REIT that owns, operates, manages, acquires, develops and redevelops self-storage properties. The company's self-storage properties are designed to offer affordable, easily accessible and secure storage space for residential and commercial customers. Through its wholly owned subsidiaries, the company owns and/or manages 13 self-storage properties in Connecticut, Illinois, Indiana, New York, Ohio, Pennsylvania, South Carolina, and Oklahoma."
SENEB,2017-03-31,NA,25648000,NA,15895000,72996000,112004000,39000000,39000000,-9690000,9753000,1262198000,1223198000,1150194000,-13352000,-18529000,15895000,15726000,8000,income_statement,Packaged Foods,Seneca Foods Corp.,"Seneca Foods Corporation provides packaged fruits and vegetables in the United States and internationally. The company offers canned, frozen, and bottled produce; and snack chips and other food products under the private label, as well as under various national and regional brands that the company owns or licenses, including Seneca, Libby's, Aunt Nellie's, READ, Green Valley, Paradise, Seneca Farms, and CherryMan. It also packs Green Giant, Le Sueur, and other brands of canned vegetables, as well as select Green Giant frozen vegetables for B&G Foods North America under a contract packing agreement. In addition, the company engages in the sale of cans and ends, as well as trucking and aircraft operations. It provides its products to grocery outlets, including supermarkets, mass merchandisers, limited assortment stores, club stores, and dollar stores; and food service distributors, industrial markets, other food packagers, and export customers in 90 countries, as well as federal, state, and local governments for school and other feeding programs. The company was founded in 1949 and is headquartered in Marion, New York."
SENEB,2018-03-31,NA,8734000,NA,-8480000,70185000,81503000,11348000,11348000,-12827000,-1315000,1162894000,1151546000,1081391000,-2614000,-18529000,10049000,-8486000,-30000,income_statement,Packaged Foods,Seneca Foods Corp.,"Seneca Foods Corporation provides packaged fruits and vegetables in the United States and internationally. The company offers canned, frozen, and bottled produce; and snack chips and other food products under the private label, as well as under various national and regional brands that the company owns or licenses, including Seneca, Libby's, Aunt Nellie's, READ, Green Valley, Paradise, Seneca Farms, and CherryMan. It also packs Green Giant, Le Sueur, and other brands of canned vegetables, as well as select Green Giant frozen vegetables for B&G Foods North America under a contract packing agreement. In addition, the company engages in the sale of cans and ends, as well as trucking and aircraft operations. It provides its products to grocery outlets, including supermarkets, mass merchandisers, limited assortment stores, club stores, and dollar stores; and food service distributors, industrial markets, other food packagers, and export customers in 90 countries, as well as federal, state, and local governments for school and other feeding programs. The company was founded in 1949 and is headquartered in Marion, New York."
SENEB,2019-03-31,NA,-49259000,NA,5747000,72549000,39496000,-33022000,-33022000,-15165000,-12776000,1199581000,1232603000,1160085000,-16237000,42230000,-36483000,5678000,-31000,income_statement,Packaged Foods,Seneca Foods Corp.,"Seneca Foods Corporation provides packaged fruits and vegetables in the United States and internationally. The company offers canned, frozen, and bottled produce; and snack chips and other food products under the private label, as well as under various national and regional brands that the company owns or licenses, including Seneca, Libby's, Aunt Nellie's, READ, Green Valley, Paradise, Seneca Farms, and CherryMan. It also packs Green Giant, Le Sueur, and other brands of canned vegetables, as well as select Green Giant frozen vegetables for B&G Foods North America under a contract packing agreement. In addition, the company engages in the sale of cans and ends, as well as trucking and aircraft operations. It provides its products to grocery outlets, including supermarkets, mass merchandisers, limited assortment stores, club stores, and dollar stores; and food service distributors, industrial markets, other food packagers, and export customers in 90 countries, as well as federal, state, and local governments for school and other feeding programs. The company was founded in 1949 and is headquartered in Marion, New York."
SENEB,2020-03-31,NA,65615000,NA,52335000,76971000,141888000,64870000,64870000,-11859000,14427000,1335769000,1270899000,1193881000,745000,1147000,51188000,52078000,47000,income_statement,Packaged Foods,Seneca Foods Corp.,"Seneca Foods Corporation provides packaged fruits and vegetables in the United States and internationally. The company offers canned, frozen, and bottled produce; and snack chips and other food products under the private label, as well as under various national and regional brands that the company owns or licenses, including Seneca, Libby's, Aunt Nellie's, READ, Green Valley, Paradise, Seneca Farms, and CherryMan. It also packs Green Giant, Le Sueur, and other brands of canned vegetables, as well as select Green Giant frozen vegetables for B&G Foods North America under a contract packing agreement. In addition, the company engages in the sale of cans and ends, as well as trucking and aircraft operations. It provides its products to grocery outlets, including supermarkets, mass merchandisers, limited assortment stores, club stores, and dollar stores; and food service distributors, industrial markets, other food packagers, and export customers in 90 countries, as well as federal, state, and local governments for school and other feeding programs. The company was founded in 1949 and is headquartered in Marion, New York."
SESN,2016-12-31,14077000,1896000,NA,1891000,11436000,17602000,6166000,6166000,-247000,5000,29981000,23815000,12379000,-4270000,NA,1891000,1891000,NA,income_statement,Biotechnology,"Sesen Bio, Inc.","Sesen Bio, Inc., a late-stage clinical company, focuses on designing, engineering, developing, and commercializing targeted fusion protein therapeutics (TFPTs) for the treatment patients with cancer. The company's lead product candidates include Vicinium, a locally-administered targeted fusion protein that is in phase 3 clinical trials for the treatment of high-risk non-muscle invasive bladder cancer (NMIBC); and VB6-845d, a systemically-administered product candidate for use in the treatment of various types of EpCAM-positive solid tumors. It also develops Vicinium in combination with Durvalumab, which is in Phase I clinical trials for use in the treatment of high-risk NMIBC; and Vicinium in combination with AstraZeneca's checkpoint inhibitor for the treatment of squamous cell carcinoma of the head and neck. Sesen Bio, Inc. has an agreement with Leiden University Medical Center to co-develop an imaging agent. The company was formerly known as Eleven Biotherapeutics, Inc. and changed its name to Sesen Bio, Inc. in May 2018. Sesen Bio, Inc. was founded in 2008 and is headquartered in Cambridge, Massachusetts."
SESN,2017-12-31,14077000,-29029000,NA,-29029000,8070000,-12085000,-20155000,-20155000,NA,0,425000,20580000,12510000,-8869000,NA,-29029000,-29029000,NA,income_statement,Biotechnology,"Sesen Bio, Inc.","Sesen Bio, Inc., a late-stage clinical company, focuses on designing, engineering, developing, and commercializing targeted fusion protein therapeutics (TFPTs) for the treatment patients with cancer. The company's lead product candidates include Vicinium, a locally-administered targeted fusion protein that is in phase 3 clinical trials for the treatment of high-risk non-muscle invasive bladder cancer (NMIBC); and VB6-845d, a systemically-administered product candidate for use in the treatment of various types of EpCAM-positive solid tumors. It also develops Vicinium in combination with Durvalumab, which is in Phase I clinical trials for use in the treatment of high-risk NMIBC; and Vicinium in combination with AstraZeneca's checkpoint inhibitor for the treatment of squamous cell carcinoma of the head and neck. Sesen Bio, Inc. has an agreement with Leiden University Medical Center to co-develop an imaging agent. The company was formerly known as Eleven Biotherapeutics, Inc. and changed its name to Sesen Bio, Inc. in May 2018. Sesen Bio, Inc. was founded in 2008 and is headquartered in Cambridge, Massachusetts."
SESN,2018-12-31,14077000,-33693000,NA,-33693000,11623000,-14077000,-25700000,-25700000,NA,0,0,25700000,14077000,-7186000,NA,-33693000,-33693000,NA,income_statement,Biotechnology,"Sesen Bio, Inc.","Sesen Bio, Inc., a late-stage clinical company, focuses on designing, engineering, developing, and commercializing targeted fusion protein therapeutics (TFPTs) for the treatment patients with cancer. The company's lead product candidates include Vicinium, a locally-administered targeted fusion protein that is in phase 3 clinical trials for the treatment of high-risk non-muscle invasive bladder cancer (NMIBC); and VB6-845d, a systemically-administered product candidate for use in the treatment of various types of EpCAM-positive solid tumors. It also develops Vicinium in combination with Durvalumab, which is in Phase I clinical trials for use in the treatment of high-risk NMIBC; and Vicinium in combination with AstraZeneca's checkpoint inhibitor for the treatment of squamous cell carcinoma of the head and neck. Sesen Bio, Inc. has an agreement with Leiden University Medical Center to co-develop an imaging agent. The company was formerly known as Eleven Biotherapeutics, Inc. and changed its name to Sesen Bio, Inc. in May 2018. Sesen Bio, Inc. was founded in 2008 and is headquartered in Cambridge, Massachusetts."
SESN,2019-12-31,24663000,-107500000,NA,-107500000,12208000,-24663000,-36871000,-36871000,NA,0,0,36871000,24663000,-141258000,NA,-107500000,-107500000,NA,income_statement,Biotechnology,"Sesen Bio, Inc.","Sesen Bio, Inc., a late-stage clinical company, focuses on designing, engineering, developing, and commercializing targeted fusion protein therapeutics (TFPTs) for the treatment patients with cancer. The company's lead product candidates include Vicinium, a locally-administered targeted fusion protein that is in phase 3 clinical trials for the treatment of high-risk non-muscle invasive bladder cancer (NMIBC); and VB6-845d, a systemically-administered product candidate for use in the treatment of various types of EpCAM-positive solid tumors. It also develops Vicinium in combination with Durvalumab, which is in Phase I clinical trials for use in the treatment of high-risk NMIBC; and Vicinium in combination with AstraZeneca's checkpoint inhibitor for the treatment of squamous cell carcinoma of the head and neck. Sesen Bio, Inc. has an agreement with Leiden University Medical Center to co-develop an imaging agent. The company was formerly known as Eleven Biotherapeutics, Inc. and changed its name to Sesen Bio, Inc. in May 2018. Sesen Bio, Inc. was founded in 2008 and is headquartered in Cambridge, Massachusetts."
SFBC,2017-12-31,NA,8193000,NA,5125000,14358000,27440000,0,8734000,NA,3068000,27440000,18706000,0,-541000,NA,5125000,5125000,4348000,income_statement,Banks—Regional,"Sound Financial Bancorp, Inc.","Sound Financial Bancorp, Inc. operates as the bank holding company for Sound Community Bank that provides banking and other financial services for consumers and businesses. It accepts various deposits products comprising savings accounts, money market deposit accounts, NOW accounts, demand accounts, and certificates of deposit. The company also offers various loan products, such as loans secured by first and second mortgages on one-to four-family residences; home equity loans comprising fixed-rate loans and variable-rate lines of credit; commercial and multifamily real estate loans; construction loans secured by single-family residences, and commercial and multifamily real estate; land loans; secured and unsecured consumer loans, including new and used manufactured home loans, floating home loans, automobile loans, boat loans, and recreational vehicle loans, and loans secured by deposit accounts; and commercial business loans to finance commercial vehicles and equipment, as well as loans secured by accounts receivable and/or inventory. It operates eight branches offices, including five branches in Seattle Metropolitan Statistical Area, two branches in Clallam County, and one branch in Jefferson County; and two loan production offices in the Madison Park neighborhood of Seattle and Sequim. Sound Financial Bancorp, Inc. was incorporated in 2008 and is headquartered in Seattle, Washington."
SFBC,2018-12-31,NA,8745000,NA,7039000,17077000,31568000,0,9263000,NA,1706000,31568000,22305000,0,-518000,NA,7039000,7039000,5228000,income_statement,Banks—Regional,"Sound Financial Bancorp, Inc.","Sound Financial Bancorp, Inc. operates as the bank holding company for Sound Community Bank that provides banking and other financial services for consumers and businesses. It accepts various deposits products comprising savings accounts, money market deposit accounts, NOW accounts, demand accounts, and certificates of deposit. The company also offers various loan products, such as loans secured by first and second mortgages on one-to four-family residences; home equity loans comprising fixed-rate loans and variable-rate lines of credit; commercial and multifamily real estate loans; construction loans secured by single-family residences, and commercial and multifamily real estate; land loans; secured and unsecured consumer loans, including new and used manufactured home loans, floating home loans, automobile loans, boat loans, and recreational vehicle loans, and loans secured by deposit accounts; and commercial business loans to finance commercial vehicles and equipment, as well as loans secured by accounts receivable and/or inventory. It operates eight branches offices, including five branches in Seattle Metropolitan Statistical Area, two branches in Clallam County, and one branch in Jefferson County; and two loan production offices in the Madison Park neighborhood of Seattle and Sequim. Sound Financial Bancorp, Inc. was incorporated in 2008 and is headquartered in Seattle, Washington."
SFBC,2019-12-31,NA,8330000,NA,6679000,16942000,31115000,0,8644000,NA,1651000,31115000,22471000,0,-314000,NA,6679000,6679000,5529000,income_statement,Banks—Regional,"Sound Financial Bancorp, Inc.","Sound Financial Bancorp, Inc. operates as the bank holding company for Sound Community Bank that provides banking and other financial services for consumers and businesses. It accepts various deposits products comprising savings accounts, money market deposit accounts, NOW accounts, demand accounts, and certificates of deposit. The company also offers various loan products, such as loans secured by first and second mortgages on one-to four-family residences; home equity loans comprising fixed-rate loans and variable-rate lines of credit; commercial and multifamily real estate loans; construction loans secured by single-family residences, and commercial and multifamily real estate; land loans; secured and unsecured consumer loans, including new and used manufactured home loans, floating home loans, automobile loans, boat loans, and recreational vehicle loans, and loans secured by deposit accounts; and commercial business loans to finance commercial vehicles and equipment, as well as loans secured by accounts receivable and/or inventory. It operates eight branches offices, including five branches in Seattle Metropolitan Statistical Area, two branches in Clallam County, and one branch in Jefferson County; and two loan production offices in the Madison Park neighborhood of Seattle and Sequim. Sound Financial Bancorp, Inc. was incorporated in 2008 and is headquartered in Seattle, Washington."
SFBC,2020-12-31,NA,11328000,NA,8937000,16622000,34006000,0,11923000,NA,2391000,34006000,22083000,0,-595000,NA,8937000,8937000,5461000,income_statement,Banks—Regional,"Sound Financial Bancorp, Inc.","Sound Financial Bancorp, Inc. operates as the bank holding company for Sound Community Bank that provides banking and other financial services for consumers and businesses. It accepts various deposits products comprising savings accounts, money market deposit accounts, NOW accounts, demand accounts, and certificates of deposit. The company also offers various loan products, such as loans secured by first and second mortgages on one-to four-family residences; home equity loans comprising fixed-rate loans and variable-rate lines of credit; commercial and multifamily real estate loans; construction loans secured by single-family residences, and commercial and multifamily real estate; land loans; secured and unsecured consumer loans, including new and used manufactured home loans, floating home loans, automobile loans, boat loans, and recreational vehicle loans, and loans secured by deposit accounts; and commercial business loans to finance commercial vehicles and equipment, as well as loans secured by accounts receivable and/or inventory. It operates eight branches offices, including five branches in Seattle Metropolitan Statistical Area, two branches in Clallam County, and one branch in Jefferson County; and two loan production offices in the Madison Park neighborhood of Seattle and Sequim. Sound Financial Bancorp, Inc. was incorporated in 2008 and is headquartered in Seattle, Washington."
SFBS,2017-12-31,NA,137350000,502000,93092000,59555000,220478000,0,142106000,NA,44258000,220478000,78372000,0,-4756000,NA,93092000,93030000,18817000,income_statement,Banks—Regional,"ServisFirst Bancshares, Inc.","ServisFirst Bancshares, Inc. operates as the bank holding company for ServisFirst Bank that provides banking services to individual and corporate customers in the United States. It offers demand, time, savings, and other deposits; checking, money market, and IRA accounts; and certificates of deposit. The company also provides commercial lending products, such as seasonal loans, bridge loans, and term loans for working capital, expansion of the business, acquisition of property, and plant and equipment, as well as commercial lines of credit; commercial real estate loans, construction and development loans, and residential real estate loans; and consumer loans, such as home equity loans, vehicle financing, loans secured by deposits, and secured and unsecured personal loans. In addition, it offers other banking products and services comprising telephone and mobile banking, direct deposit, Internet banking, traveler's checks, safe deposit boxes, attorney trust accounts, automatic account transfers, automated teller machines, and debit card systems, as well as Visa credit cards; treasury and cash management services; wire transfer, night depository, banking-by-mail, and remote capture services; and correspondent banking services to other financial institutions. Further, the company, through its subsidiary, SF Intermediate Holding Company, Inc., operates as a real estate investment trust for the United States income tax purposes; and holds and manages participations in residential mortgages and commercial real estate loans originated by ServisFirst Bank in Alabama, Florida, Georgia, and Tennessee. It operates 20 full-service banking offices located in Jefferson, Shelby, Madison, Montgomery, Mobile, Baldwin, and Houston Counties in Alabama; Escambia and Hillsborough Counties in Florida; Cobb and Douglas Counties in Georgia; Charleston County in South Carolina; and Davidson County in Tennessee. The company was founded in 2005 and is headquartered in Birmingham, Alabama."
SFBS,2018-12-31,NA,168842000,502000,136940000,64475000,259967000,0,173965000,NA,31902000,259967000,86002000,0,-5123000,NA,136940000,136877000,21527000,income_statement,Banks—Regional,"ServisFirst Bancshares, Inc.","ServisFirst Bancshares, Inc. operates as the bank holding company for ServisFirst Bank that provides banking services to individual and corporate customers in the United States. It offers demand, time, savings, and other deposits; checking, money market, and IRA accounts; and certificates of deposit. The company also provides commercial lending products, such as seasonal loans, bridge loans, and term loans for working capital, expansion of the business, acquisition of property, and plant and equipment, as well as commercial lines of credit; commercial real estate loans, construction and development loans, and residential real estate loans; and consumer loans, such as home equity loans, vehicle financing, loans secured by deposits, and secured and unsecured personal loans. In addition, it offers other banking products and services comprising telephone and mobile banking, direct deposit, Internet banking, traveler's checks, safe deposit boxes, attorney trust accounts, automatic account transfers, automated teller machines, and debit card systems, as well as Visa credit cards; treasury and cash management services; wire transfer, night depository, banking-by-mail, and remote capture services; and correspondent banking services to other financial institutions. Further, the company, through its subsidiary, SF Intermediate Holding Company, Inc., operates as a real estate investment trust for the United States income tax purposes; and holds and manages participations in residential mortgages and commercial real estate loans originated by ServisFirst Bank in Alabama, Florida, Georgia, and Tennessee. It operates 20 full-service banking offices located in Jefferson, Shelby, Madison, Montgomery, Mobile, Baldwin, and Houston Counties in Alabama; Escambia and Hillsborough Counties in Florida; Cobb and Douglas Counties in Georgia; Charleston County in South Carolina; and Davidson County in Tennessee. The company was founded in 2005 and is headquartered in Birmingham, Alabama."
SFBS,2019-12-31,NA,186861000,502000,149243000,71871000,288243000,0,190828000,NA,37618000,288243000,97415000,0,-3967000,NA,149243000,149180000,25544000,income_statement,Banks—Regional,"ServisFirst Bancshares, Inc.","ServisFirst Bancshares, Inc. operates as the bank holding company for ServisFirst Bank that provides banking services to individual and corporate customers in the United States. It offers demand, time, savings, and other deposits; checking, money market, and IRA accounts; and certificates of deposit. The company also provides commercial lending products, such as seasonal loans, bridge loans, and term loans for working capital, expansion of the business, acquisition of property, and plant and equipment, as well as commercial lines of credit; commercial real estate loans, construction and development loans, and residential real estate loans; and consumer loans, such as home equity loans, vehicle financing, loans secured by deposits, and secured and unsecured personal loans. In addition, it offers other banking products and services comprising telephone and mobile banking, direct deposit, Internet banking, traveler's checks, safe deposit boxes, attorney trust accounts, automatic account transfers, automated teller machines, and debit card systems, as well as Visa credit cards; treasury and cash management services; wire transfer, night depository, banking-by-mail, and remote capture services; and correspondent banking services to other financial institutions. Further, the company, through its subsidiary, SF Intermediate Holding Company, Inc., operates as a real estate investment trust for the United States income tax purposes; and holds and manages participations in residential mortgages and commercial real estate loans originated by ServisFirst Bank in Alabama, Florida, Georgia, and Tennessee. It operates 20 full-service banking offices located in Jefferson, Shelby, Madison, Montgomery, Mobile, Baldwin, and Houston Counties in Alabama; Escambia and Hillsborough Counties in Florida; Cobb and Douglas Counties in Georgia; Charleston County in South Carolina; and Davidson County in Tennessee. The company was founded in 2005 and is headquartered in Birmingham, Alabama."
SFBS,2020-12-31,NA,214208000,500000,169569000,89504000,325719000,0,220725000,NA,44639000,325719000,104994000,0,-6517000,NA,169569000,169506000,15490000,income_statement,Banks—Regional,"ServisFirst Bancshares, Inc.","ServisFirst Bancshares, Inc. operates as the bank holding company for ServisFirst Bank that provides banking services to individual and corporate customers in the United States. It offers demand, time, savings, and other deposits; checking, money market, and IRA accounts; and certificates of deposit. The company also provides commercial lending products, such as seasonal loans, bridge loans, and term loans for working capital, expansion of the business, acquisition of property, and plant and equipment, as well as commercial lines of credit; commercial real estate loans, construction and development loans, and residential real estate loans; and consumer loans, such as home equity loans, vehicle financing, loans secured by deposits, and secured and unsecured personal loans. In addition, it offers other banking products and services comprising telephone and mobile banking, direct deposit, Internet banking, traveler's checks, safe deposit boxes, attorney trust accounts, automatic account transfers, automated teller machines, and debit card systems, as well as Visa credit cards; treasury and cash management services; wire transfer, night depository, banking-by-mail, and remote capture services; and correspondent banking services to other financial institutions. Further, the company, through its subsidiary, SF Intermediate Holding Company, Inc., operates as a real estate investment trust for the United States income tax purposes; and holds and manages participations in residential mortgages and commercial real estate loans originated by ServisFirst Bank in Alabama, Florida, Georgia, and Tennessee. It operates 20 full-service banking offices located in Jefferson, Shelby, Madison, Montgomery, Mobile, Baldwin, and Houston Counties in Alabama; Escambia and Hillsborough Counties in Florida; Cobb and Douglas Counties in Georgia; Charleston County in South Carolina; and Davidson County in Tennessee. The company was founded in 2005 and is headquartered in Birmingham, Alabama."
SFET,2016-12-31,1085000,-8920000,NA,-8922000,5015000,331000,-5769000,-5769000,NA,2000,843000,6612000,512000,-3151000,NA,-8922000,-8922000,NA,income_statement,Software—Infrastructure,Safe-T Group Ltd.,"Safe-T Group Ltd. develops and markets cyber security solutions in Israel, North America, the Asia-Pacific, Africa, Europe, and internationally. The company offers on-demand software defined perimeter solutions, which protect access to data and services by separating the access layer from the authentication layer, as well as by segregating internal networks and granting access only to authorized users; and software-defined access solutions that controls and secures data exchange, as well as prevents data exfiltration, leakage, malware, ransomware, and fraud. It serves customers in healthcare, financial services, insurance, retail, manufacturing, law firms, and defense and law enforcement industries, as well as governments and education institutions. The company was founded in 2013 and is headquartered in Herzliya, Israel."
SFET,2017-12-31,1608000,-5312000,NA,-5313000,6201000,513000,-7296000,-7296000,NA,1000,1096000,8392000,583000,1984000,NA,-5313000,-5313000,NA,income_statement,Software—Infrastructure,Safe-T Group Ltd.,"Safe-T Group Ltd. develops and markets cyber security solutions in Israel, North America, the Asia-Pacific, Africa, Europe, and internationally. The company offers on-demand software defined perimeter solutions, which protect access to data and services by separating the access layer from the authentication layer, as well as by segregating internal networks and granting access only to authorized users; and software-defined access solutions that controls and secures data exchange, as well as prevents data exfiltration, leakage, malware, ransomware, and fraud. It serves customers in healthcare, financial services, insurance, retail, manufacturing, law firms, and defense and law enforcement industries, as well as governments and education institutions. The company was founded in 2013 and is headquartered in Herzliya, Israel."
SFET,2018-12-31,2414000,-11747000,NA,-11753000,7467000,675000,-9206000,-9206000,NA,6000,1466000,10672000,791000,-2541000,NA,-11753000,-11753000,NA,income_statement,Software—Infrastructure,Safe-T Group Ltd.,"Safe-T Group Ltd. develops and markets cyber security solutions in Israel, North America, the Asia-Pacific, Africa, Europe, and internationally. The company offers on-demand software defined perimeter solutions, which protect access to data and services by separating the access layer from the authentication layer, as well as by segregating internal networks and granting access only to authorized users; and software-defined access solutions that controls and secures data exchange, as well as prevents data exfiltration, leakage, malware, ransomware, and fraud. It serves customers in healthcare, financial services, insurance, retail, manufacturing, law firms, and defense and law enforcement industries, as well as governments and education institutions. The company was founded in 2013 and is headquartered in Herzliya, Israel."
SFET,2019-12-31,2485000,-12975000,NA,-12998000,7540000,1665000,-8360000,-8360000,NA,23000,3284000,11644000,1619000,-4615000,NA,-12998000,-12998000,NA,income_statement,Software—Infrastructure,Safe-T Group Ltd.,"Safe-T Group Ltd. develops and markets cyber security solutions in Israel, North America, the Asia-Pacific, Africa, Europe, and internationally. The company offers on-demand software defined perimeter solutions, which protect access to data and services by separating the access layer from the authentication layer, as well as by segregating internal networks and granting access only to authorized users; and software-defined access solutions that controls and secures data exchange, as well as prevents data exfiltration, leakage, malware, ransomware, and fraud. It serves customers in healthcare, financial services, insurance, retail, manufacturing, law firms, and defense and law enforcement industries, as well as governments and education institutions. The company was founded in 2013 and is headquartered in Herzliya, Israel."
SFIX,2017-07-29,NA,12801000,NA,-594000,402781000,434421000,31640000,31640000,NA,13395000,977139000,945499000,542718000,-18839000,NA,-594000,-594000,NA,income_statement,Specialty Retail,"Stitch Fix, Inc.","Stitch Fix, Inc. sells a range of apparel, shoes, and accessories through its Website and mobile application in the United States. It offers denim, dresses, blouses, skirts, shoes, jewelry, and handbags for men, women, and kids under the Stitch Fix brand. The company was formerly known as rack habit inc. and changed its name to Stitch Fix, Inc. in October 2011. Stitch Fix, Inc. was founded in 2011 and is headquartered in San Francisco, California."
SFIX,2018-07-28,NA,54713000,NA,44900000,492998000,536022000,43024000,43024000,NA,9813000,1226505000,1183481000,690483000,11689000,NA,44900000,35541000,NA,income_statement,Specialty Retail,"Stitch Fix, Inc.","Stitch Fix, Inc. sells a range of apparel, shoes, and accessories through its Website and mobile application in the United States. It offers denim, dresses, blouses, skirts, shoes, jewelry, and handbags for men, women, and kids under the Stitch Fix brand. The company was formerly known as rack habit inc. and changed its name to Stitch Fix, Inc. in October 2011. Stitch Fix, Inc. was founded in 2011 and is headquartered in San Francisco, California."
SFIX,2019-08-03,NA,30821000,NA,36881000,679634000,703129000,23495000,23495000,NA,-6060000,1577558000,1554063000,874429000,7326000,NA,36881000,36863000,NA,income_statement,Specialty Retail,"Stitch Fix, Inc.","Stitch Fix, Inc. sells a range of apparel, shoes, and accessories through its Website and mobile application in the United States. It offers denim, dresses, blouses, skirts, shoes, jewelry, and handbags for men, women, and kids under the Stitch Fix brand. The company was formerly known as rack habit inc. and changed its name to Stitch Fix, Inc. in October 2011. Stitch Fix, Inc. was founded in 2011 and is headquartered in San Francisco, California."
SFIX,2020-08-01,NA,-47722000,NA,-67117000,805874000,754210000,-51664000,-51664000,NA,19395000,1711733000,1763397000,957523000,3942000,NA,-67117000,-67117000,NA,income_statement,Specialty Retail,"Stitch Fix, Inc.","Stitch Fix, Inc. sells a range of apparel, shoes, and accessories through its Website and mobile application in the United States. It offers denim, dresses, blouses, skirts, shoes, jewelry, and handbags for men, women, and kids under the Stitch Fix brand. The company was formerly known as rack habit inc. and changed its name to Stitch Fix, Inc. in October 2011. Stitch Fix, Inc. was founded in 2011 and is headquartered in San Francisco, California."
SFM,2017-01-01,NA,198592000,NA,124306000,1068995000,1363448000,215932000,215932000,-14794000,74286000,4046385000,3830453000,2682937000,-17340000,NA,124306000,124306000,228000,income_statement,Grocery Stores,"Sprouts Farmers Market, Inc.","Sprouts Farmers Market, Inc., a healthy grocery store, provides fresh, natural, and organic food products in the United States. Its stores offer fresh produce, packaged groceries, meat and seafood, deli, vitamins and supplements, dairy and dairy alternatives, bulk items, baked goods, frozen foods, natural health and body care, beer and wine, and household items. As of February 20, 2020, it operated 341 stores in 22 states. Sprouts Farmers Market, Inc. was founded in 2002 and is based in Phoenix, Arizona."
SFM,2017-12-31,NA,205518000,NA,158440000,1245640000,1567030000,226770000,226770000,-20561000,47078000,4664612000,4437842000,3097582000,-21252000,NA,158440000,158440000,426000,income_statement,Grocery Stores,"Sprouts Farmers Market, Inc.","Sprouts Farmers Market, Inc., a healthy grocery store, provides fresh, natural, and organic food products in the United States. Its stores offer fresh produce, packaged groceries, meat and seafood, deli, vitamins and supplements, dairy and dairy alternatives, bulk items, baked goods, frozen foods, natural health and body care, beer and wine, and household items. As of February 20, 2020, it operated 341 stores in 22 states. Sprouts Farmers Market, Inc. was founded in 2002 and is based in Phoenix, Arizona."
SFM,2018-12-30,NA,195796000,NA,158536000,1404443000,1747475000,234511000,234511000,-27574000,37260000,5207336000,4972825000,3459861000,-38715000,NA,158536000,158536000,476000,income_statement,Grocery Stores,"Sprouts Farmers Market, Inc.","Sprouts Farmers Market, Inc., a healthy grocery store, provides fresh, natural, and organic food products in the United States. Its stores offer fresh produce, packaged groceries, meat and seafood, deli, vitamins and supplements, dairy and dairy alternatives, bulk items, baked goods, frozen foods, natural health and body care, beer and wine, and household items. As of February 20, 2020, it operated 341 stores in 22 states. Sprouts Farmers Market, Inc. was founded in 2002 and is based in Phoenix, Arizona."
SFM,2019-12-29,NA,196168000,NA,149629000,1557907000,1903018000,222660000,222660000,-20994000,46539000,5634835000,5412175000,3731817000,-26492000,NA,149629000,149629000,1960000,income_statement,Grocery Stores,"Sprouts Farmers Market, Inc.","Sprouts Farmers Market, Inc., a healthy grocery store, provides fresh, natural, and organic food products in the United States. Its stores offer fresh produce, packaged groceries, meat and seafood, deli, vitamins and supplements, dairy and dairy alternatives, bulk items, baked goods, frozen foods, natural health and body care, beer and wine, and household items. As of February 20, 2020, it operated 341 stores in 22 states. Sprouts Farmers Market, Inc. was founded in 2002 and is based in Phoenix, Arizona."
SFNC,2016-12-31,NA,143438000,NA,96814000,182679000,398523000,0,159803000,NA,46624000,398523000,238720000,0,-16365000,NA,96814000,96790000,56041000,income_statement,Banks—Regional,Simmons First National Corporat,"Simmons First National Corporation operates as the holding company for Simmons Bank that provides financial products and services to individuals and businesses. It offers checking, savings, and time deposits; consumer, real estate, and commercial loans; agricultural finance, equipment, and small business administration lending; trust and fiduciary services; credit cards; investment management products; insurance products; and securities and investment services. As of September 30, 2020, the company operated through approximately 226 financial centers located throughout market areas in Arkansas, Illinois, Kansas, Missouri, Oklahoma, Tennessee, and Texas. Simmons First National Corporation was founded in 1903 and is headquartered in Pine Bluff, Arkansas."
SFNC,2017-12-31,NA,154923000,NA,92940000,205980000,467302000,0,184018000,NA,61983000,467302000,283284000,0,-29095000,NA,92940000,92940000,77304000,income_statement,Banks—Regional,Simmons First National Corporat,"Simmons First National Corporation operates as the holding company for Simmons Bank that provides financial products and services to individuals and businesses. It offers checking, savings, and time deposits; consumer, real estate, and commercial loans; agricultural finance, equipment, and small business administration lending; trust and fiduciary services; credit cards; investment management products; insurance products; and securities and investment services. As of September 30, 2020, the company operated through approximately 226 financial centers located throughout market areas in Arkansas, Illinois, Kansas, Missouri, Oklahoma, Tennessee, and Texas. Simmons First National Corporation was founded in 1903 and is headquartered in Pine Bluff, Arkansas."
SFNC,2018-12-31,NA,266071000,NA,215713000,271086000,658300000,0,285390000,NA,50358000,658300000,372910000,0,-19319000,NA,215713000,215713000,101824000,income_statement,Banks—Regional,Simmons First National Corporat,"Simmons First National Corporation operates as the holding company for Simmons Bank that provides financial products and services to individuals and businesses. It offers checking, savings, and time deposits; consumer, real estate, and commercial loans; agricultural finance, equipment, and small business administration lending; trust and fiduciary services; credit cards; investment management products; insurance products; and securities and investment services. As of September 30, 2020, the company operated through approximately 226 financial centers located throughout market areas in Arkansas, Illinois, Kansas, Missouri, Oklahoma, Tennessee, and Texas. Simmons First National Corporation was founded in 1903 and is headquartered in Pine Bluff, Arkansas."
SFNC,2019-12-31,NA,302432000,NA,238167000,291058000,763544000,0,353262000,NA,64265000,763544000,410282000,0,-50830000,NA,238167000,237828000,119224000,income_statement,Banks—Regional,Simmons First National Corporat,"Simmons First National Corporation operates as the holding company for Simmons Bank that provides financial products and services to individuals and businesses. It offers checking, savings, and time deposits; consumer, real estate, and commercial loans; agricultural finance, equipment, and small business administration lending; trust and fiduciary services; credit cards; investment management products; insurance products; and securities and investment services. As of September 30, 2020, the company operated through approximately 226 financial centers located throughout market areas in Arkansas, Illinois, Kansas, Missouri, Oklahoma, Tennessee, and Texas. Simmons First National Corporation was founded in 1903 and is headquartered in Pine Bluff, Arkansas."
SFST,2017-12-31,NA,23661000,NA,13045000,31169000,58213000,0,24807000,NA,10616000,58213000,33406000,0,-1146000,NA,13045000,13045000,2237000,income_statement,Banks—Regional,"Southern First Bancshares, Inc.","Southern First Bancshares, Inc. operates as the bank holding company for Southern First Bank that provides various banking products and services to general public in South Carolina, North Carolina, and Georgia. It accepts various deposit products that include checking accounts, commercial checking accounts, savings accounts, and other time deposits, including daily money market accounts and long-term certificates of deposit. The company's loan portfolio comprises commercial real estate loans; construction real estate loans; commercial business loans for various lines of businesses, such as the manufacturing, service industry, and professional service areas; consumer real estate and home equity loans; and other consumer loans, including secured and unsecured installment loans and revolving lines of credit. In addition, it provides other bank services, such as internet banking, cash management, safe deposit boxes, direct deposit, automatic drafts, bill payment, and mobile banking services. The company operates through ten retail offices located in Greenville, Columbia, and Charleston; two retail offices located in Raleigh and Greensboro markets; and one retail office located in Atlanta. Southern First Bancshares, Inc. was founded in 1999 and is headquartered in Greenville, South Carolina."
SFST,2018-12-31,NA,28690000,NA,22289000,36342000,68453000,0,29974000,NA,6401000,68453000,38479000,0,-1284000,NA,22289000,22289000,2137000,income_statement,Banks—Regional,"Southern First Bancshares, Inc.","Southern First Bancshares, Inc. operates as the bank holding company for Southern First Bank that provides various banking products and services to general public in South Carolina, North Carolina, and Georgia. It accepts various deposit products that include checking accounts, commercial checking accounts, savings accounts, and other time deposits, including daily money market accounts and long-term certificates of deposit. The company's loan portfolio comprises commercial real estate loans; construction real estate loans; commercial business loans for various lines of businesses, such as the manufacturing, service industry, and professional service areas; consumer real estate and home equity loans; and other consumer loans, including secured and unsecured installment loans and revolving lines of credit. In addition, it provides other bank services, such as internet banking, cash management, safe deposit boxes, direct deposit, automatic drafts, bill payment, and mobile banking services. The company operates through ten retail offices located in Greenville, Columbia, and Charleston; two retail offices located in Raleigh and Greensboro markets; and one retail office located in Atlanta. Southern First Bancshares, Inc. was founded in 1999 and is headquartered in Greenville, South Carolina."
SFST,2019-12-31,NA,35479000,NA,27858000,41379000,81448000,0,37788000,NA,7621000,81448000,43660000,0,-2309000,NA,27858000,27858000,2281000,income_statement,Banks—Regional,"Southern First Bancshares, Inc.","Southern First Bancshares, Inc. operates as the bank holding company for Southern First Bank that provides various banking products and services to general public in South Carolina, North Carolina, and Georgia. It accepts various deposit products that include checking accounts, commercial checking accounts, savings accounts, and other time deposits, including daily money market accounts and long-term certificates of deposit. The company's loan portfolio comprises commercial real estate loans; construction real estate loans; commercial business loans for various lines of businesses, such as the manufacturing, service industry, and professional service areas; consumer real estate and home equity loans; and other consumer loans, including secured and unsecured installment loans and revolving lines of credit. In addition, it provides other bank services, such as internet banking, cash management, safe deposit boxes, direct deposit, automatic drafts, bill payment, and mobile banking services. The company operates through ten retail offices located in Greenville, Columbia, and Charleston; two retail offices located in Raleigh and Greensboro markets; and one retail office located in Atlanta. Southern First Bancshares, Inc. was founded in 1999 and is headquartered in Greenville, South Carolina."
SFST,2020-12-31,NA,23819000,NA,18328000,39135000,77600000,0,26459000,NA,5491000,77600000,51141000,0,-2640000,NA,18328000,18328000,12006000,income_statement,Banks—Regional,"Southern First Bancshares, Inc.","Southern First Bancshares, Inc. operates as the bank holding company for Southern First Bank that provides various banking products and services to general public in South Carolina, North Carolina, and Georgia. It accepts various deposit products that include checking accounts, commercial checking accounts, savings accounts, and other time deposits, including daily money market accounts and long-term certificates of deposit. The company's loan portfolio comprises commercial real estate loans; construction real estate loans; commercial business loans for various lines of businesses, such as the manufacturing, service industry, and professional service areas; consumer real estate and home equity loans; and other consumer loans, including secured and unsecured installment loans and revolving lines of credit. In addition, it provides other bank services, such as internet banking, cash management, safe deposit boxes, direct deposit, automatic drafts, bill payment, and mobile banking services. The company operates through ten retail offices located in Greenville, Columbia, and Charleston; two retail offices located in Raleigh and Greensboro markets; and one retail office located in Atlanta. Southern First Bancshares, Inc. was founded in 1999 and is headquartered in Greenville, South Carolina."
SFT,2017-12-31,NA,-25646000,NA,-25646000,28570000,4539000,-25598000,-25598000,-261000,0,94538000,120136000,89999000,-48000,NA,-25646000,-25646000,NA,income_statement,Internet Retail,"Shift Technologies, Inc.","Shift Technologies, Inc. provides an online platform that allows people to buy and sell their new and used cars. The company offers sedans, hatchbacks, wagons, SUVs, vans, coupes, convertibles, and trucks. It also offers financing options. The company was founded in 2013 and is based in San Francisco, California with physical locations in San Francisco, Los Angeles, San Diego, and Sacramento, California; and Portland, Oregon."
SFT,2018-12-31,NA,-44866000,NA,-44866000,44697000,5389000,-41838000,-41838000,-3171000,0,131812000,173650000,126423000,-3028000,NA,-44866000,-44866000,NA,income_statement,Internet Retail,"Shift Technologies, Inc.","Shift Technologies, Inc. provides an online platform that allows people to buy and sell their new and used cars. The company offers sedans, hatchbacks, wagons, SUVs, vans, coupes, convertibles, and trucks. It also offers financing options. The company was founded in 2013 and is based in San Francisco, California with physical locations in San Francisco, Los Angeles, San Diego, and Sacramento, California; and Portland, Oregon."
SFT,2019-12-31,NA,-80483000,NA,-80483000,71860000,-1762000,-76843000,-76843000,-5461000,0,166235000,243078000,167997000,-3640000,NA,-80483000,-80483000,NA,income_statement,Internet Retail,"Shift Technologies, Inc.","Shift Technologies, Inc. provides an online platform that allows people to buy and sell their new and used cars. The company offers sedans, hatchbacks, wagons, SUVs, vans, coupes, convertibles, and trucks. It also offers financing options. The company was founded in 2013 and is based in San Francisco, California with physical locations in San Francisco, Los Angeles, San Diego, and Sacramento, California; and Portland, Oregon."
SG,2016-12-31,NA,44500000,251300000,32500000,85100000,187900000,79500000,79500000,-34600000,-7300000,1001500000,922000000,813600000,-35000000,NA,51800000,32500000,23300000,income_statement,Insurance—Property & Casualty,Sirius International Insurance,"Sirius International Insurance Group, Ltd., through its subsidiaries, provides insurance and reinsurance products worldwide. The company operates through four segments: Global Reinsurance, Global A&H, U.S. Specialty, and Runoff and Other. It offers property insurance and reinsurance; property catastrophe excess reinsurance; agriculture reinsurance; healthcare and medical travel insurance; insurance and reinsurance product lines, including aviation and space, marine, trade credit, contingency, casualty, surety, and environmental specialty lines; and asbestos risks, environmental risks, and other long-tailed liability exposure products, as well as administration services. The company is also involved in the acquisition and management of runoff liabilities for insurance and reinsurance companies. Sirius International Insurance Group, Ltd. is based in Hamilton, Bermuda."
SG,2017-12-31,NA,-109900000,200000,-150000000,91900000,-15000000,-140500000,-140500000,-22400000,26400000,1076100000,1216600000,1091100000,30600000,NA,-136300000,-156100000,23400000,income_statement,Insurance—Property & Casualty,Sirius International Insurance,"Sirius International Insurance Group, Ltd., through its subsidiaries, provides insurance and reinsurance products worldwide. The company operates through four segments: Global Reinsurance, Global A&H, U.S. Specialty, and Runoff and Other. It offers property insurance and reinsurance; property catastrophe excess reinsurance; agriculture reinsurance; healthcare and medical travel insurance; insurance and reinsurance product lines, including aviation and space, marine, trade credit, contingency, casualty, surety, and environmental specialty lines; and asbestos risks, environmental risks, and other long-tailed liability exposure products, as well as administration services. The company is also involved in the acquisition and management of runoff liabilities for insurance and reinsurance companies. Sirius International Insurance Group, Ltd. is based in Hamilton, Bermuda."
SG,2018-12-31,NA,23700000,1700000,-18100000,77900000,151300000,30200000,30200000,-30800000,40400000,1425500000,1395300000,1274200000,-6500000,NA,-16700000,-43300000,27400000,income_statement,Insurance—Property & Casualty,Sirius International Insurance,"Sirius International Insurance Group, Ltd., through its subsidiaries, provides insurance and reinsurance products worldwide. The company operates through four segments: Global Reinsurance, Global A&H, U.S. Specialty, and Runoff and Other. It offers property insurance and reinsurance; property catastrophe excess reinsurance; agriculture reinsurance; healthcare and medical travel insurance; insurance and reinsurance product lines, including aviation and space, marine, trade credit, contingency, casualty, surety, and environmental specialty lines; and asbestos risks, environmental risks, and other long-tailed liability exposure products, as well as administration services. The company is also involved in the acquisition and management of runoff liabilities for insurance and reinsurance companies. Sirius International Insurance Group, Ltd. is based in Hamilton, Bermuda."
SG,2019-12-31,NA,-33700000,2400000,-47300000,109800000,145200000,-4100000,-4100000,-31000000,11900000,1718700000,1722800000,1573500000,-29600000,NA,-45600000,-38100000,23700000,income_statement,Insurance—Property & Casualty,Sirius International Insurance,"Sirius International Insurance Group, Ltd., through its subsidiaries, provides insurance and reinsurance products worldwide. The company operates through four segments: Global Reinsurance, Global A&H, U.S. Specialty, and Runoff and Other. It offers property insurance and reinsurance; property catastrophe excess reinsurance; agriculture reinsurance; healthcare and medical travel insurance; insurance and reinsurance product lines, including aviation and space, marine, trade credit, contingency, casualty, surety, and environmental specialty lines; and asbestos risks, environmental risks, and other long-tailed liability exposure products, as well as administration services. The company is also involved in the acquisition and management of runoff liabilities for insurance and reinsurance companies. Sirius International Insurance Group, Ltd. is based in Hamilton, Bermuda."
SGA,2016-12-31,NA,21783000,NA,18186000,10980000,32156000,21112000,21112000,-744000,8873000,118955000,97843000,86799000,671000,5276000,12910000,17861000,64000,income_statement,Broadcasting,"Saga Communications, Inc.","Saga Communications, Inc., a broadcast company, acquires, develops, and operates broadcast properties in the United States. The company's radio stations employ various programming formats, including classic hits, adult hits, top 40, country, country legends, mainstream/hot/soft adult contemporary, pure oldies, classic rock, and news/talk. As of February 29, 2020, it owned seventy-nine FM, thirty-four AM radio stations, and seventy-seven metro signals serving twenty-seven markets. The company was founded in 1986 and is headquartered in Grosse Pointe Farms, Michigan."
SGA,2017-12-31,NA,16326000,NA,54717000,11657000,30390000,18678000,18678000,-903000,-5920000,118149000,99471000,87759000,-2352000,32471000,22246000,53806000,55000,income_statement,Broadcasting,"Saga Communications, Inc.","Saga Communications, Inc., a broadcast company, acquires, develops, and operates broadcast properties in the United States. The company's radio stations employ various programming formats, including classic hits, adult hits, top 40, country, country legends, mainstream/hot/soft adult contemporary, pure oldies, classic rock, and news/talk. As of February 29, 2020, it owned seventy-nine FM, thirty-four AM radio stations, and seventy-seven metro signals serving twenty-seven markets. The company was founded in 1986 and is headquartered in Grosse Pointe Farms, Michigan."
SGA,2018-12-31,NA,19390000,NA,13690000,11359000,31102000,19682000,19682000,-946000,5700000,124829000,105147000,93727000,-292000,NA,13690000,13434000,61000,income_statement,Broadcasting,"Saga Communications, Inc.","Saga Communications, Inc., a broadcast company, acquires, develops, and operates broadcast properties in the United States. The company's radio stations employ various programming formats, including classic hits, adult hits, top 40, country, country legends, mainstream/hot/soft adult contemporary, pure oldies, classic rock, and news/talk. As of February 29, 2020, it owned seventy-nine FM, thirty-four AM radio stations, and seventy-seven metro signals serving twenty-seven markets. The company was founded in 1986 and is headquartered in Grosse Pointe Farms, Michigan."
SGA,2019-12-31,NA,18699000,NA,13279000,11460000,30380000,18808000,18808000,-735000,5420000,123072000,104264000,92692000,-3762000,NA,13279000,12987000,112000,income_statement,Broadcasting,"Saga Communications, Inc.","Saga Communications, Inc., a broadcast company, acquires, develops, and operates broadcast properties in the United States. The company's radio stations employ various programming formats, including classic hits, adult hits, top 40, country, country legends, mainstream/hot/soft adult contemporary, pure oldies, classic rock, and news/talk. As of February 29, 2020, it owned seventy-nine FM, thirty-four AM radio stations, and seventy-seven metro signals serving twenty-seven markets. The company was founded in 1986 and is headquartered in Grosse Pointe Farms, Michigan."
SGBX,2016-12-31,NA,-1971313,NA,-1971313,2082190,313929,-1824822,-1824822,-696734,0,1924389,3749211,1610460,-146491,NA,-1971313,-1971313,NA,income_statement,Metal Fabrication,"SG Blocks, Inc.","SG Blocks, Inc. engages in the design and fabrication of container-based structures. The company redesigns, repurposes, and converts heavy-gauge steel cargo shipping containers into green building blocks for commercial, industrial, and residential building construction; and purpose-built modules, or prefabricated steel modular units for construction. It also provides engineering and project management services related to the use of modified containers in construction. The company serves architects, landowners, builders, and developers. It has operations in the United States and Canada. SG Blocks, Inc. was founded in 2007 and is headquartered in Brooklyn, New York."
SGBX,2017-12-31,NA,-4512680,NA,-4512680,3837774,633807,-3261159,-3261159,-330388,0,5061585,8322744,4427778,-1251521,NA,-4512680,-4512680,NA,income_statement,Metal Fabrication,"SG Blocks, Inc.","SG Blocks, Inc. engages in the design and fabrication of container-based structures. The company redesigns, repurposes, and converts heavy-gauge steel cargo shipping containers into green building blocks for commercial, industrial, and residential building construction; and purpose-built modules, or prefabricated steel modular units for construction. It also provides engineering and project management services related to the use of modified containers in construction. The company serves architects, landowners, builders, and developers. It has operations in the United States and Canada. SG Blocks, Inc. was founded in 2007 and is headquartered in Brooklyn, New York."
SGBX,2018-12-31,NA,-4844021,NA,-4844021,5314267,542733,-4846163,-4846163,-178995,0,8190712,13036875,7647979,2142,NA,-4844021,-4844021,NA,income_statement,Metal Fabrication,"SG Blocks, Inc.","SG Blocks, Inc. engages in the design and fabrication of container-based structures. The company redesigns, repurposes, and converts heavy-gauge steel cargo shipping containers into green building blocks for commercial, industrial, and residential building construction; and purpose-built modules, or prefabricated steel modular units for construction. It also provides engineering and project management services related to the use of modified containers in construction. The company serves architects, landowners, builders, and developers. It has operations in the United States and Canada. SG Blocks, Inc. was founded in 2007 and is headquartered in Brooklyn, New York."
SGBX,2019-12-31,NA,-6920540,NA,-6920540,4421420,677347,-3765359,-3765359,-178995,0,2984835,6750194,2307488,-3155181,NA,-6920540,-6920540,NA,income_statement,Metal Fabrication,"SG Blocks, Inc.","SG Blocks, Inc. engages in the design and fabrication of container-based structures. The company redesigns, repurposes, and converts heavy-gauge steel cargo shipping containers into green building blocks for commercial, industrial, and residential building construction; and purpose-built modules, or prefabricated steel modular units for construction. It also provides engineering and project management services related to the use of modified containers in construction. The company serves architects, landowners, builders, and developers. It has operations in the United States and Canada. SG Blocks, Inc. was founded in 2007 and is headquartered in Brooklyn, New York."
SGC,2016-12-31,NA,19898000,NA,14638000,65296000,86982000,21686000,21686000,-688000,5260000,252596000,230910000,165614000,-1788000,NA,14638000,14638000,NA,income_statement,Apparel Manufacturing,"Superior Group of Companies, In","Superior Group of Companies, Inc. manufactures and sells apparel and accessories in the United States and internationally. It operates through three segments: Uniforms and Related Products, Remote Staffing Solutions, and Promotional Products. The Uniforms and Related Products segment manufactures and sells a range of uniforms, corporate identity apparel, career apparel, and accessories for personnel of hospitals and health facilities; hotels; food service facilities; retail stores; general and special purpose industrial uses; commercial markets; transportation; public and private safety and security organizations; and miscellaneous service uses. It also provides various products directly related to uniforms and service apparel; industrial laundry bags for linen suppliers and industrial launderers; and promotional and related products for branded marketing programs, event promotions, employee and consumer rewards and incentives, and specialty packaging and displays. This segment sells its products under the Fashion Seal Healthcare, HPI, and WonderWink brand names. The Remote Staffing Solutions segment provides multilingual telemarketing and business process outsourced solutions through the recruitment and employment of qualified English-speaking agents. The Promotional Products segment produces and sells promotional products and branded merchandise under the BAMKO, Public Identity, and Tangerine brands to corporate clients and universities. The company was formerly known as Superior Uniform Group, Inc. and changed its name to Superior Group of Companies, Inc. in May 2018. Superior Group of Companies, Inc. was founded in 1920 and is headquartered in Seminole, Florida."
SGC,2017-12-31,NA,24782000,NA,15022000,71616000,96352000,24736000,24736000,-802000,9760000,266814000,242078000,170462000,46000,NA,15022000,15022000,NA,income_statement,Apparel Manufacturing,"Superior Group of Companies, In","Superior Group of Companies, Inc. manufactures and sells apparel and accessories in the United States and internationally. It operates through three segments: Uniforms and Related Products, Remote Staffing Solutions, and Promotional Products. The Uniforms and Related Products segment manufactures and sells a range of uniforms, corporate identity apparel, career apparel, and accessories for personnel of hospitals and health facilities; hotels; food service facilities; retail stores; general and special purpose industrial uses; commercial markets; transportation; public and private safety and security organizations; and miscellaneous service uses. It also provides various products directly related to uniforms and service apparel; industrial laundry bags for linen suppliers and industrial launderers; and promotional and related products for branded marketing programs, event promotions, employee and consumer rewards and incentives, and specialty packaging and displays. This segment sells its products under the Fashion Seal Healthcare, HPI, and WonderWink brand names. The Remote Staffing Solutions segment provides multilingual telemarketing and business process outsourced solutions through the recruitment and employment of qualified English-speaking agents. The Promotional Products segment produces and sells promotional products and branded merchandise under the BAMKO, Public Identity, and Tangerine brands to corporate clients and universities. The company was formerly known as Superior Uniform Group, Inc. and changed its name to Superior Group of Companies, Inc. in May 2018. Superior Group of Companies, Inc. was founded in 1920 and is headquartered in Seminole, Florida."
SGC,2018-12-31,NA,21395000,NA,16975000,96111000,121697000,25586000,25586000,-3207000,4420000,346350000,320764000,224653000,-4191000,NA,16975000,16975000,NA,income_statement,Apparel Manufacturing,"Superior Group of Companies, In","Superior Group of Companies, Inc. manufactures and sells apparel and accessories in the United States and internationally. It operates through three segments: Uniforms and Related Products, Remote Staffing Solutions, and Promotional Products. The Uniforms and Related Products segment manufactures and sells a range of uniforms, corporate identity apparel, career apparel, and accessories for personnel of hospitals and health facilities; hotels; food service facilities; retail stores; general and special purpose industrial uses; commercial markets; transportation; public and private safety and security organizations; and miscellaneous service uses. It also provides various products directly related to uniforms and service apparel; industrial laundry bags for linen suppliers and industrial launderers; and promotional and related products for branded marketing programs, event promotions, employee and consumer rewards and incentives, and specialty packaging and displays. This segment sells its products under the Fashion Seal Healthcare, HPI, and WonderWink brand names. The Remote Staffing Solutions segment provides multilingual telemarketing and business process outsourced solutions through the recruitment and employment of qualified English-speaking agents. The Promotional Products segment produces and sells promotional products and branded merchandise under the BAMKO, Public Identity, and Tangerine brands to corporate clients and universities. The company was formerly known as Superior Uniform Group, Inc. and changed its name to Superior Group of Companies, Inc. in May 2018. Superior Group of Companies, Inc. was founded in 1920 and is headquartered in Seminole, Florida."
SGC,2019-12-31,NA,15286000,NA,12066000,109318000,128929000,19611000,19611000,-4399000,3220000,376701000,357090000,247772000,-4325000,NA,12066000,12066000,NA,income_statement,Apparel Manufacturing,"Superior Group of Companies, In","Superior Group of Companies, Inc. manufactures and sells apparel and accessories in the United States and internationally. It operates through three segments: Uniforms and Related Products, Remote Staffing Solutions, and Promotional Products. The Uniforms and Related Products segment manufactures and sells a range of uniforms, corporate identity apparel, career apparel, and accessories for personnel of hospitals and health facilities; hotels; food service facilities; retail stores; general and special purpose industrial uses; commercial markets; transportation; public and private safety and security organizations; and miscellaneous service uses. It also provides various products directly related to uniforms and service apparel; industrial laundry bags for linen suppliers and industrial launderers; and promotional and related products for branded marketing programs, event promotions, employee and consumer rewards and incentives, and specialty packaging and displays. This segment sells its products under the Fashion Seal Healthcare, HPI, and WonderWink brand names. The Remote Staffing Solutions segment provides multilingual telemarketing and business process outsourced solutions through the recruitment and employment of qualified English-speaking agents. The Promotional Products segment produces and sells promotional products and branded merchandise under the BAMKO, Public Identity, and Tangerine brands to corporate clients and universities. The company was formerly known as Superior Uniform Group, Inc. and changed its name to Superior Group of Companies, Inc. in May 2018. Superior Group of Companies, Inc. was founded in 1920 and is headquartered in Seminole, Florida."
SGEN,2017-12-31,565309000,-158887000,NA,-125530000,167233000,-28568000,-195801000,-195801000,NA,-33357000,482250000,678051000,510818000,36914000,NA,-125530000,-125530000,NA,income_statement,Biotechnology,Seagen Inc.,"Seagen Inc., a biotechnology company, develops and commercializes therapies for the treatment of cancer in the United States and internationally. The company markets ADCETRIS, an antibody-drug conjugate (ADC) for the treatment of patients with Hodgkin lymphoma or CD30-positive T-cell lymphomas; PADCEV, an ADC targeting Nectin-4 for the treatment of metastatic urothelial cancers; and TUKYSA, an oral small molecule tyrosine kinase inhibitor for the treatment of adult patients with advanced unresectable or metastatic HER2-positive breast cancer. It also develops Tisotumab Vedotin for metastatic cervical cancer and other solid tumors; ladiratuzumab vedotin, an ADC targeting LIV-1 for metastatic breast cancer and solid tumors; and SEA-CD40, SEA-TGT, SEA-BCMA, and SEA-CD70 for various cancer diseases. Seagen Inc. has collaboration agreements with Takeda Pharmaceutical Company Limited; Agensys, Inc.; Genmab A/S; and Merck. The company was formerly known as Seattle Genetics, Inc. and changed its name to Seagen Inc. in October 2020. Seagen Inc. was incorporated in 1997 and is headquartered in Bothell, Washington."
SGEN,2018-12-31,565309000,-246346000,NA,-222693000,252596000,1098000,-251498000,-251498000,NA,-23653000,654700000,906198000,653602000,5152000,NA,-222693000,-222693000,NA,income_statement,Biotechnology,Seagen Inc.,"Seagen Inc., a biotechnology company, develops and commercializes therapies for the treatment of cancer in the United States and internationally. The company markets ADCETRIS, an antibody-drug conjugate (ADC) for the treatment of patients with Hodgkin lymphoma or CD30-positive T-cell lymphomas; PADCEV, an ADC targeting Nectin-4 for the treatment of metastatic urothelial cancers; and TUKYSA, an oral small molecule tyrosine kinase inhibitor for the treatment of adult patients with advanced unresectable or metastatic HER2-positive breast cancer. It also develops Tisotumab Vedotin for metastatic cervical cancer and other solid tumors; ladiratuzumab vedotin, an ADC targeting LIV-1 for metastatic breast cancer and solid tumors; and SEA-CD40, SEA-TGT, SEA-BCMA, and SEA-CD70 for various cancer diseases. Seagen Inc. has collaboration agreements with Takeda Pharmaceutical Company Limited; Agensys, Inc.; Genmab A/S; and Merck. The company was formerly known as Seattle Genetics, Inc. and changed its name to Seagen Inc. in October 2020. Seagen Inc. was incorporated in 1997 and is headquartered in Bothell, Washington."
SGEN,2019-12-31,NA,-158650000,NA,-158650000,373932000,153387000,-220545000,-220545000,NA,0,916713000,1137258000,763326000,61895000,NA,-158650000,-158650000,NA,income_statement,Biotechnology,Seagen Inc.,"Seagen Inc., a biotechnology company, develops and commercializes therapies for the treatment of cancer in the United States and internationally. The company markets ADCETRIS, an antibody-drug conjugate (ADC) for the treatment of patients with Hodgkin lymphoma or CD30-positive T-cell lymphomas; PADCEV, an ADC targeting Nectin-4 for the treatment of metastatic urothelial cancers; and TUKYSA, an oral small molecule tyrosine kinase inhibitor for the treatment of adult patients with advanced unresectable or metastatic HER2-positive breast cancer. It also develops Tisotumab Vedotin for metastatic cervical cancer and other solid tumors; ladiratuzumab vedotin, an ADC targeting LIV-1 for metastatic breast cancer and solid tumors; and SEA-CD40, SEA-TGT, SEA-BCMA, and SEA-CD70 for various cancer diseases. Seagen Inc. has collaboration agreements with Takeda Pharmaceutical Company Limited; Agensys, Inc.; Genmab A/S; and Merck. The company was formerly known as Seattle Genetics, Inc. and changed its name to Seagen Inc. in October 2020. Seagen Inc. was incorporated in 1997 and is headquartered in Bothell, Washington."
SGEN,2020-12-31,NA,615701000,NA,613670000,533835000,1130687000,596852000,596852000,NA,2031000,2175536000,1578684000,1044849000,18849000,NA,613670000,613670000,NA,income_statement,Biotechnology,Seagen Inc.,"Seagen Inc., a biotechnology company, develops and commercializes therapies for the treatment of cancer in the United States and internationally. The company markets ADCETRIS, an antibody-drug conjugate (ADC) for the treatment of patients with Hodgkin lymphoma or CD30-positive T-cell lymphomas; PADCEV, an ADC targeting Nectin-4 for the treatment of metastatic urothelial cancers; and TUKYSA, an oral small molecule tyrosine kinase inhibitor for the treatment of adult patients with advanced unresectable or metastatic HER2-positive breast cancer. It also develops Tisotumab Vedotin for metastatic cervical cancer and other solid tumors; ladiratuzumab vedotin, an ADC targeting LIV-1 for metastatic breast cancer and solid tumors; and SEA-CD40, SEA-TGT, SEA-BCMA, and SEA-CD70 for various cancer diseases. Seagen Inc. has collaboration agreements with Takeda Pharmaceutical Company Limited; Agensys, Inc.; Genmab A/S; and Merck. The company was formerly known as Seattle Genetics, Inc. and changed its name to Seagen Inc. in October 2020. Seagen Inc. was incorporated in 1997 and is headquartered in Bothell, Washington."
SGH,2017-08-25,38160000,2119000,NA,-7795000,69759000,162622000,54703000,54703000,-29204000,9914000,761291000,706588000,598669000,-52584000,NA,-7795000,-7795000,NA,income_statement,Semiconductors,"SMART Global Holdings, Inc.","SMART Global Holdings, Inc. designs and manufactures electronic products focused in memory and computing technology areas. It offers dynamic random access memory (DRAM) modules for desktops, notebooks, and servers; and embedded and removable flash memory products; and flash component products, such as embedded multimedia controllers, and embedded and removal products in USB, CompactFlash and SD/microSD card configurations. The company also provides supply chain services, including procurement, logistics, inventory management, temporary warehousing, programming, kitting, and packaging. In addition, it offers specialty compute and storage system solutions to customers various verticals, including financial services, energy, government, social media, and education end markets; and offers hardware and software products, including solutions based on the Open Compute Project. Further it provides servers, software, integrated turn-key clusters, enterprise-grade storage, and bare metal HPC in hardware or cloud-based solutions through Penguin Computing On-Demand; Open Compute Tundra Extreme Scale products; turn-key storage solutions based upon its Frostbyte storage platform; and rackmount servers and GPU accelerated computing platforms. The company sells its products directly to original equipment manufacturers, enterprise, government and other end customers through direct sales force, e-commerce, customer service representatives, on-site field application engineers, independent sales representatives, distributors, integrators, and resellers. The company was formerly known as Saleen Holdings, Inc. and changed its name to SMART Global Holdings, Inc. in August 2014. SMART Global Holdings, Inc. was founded in 1988 and is headquartered in Newark, California."
SGH,2018-08-31,39824000,137778000,NA,119463000,80841000,291586000,170921000,170921000,-19144000,18315000,1288821000,1117900000,997235000,-33143000,NA,119463000,119463000,NA,income_statement,Semiconductors,"SMART Global Holdings, Inc.","SMART Global Holdings, Inc. designs and manufactures electronic products focused in memory and computing technology areas. It offers dynamic random access memory (DRAM) modules for desktops, notebooks, and servers; and embedded and removable flash memory products; and flash component products, such as embedded multimedia controllers, and embedded and removal products in USB, CompactFlash and SD/microSD card configurations. The company also provides supply chain services, including procurement, logistics, inventory management, temporary warehousing, programming, kitting, and packaging. In addition, it offers specialty compute and storage system solutions to customers various verticals, including financial services, energy, government, social media, and education end markets; and offers hardware and software products, including solutions based on the Open Compute Project. Further it provides servers, software, integrated turn-key clusters, enterprise-grade storage, and bare metal HPC in hardware or cloud-based solutions through Penguin Computing On-Demand; Open Compute Tundra Extreme Scale products; turn-key storage solutions based upon its Frostbyte storage platform; and rackmount servers and GPU accelerated computing platforms. The company sells its products directly to original equipment manufacturers, enterprise, government and other end customers through direct sales force, e-commerce, customer service representatives, on-site field application engineers, independent sales representatives, distributors, integrators, and resellers. The company was formerly known as Saleen Holdings, Inc. and changed its name to SMART Global Holdings, Inc. in August 2014. SMART Global Holdings, Inc. was founded in 1988 and is headquartered in Newark, California."
SGH,2019-08-30,47920000,66204000,NA,51332000,101726000,237527000,87881000,87881000,-20716000,14872000,1211999000,1124118000,974472000,-21677000,NA,51332000,51332000,NA,income_statement,Semiconductors,"SMART Global Holdings, Inc.","SMART Global Holdings, Inc. designs and manufactures electronic products focused in memory and computing technology areas. It offers dynamic random access memory (DRAM) modules for desktops, notebooks, and servers; and embedded and removable flash memory products; and flash component products, such as embedded multimedia controllers, and embedded and removal products in USB, CompactFlash and SD/microSD card configurations. The company also provides supply chain services, including procurement, logistics, inventory management, temporary warehousing, programming, kitting, and packaging. In addition, it offers specialty compute and storage system solutions to customers various verticals, including financial services, energy, government, social media, and education end markets; and offers hardware and software products, including solutions based on the Open Compute Project. Further it provides servers, software, integrated turn-key clusters, enterprise-grade storage, and bare metal HPC in hardware or cloud-based solutions through Penguin Computing On-Demand; Open Compute Tundra Extreme Scale products; turn-key storage solutions based upon its Frostbyte storage platform; and rackmount servers and GPU accelerated computing platforms. The company sells its products directly to original equipment manufacturers, enterprise, government and other end customers through direct sales force, e-commerce, customer service representatives, on-site field application engineers, independent sales representatives, distributors, integrators, and resellers. The company was formerly known as Saleen Holdings, Inc. and changed its name to SMART Global Holdings, Inc. in August 2014. SMART Global Holdings, Inc. was founded in 1988 and is headquartered in Newark, California."
SGH,2020-08-28,52056000,9360000,NA,-1143000,113138000,216396000,51202000,51202000,-15000000,10503000,1122377000,1071175000,905981000,-41842000,NA,-1143000,-1143000,NA,income_statement,Semiconductors,"SMART Global Holdings, Inc.","SMART Global Holdings, Inc. designs and manufactures electronic products focused in memory and computing technology areas. It offers dynamic random access memory (DRAM) modules for desktops, notebooks, and servers; and embedded and removable flash memory products; and flash component products, such as embedded multimedia controllers, and embedded and removal products in USB, CompactFlash and SD/microSD card configurations. The company also provides supply chain services, including procurement, logistics, inventory management, temporary warehousing, programming, kitting, and packaging. In addition, it offers specialty compute and storage system solutions to customers various verticals, including financial services, energy, government, social media, and education end markets; and offers hardware and software products, including solutions based on the Open Compute Project. Further it provides servers, software, integrated turn-key clusters, enterprise-grade storage, and bare metal HPC in hardware or cloud-based solutions through Penguin Computing On-Demand; Open Compute Tundra Extreme Scale products; turn-key storage solutions based upon its Frostbyte storage platform; and rackmount servers and GPU accelerated computing platforms. The company sells its products directly to original equipment manufacturers, enterprise, government and other end customers through direct sales force, e-commerce, customer service representatives, on-site field application engineers, independent sales representatives, distributors, integrators, and resellers. The company was formerly known as Saleen Holdings, Inc. and changed its name to SMART Global Holdings, Inc. in August 2014. SMART Global Holdings, Inc. was founded in 1988 and is headquartered in Newark, California."
SGLB,2016-12-31,120638,-2196834,NA,-2196834,1816594,737520,-1852331,-1852331,-129798,0,966422,2818753,228902,-344503,NA,-2196834,-2196834,132220,income_statement,Information Technology Services,"Sigma Labs, Inc.","Sigma Labs, Inc. develops and commercializes manufacturing and materials technologies. The company offers PrintRite3D, an in-process-quality-assurance suite of software applications that embeds quality assurance and process control practices for metal-based additive manufacturing or 3D printing, and other advanced manufacturing technologies, as well as provides related engineering consulting services. It serves aerospace, defense, oil and gas, bio-medical, and power generation industries. The company was formerly known as Framewaves Inc. and changed its name to Sigma Labs, Inc. in September 2010. Sigma Labs, Inc. was incorporated in 1985 and is headquartered in Santa Fe, New Mexico."
SGLB,2017-12-31,302043,-4424503,NA,-4424503,2397892,368677,-3343987,-3343987,-520132,0,641049,3985036,272372,-1080516,NA,-4424503,-4424503,95990,income_statement,Information Technology Services,"Sigma Labs, Inc.","Sigma Labs, Inc. develops and commercializes manufacturing and materials technologies. The company offers PrintRite3D, an in-process-quality-assurance suite of software applications that embeds quality assurance and process control practices for metal-based additive manufacturing or 3D printing, and other advanced manufacturing technologies, as well as provides related engineering consulting services. It serves aerospace, defense, oil and gas, bio-medical, and power generation industries. The company was formerly known as Framewaves Inc. and changed its name to Sigma Labs, Inc. in September 2010. Sigma Labs, Inc. was incorporated in 1985 and is headquartered in Santa Fe, New Mexico."
SGLB,2018-12-31,493410,-5574163,NA,-5574163,3088095,118467,-4935769,-4935769,-3966,0,388574,5324343,270107,-638394,NA,-5574163,-5589288,134827,income_statement,Information Technology Services,"Sigma Labs, Inc.","Sigma Labs, Inc. develops and commercializes manufacturing and materials technologies. The company offers PrintRite3D, an in-process-quality-assurance suite of software applications that embeds quality assurance and process control practices for metal-based additive manufacturing or 3D printing, and other advanced manufacturing technologies, as well as provides related engineering consulting services. It serves aerospace, defense, oil and gas, bio-medical, and power generation industries. The company was formerly known as Framewaves Inc. and changed its name to Sigma Labs, Inc. in September 2010. Sigma Labs, Inc. was incorporated in 1985 and is headquartered in Santa Fe, New Mexico."
SGLB,2019-12-31,647994,-6320849,NA,-6320849,3711613,-171855,-5699585,-5699585,-8685,0,402446,6102031,574301,-621264,NA,-6320849,-6320849,158706,income_statement,Information Technology Services,"Sigma Labs, Inc.","Sigma Labs, Inc. develops and commercializes manufacturing and materials technologies. The company offers PrintRite3D, an in-process-quality-assurance suite of software applications that embeds quality assurance and process control practices for metal-based additive manufacturing or 3D printing, and other advanced manufacturing technologies, as well as provides related engineering consulting services. It serves aerospace, defense, oil and gas, bio-medical, and power generation industries. The company was formerly known as Framewaves Inc. and changed its name to Sigma Labs, Inc. in September 2010. Sigma Labs, Inc. was incorporated in 1985 and is headquartered in Santa Fe, New Mexico."
SGMA,2017-04-30,NA,2497683,NA,1390206,22262701,25175308,2912607,2912607,-1135853,1107477,253370175,250457568,228194867,-414924,NA,1390206,1390206,NA,income_statement,Electronic Components,"SigmaTron International, Inc.","SigmaTron International, Inc. operates as an independent provider of electronic manufacturing services (EMS). Its EMS services includes printed circuit board assemblies and completely assembled (box-build) electronic products. The company also offers automatic and manual assembly, and testing of products; material sourcing and procurement services; manufacturing and test engineering support services; design services; warehousing and distribution services; and assistance in obtaining product approval from governmental and other regulatory bodies. It primarily serves customers operating in the industrial electronics, consumer electronics, and medical/life sciences industries in the United States, Mexico, China, and Vietnam. The company markets its services through independent manufacturers' representative organizations. SigmaTron International, Inc. was founded in 1993 and is headquartered in Elk Grove Village, Illinois."
SGMA,2018-04-30,NA,-4302322,NA,-3241870,23174283,26602918,3428635,3428635,-1537446,-1060452,278131709,274703074,251528791,-7730957,NA,-3241870,-3241870,NA,income_statement,Electronic Components,"SigmaTron International, Inc.","SigmaTron International, Inc. operates as an independent provider of electronic manufacturing services (EMS). Its EMS services includes printed circuit board assemblies and completely assembled (box-build) electronic products. The company also offers automatic and manual assembly, and testing of products; material sourcing and procurement services; manufacturing and test engineering support services; design services; warehousing and distribution services; and assistance in obtaining product approval from governmental and other regulatory bodies. It primarily serves customers operating in the industrial electronics, consumer electronics, and medical/life sciences industries in the United States, Mexico, China, and Vietnam. The company markets its services through independent manufacturers' representative organizations. SigmaTron International, Inc. was founded in 1993 and is headquartered in Elk Grove Village, Illinois."
SGMA,2019-04-30,NA,866301,NA,-865114,23263117,26341769,3078652,3078652,-2413297,1731415,290553951,287475299,264212182,-2212351,NA,-865114,-865114,NA,income_statement,Electronic Components,"SigmaTron International, Inc.","SigmaTron International, Inc. operates as an independent provider of electronic manufacturing services (EMS). Its EMS services includes printed circuit board assemblies and completely assembled (box-build) electronic products. The company also offers automatic and manual assembly, and testing of products; material sourcing and procurement services; manufacturing and test engineering support services; design services; warehousing and distribution services; and assistance in obtaining product approval from governmental and other regulatory bodies. It primarily serves customers operating in the industrial electronics, consumer electronics, and medical/life sciences industries in the United States, Mexico, China, and Vietnam. The company markets its services through independent manufacturers' representative organizations. SigmaTron International, Inc. was founded in 1993 and is headquartered in Elk Grove Village, Illinois."
SGMA,2020-04-30,NA,1093134,NA,443102,22292309,25104890,2812581,2812581,-1839060,650032,281042482,278229901,255937592,-1719447,NA,443102,443102,NA,income_statement,Electronic Components,"SigmaTron International, Inc.","SigmaTron International, Inc. operates as an independent provider of electronic manufacturing services (EMS). Its EMS services includes printed circuit board assemblies and completely assembled (box-build) electronic products. The company also offers automatic and manual assembly, and testing of products; material sourcing and procurement services; manufacturing and test engineering support services; design services; warehousing and distribution services; and assistance in obtaining product approval from governmental and other regulatory bodies. It primarily serves customers operating in the industrial electronics, consumer electronics, and medical/life sciences industries in the United States, Mexico, China, and Vietnam. The company markets its services through independent manufacturers' representative organizations. SigmaTron International, Inc. was founded in 1993 and is headquartered in Elk Grove Village, Illinois."
SGMO,2016-12-31,114866000,-71672000,739000,-71658000,22230000,-46229000,-68459000,-68459000,NA,-14000,19389000,87848000,65618000,-3213000,NA,-71658000,-71658000,NA,income_statement,Biotechnology,"Sangamo Therapeutics, Inc.","Sangamo Therapeutics, Inc., a biotechnology company, focuses on translating science into genomic medicines that transform patients' lives using platform technologies in gene therapy, cell therapy, genome editing, and genome regulation. The company's zinc finger proteins (ZFPs) could be engineered to make zinc finger nucleases (ZFNs), proteins that could be used to modify DNA sequences by adding or knocking out specific genes or genome editing; and ZFP transcription factors (ZFP TFs) proteins that can be used to increase or decrease gene expression. Its therapeutic products that are in Phase I/II clinical trial include SB-525 for the treatment of hemophilia A; ST-920 gene therapy for Fabry disease; ST-101 gene therapy for phenylketonuria; ST-400 and BIVV-003 for the treatment of hemoglobinopathies; SB-913 for the treatment of Mucopolysaccharidosis type II; SB-318 for the treatment of Mucopolysaccharidosis type I; and SB-FIX for the treatment of hemophilia B. The company has collaborative and strategic partnerships with Biogen Inc.; Kite Pharma, Inc.; Pfizer Inc.; Sanofi Genzyme; Shire International GmbH; Dow AgroSciences LLC; Sigma-Aldrich Corporation; Genentech, Inc.; Open Monoclonal Technology, Inc.; F. Hoffmann-La Roche Ltd and Hoffmann-La Roche Inc.; and California Institute for Regenerative Medicine. The company was formerly known as Sangamo BioSciences, Inc. and changed its name to Sangamo Therapeutics, Inc. in January 2017. Sangamo Therapeutics, Inc. was founded in 1995 and is headquartered in Brisbane, California."
SGMO,2017-12-31,114866000,-54568000,739000,-54568000,27200000,-29161000,-56361000,-56361000,NA,0,36567000,92928000,65728000,1793000,NA,-54568000,-54568000,NA,income_statement,Biotechnology,"Sangamo Therapeutics, Inc.","Sangamo Therapeutics, Inc., a biotechnology company, focuses on translating science into genomic medicines that transform patients' lives using platform technologies in gene therapy, cell therapy, genome editing, and genome regulation. The company's zinc finger proteins (ZFPs) could be engineered to make zinc finger nucleases (ZFNs), proteins that could be used to modify DNA sequences by adding or knocking out specific genes or genome editing; and ZFP transcription factors (ZFP TFs) proteins that can be used to increase or decrease gene expression. Its therapeutic products that are in Phase I/II clinical trial include SB-525 for the treatment of hemophilia A; ST-920 gene therapy for Fabry disease; ST-101 gene therapy for phenylketonuria; ST-400 and BIVV-003 for the treatment of hemoglobinopathies; SB-913 for the treatment of Mucopolysaccharidosis type II; SB-318 for the treatment of Mucopolysaccharidosis type I; and SB-FIX for the treatment of hemophilia B. The company has collaborative and strategic partnerships with Biogen Inc.; Kite Pharma, Inc.; Pfizer Inc.; Sanofi Genzyme; Shire International GmbH; Dow AgroSciences LLC; Sigma-Aldrich Corporation; Genentech, Inc.; Open Monoclonal Technology, Inc.; F. Hoffmann-La Roche Ltd and Hoffmann-La Roche Inc.; and California Institute for Regenerative Medicine. The company was formerly known as Sangamo BioSciences, Inc. and changed its name to Sangamo Therapeutics, Inc. in January 2017. Sangamo Therapeutics, Inc. was founded in 1995 and is headquartered in Brisbane, California."
SGMO,2018-12-31,114866000,-68889000,739000,-68334000,46736000,-30414000,-77150000,-77150000,NA,0,84452000,161602000,114866000,5561000,NA,-68889000,-68334000,NA,income_statement,Biotechnology,"Sangamo Therapeutics, Inc.","Sangamo Therapeutics, Inc., a biotechnology company, focuses on translating science into genomic medicines that transform patients' lives using platform technologies in gene therapy, cell therapy, genome editing, and genome regulation. The company's zinc finger proteins (ZFPs) could be engineered to make zinc finger nucleases (ZFNs), proteins that could be used to modify DNA sequences by adding or knocking out specific genes or genome editing; and ZFP transcription factors (ZFP TFs) proteins that can be used to increase or decrease gene expression. Its therapeutic products that are in Phase I/II clinical trial include SB-525 for the treatment of hemophilia A; ST-920 gene therapy for Fabry disease; ST-101 gene therapy for phenylketonuria; ST-400 and BIVV-003 for the treatment of hemoglobinopathies; SB-913 for the treatment of Mucopolysaccharidosis type II; SB-318 for the treatment of Mucopolysaccharidosis type I; and SB-FIX for the treatment of hemophilia B. The company has collaborative and strategic partnerships with Biogen Inc.; Kite Pharma, Inc.; Pfizer Inc.; Sanofi Genzyme; Shire International GmbH; Dow AgroSciences LLC; Sigma-Aldrich Corporation; Genentech, Inc.; Open Monoclonal Technology, Inc.; F. Hoffmann-La Roche Ltd and Hoffmann-La Roche Inc.; and California Institute for Regenerative Medicine. The company was formerly known as Sangamo BioSciences, Inc. and changed its name to Sangamo Therapeutics, Inc. in January 2017. Sangamo Therapeutics, Inc. was founded in 1995 and is headquartered in Brisbane, California."
SGMO,2019-12-31,145922000,-95419000,185000,-95186000,61686000,-43494000,-105180000,-105180000,NA,0,102428000,207608000,145922000,9761000,NA,-95419000,-95186000,NA,income_statement,Biotechnology,"Sangamo Therapeutics, Inc.","Sangamo Therapeutics, Inc., a biotechnology company, focuses on translating science into genomic medicines that transform patients' lives using platform technologies in gene therapy, cell therapy, genome editing, and genome regulation. The company's zinc finger proteins (ZFPs) could be engineered to make zinc finger nucleases (ZFNs), proteins that could be used to modify DNA sequences by adding or knocking out specific genes or genome editing; and ZFP transcription factors (ZFP TFs) proteins that can be used to increase or decrease gene expression. Its therapeutic products that are in Phase I/II clinical trial include SB-525 for the treatment of hemophilia A; ST-920 gene therapy for Fabry disease; ST-101 gene therapy for phenylketonuria; ST-400 and BIVV-003 for the treatment of hemoglobinopathies; SB-913 for the treatment of Mucopolysaccharidosis type II; SB-318 for the treatment of Mucopolysaccharidosis type I; and SB-FIX for the treatment of hemophilia B. The company has collaborative and strategic partnerships with Biogen Inc.; Kite Pharma, Inc.; Pfizer Inc.; Sanofi Genzyme; Shire International GmbH; Dow AgroSciences LLC; Sigma-Aldrich Corporation; Genentech, Inc.; Open Monoclonal Technology, Inc.; F. Hoffmann-La Roche Ltd and Hoffmann-La Roche Inc.; and California Institute for Regenerative Medicine. The company was formerly known as Sangamo BioSciences, Inc. and changed its name to Sangamo Therapeutics, Inc. in January 2017. Sangamo Therapeutics, Inc. was founded in 1995 and is headquartered in Brisbane, California."
SGMS,2016-12-31,204800000,-478700000,104000000,-353700000,584500000,1777100000,249100000,249100000,-661400000,-125000000,2883400000,2634300000,1106300000,-727800000,NA,-353700000,-353700000,NA,income_statement,Gambling,Scientific Games Corp,"Scientific Games Corporation develops technology-based products and services, and related content for the gaming, lottery, social and digital gaming industries in the United States and internationally. The company's Gaming segment sells new and used gaming machines, electronic table systems, video lottery terminals, conversion game kits, and spare parts; slot, casino, and table-management systems; table products, including shufflers; and perpetual licenses to proprietary table games. It also leases gaming machines; provides gaming operations and licensing arrangements; and installs and supports casino management systems, such as ongoing hardware and software maintenance and upgrade services of customer casino management systems. The company's Lottery segment designs, prints, and sells instant lottery products; designs and manufactures instant games tickets; offers instant products planning, monitoring, management system, warehousing, inventory management, distribution, marketing, and game support functions; supplies player loyalty programs, merchandising services, and interactive marketing campaigns; and sublicenses brands for lottery products and lottery-related promotional products. It also provides software, hardware, and related services for lottery operations; and lottery systems software maintenance and support services. The company's SciPlay segment sells virtual coins, chips, or bingo cards; and third-party branded games and original content through mobile and web platforms. Its Digital segment provides digital gaming and sports wagering solutions and services, including digital RMG and sports wagering solutions, distribution platforms, content, products, and services; software design, development, licensing, maintenance, and support services; Open Platform Systems; and content aggregation platforms. The company was founded in 1984 and is headquartered in Las Vegas, Nevada."
SGMS,2017-12-31,184000000,-227000000,104000000,-242000000,613000000,1920000000,440000000,440000000,-610000000,15000000,3084000000,2644000000,1164000000,-667000000,NA,-242000000,-242000000,NA,income_statement,Gambling,Scientific Games Corp,"Scientific Games Corporation develops technology-based products and services, and related content for the gaming, lottery, social and digital gaming industries in the United States and internationally. The company's Gaming segment sells new and used gaming machines, electronic table systems, video lottery terminals, conversion game kits, and spare parts; slot, casino, and table-management systems; table products, including shufflers; and perpetual licenses to proprietary table games. It also leases gaming machines; provides gaming operations and licensing arrangements; and installs and supports casino management systems, such as ongoing hardware and software maintenance and upgrade services of customer casino management systems. The company's Lottery segment designs, prints, and sells instant lottery products; designs and manufactures instant games tickets; offers instant products planning, monitoring, management system, warehousing, inventory management, distribution, marketing, and game support functions; supplies player loyalty programs, merchandising services, and interactive marketing campaigns; and sublicenses brands for lottery products and lottery-related promotional products. It also provides software, hardware, and related services for lottery operations; and lottery systems software maintenance and support services. The company's SciPlay segment sells virtual coins, chips, or bingo cards; and third-party branded games and original content through mobile and web platforms. Its Digital segment provides digital gaming and sports wagering solutions and services, including digital RMG and sports wagering solutions, distribution platforms, content, products, and services; software design, development, licensing, maintenance, and support services; Open Platform Systems; and content aggregation platforms. The company was founded in 1984 and is headquartered in Las Vegas, Nevada."
SGMS,2018-12-31,202000000,-339000000,104000000,-352000000,697000000,2108000000,538000000,538000000,-597000000,13000000,3363000000,2825000000,1255000000,-877000000,NA,-352000000,-352000000,NA,income_statement,Gambling,Scientific Games Corp,"Scientific Games Corporation develops technology-based products and services, and related content for the gaming, lottery, social and digital gaming industries in the United States and internationally. The company's Gaming segment sells new and used gaming machines, electronic table systems, video lottery terminals, conversion game kits, and spare parts; slot, casino, and table-management systems; table products, including shufflers; and perpetual licenses to proprietary table games. It also leases gaming machines; provides gaming operations and licensing arrangements; and installs and supports casino management systems, such as ongoing hardware and software maintenance and upgrade services of customer casino management systems. The company's Lottery segment designs, prints, and sells instant lottery products; designs and manufactures instant games tickets; offers instant products planning, monitoring, management system, warehousing, inventory management, distribution, marketing, and game support functions; supplies player loyalty programs, merchandising services, and interactive marketing campaigns; and sublicenses brands for lottery products and lottery-related promotional products. It also provides software, hardware, and related services for lottery operations; and lottery systems software maintenance and support services. The company's SciPlay segment sells virtual coins, chips, or bingo cards; and third-party branded games and original content through mobile and web platforms. Its Digital segment provides digital gaming and sports wagering solutions and services, including digital RMG and sports wagering solutions, distribution platforms, content, products, and services; software design, development, licensing, maintenance, and support services; Open Platform Systems; and content aggregation platforms. The company was founded in 1984 and is headquartered in Las Vegas, Nevada."
SGMS,2019-12-31,188000000,-108000000,104000000,-130000000,707000000,2116000000,583000000,583000000,-589000000,10000000,3400000000,2817000000,1284000000,-691000000,NA,-118000000,-130000000,NA,income_statement,Gambling,Scientific Games Corp,"Scientific Games Corporation develops technology-based products and services, and related content for the gaming, lottery, social and digital gaming industries in the United States and internationally. The company's Gaming segment sells new and used gaming machines, electronic table systems, video lottery terminals, conversion game kits, and spare parts; slot, casino, and table-management systems; table products, including shufflers; and perpetual licenses to proprietary table games. It also leases gaming machines; provides gaming operations and licensing arrangements; and installs and supports casino management systems, such as ongoing hardware and software maintenance and upgrade services of customer casino management systems. The company's Lottery segment designs, prints, and sells instant lottery products; designs and manufactures instant games tickets; offers instant products planning, monitoring, management system, warehousing, inventory management, distribution, marketing, and game support functions; supplies player loyalty programs, merchandising services, and interactive marketing campaigns; and sublicenses brands for lottery products and lottery-related promotional products. It also provides software, hardware, and related services for lottery operations; and lottery systems software maintenance and support services. The company's SciPlay segment sells virtual coins, chips, or bingo cards; and third-party branded games and original content through mobile and web platforms. Its Digital segment provides digital gaming and sports wagering solutions and services, including digital RMG and sports wagering solutions, distribution platforms, content, products, and services; software design, development, licensing, maintenance, and support services; Open Platform Systems; and content aggregation platforms. The company was founded in 1984 and is headquartered in Las Vegas, Nevada."
SGOC,2016-12-31,NA,-5362000,30105000,-5047000,4170000,202000,-3968000,-3968000,-15000,-315000,5069000,9037000,4867000,-1394000,-2411000,-5047000,-5047000,NA,income_statement,Credit Services,"SGOCO Group, Ltd","SGOCO Group, Ltd. designs, develops, and manufactures phase change material storage systems for applications on cooling and heating systems in Mainland China and Hong Kong. The company's products include phase change material thermal energy storage products; LCD/LED monitors; and TV product-related and application-specific products. It is also involved in money lending services; and property lease and management activities. In addition, the company provides fintech and IT support services. It sells its products under the SGOCO, No. 10, and POVIZON brand names. The company was formerly known as SGOCO Technology, Ltd. SGOCO Group, Ltd. was founded in 2005 and is headquartered in Tsuen Wan, Hong Kong."
SGOC,2017-12-31,NA,-9153000,30105000,-11214000,2216000,-1292000,-3508000,-3508000,-13000,-350000,51000,3559000,1343000,-5645000,-2411000,-8803000,-11214000,NA,income_statement,Credit Services,"SGOCO Group, Ltd","SGOCO Group, Ltd. designs, develops, and manufactures phase change material storage systems for applications on cooling and heating systems in Mainland China and Hong Kong. The company's products include phase change material thermal energy storage products; LCD/LED monitors; and TV product-related and application-specific products. It is also involved in money lending services; and property lease and management activities. In addition, the company provides fintech and IT support services. It sells its products under the SGOCO, No. 10, and POVIZON brand names. The company was formerly known as SGOCO Technology, Ltd. SGOCO Group, Ltd. was founded in 2005 and is headquartered in Tsuen Wan, Hong Kong."
SGOC,2018-12-31,NA,-13862000,30105000,-12372000,2391000,-1055000,-3446000,-3446000,-198000,-311000,1580000,5026000,2635000,-10416000,-4198000,-13551000,-12372000,NA,income_statement,Credit Services,"SGOCO Group, Ltd","SGOCO Group, Ltd. designs, develops, and manufactures phase change material storage systems for applications on cooling and heating systems in Mainland China and Hong Kong. The company's products include phase change material thermal energy storage products; LCD/LED monitors; and TV product-related and application-specific products. It is also involved in money lending services; and property lease and management activities. In addition, the company provides fintech and IT support services. It sells its products under the SGOCO, No. 10, and POVIZON brand names. The company was formerly known as SGOCO Technology, Ltd. SGOCO Group, Ltd. was founded in 2005 and is headquartered in Tsuen Wan, Hong Kong."
SGOC,2019-12-31,NA,-41692000,196000,-19402000,4350000,1212000,-3138000,-3138000,-218000,-4640000,5525000,8663000,4313000,-38554000,-4000,-37052000,-19402000,NA,income_statement,Credit Services,"SGOCO Group, Ltd","SGOCO Group, Ltd. designs, develops, and manufactures phase change material storage systems for applications on cooling and heating systems in Mainland China and Hong Kong. The company's products include phase change material thermal energy storage products; LCD/LED monitors; and TV product-related and application-specific products. It is also involved in money lending services; and property lease and management activities. In addition, the company provides fintech and IT support services. It sells its products under the SGOCO, No. 10, and POVIZON brand names. The company was formerly known as SGOCO Technology, Ltd. SGOCO Group, Ltd. was founded in 2005 and is headquartered in Tsuen Wan, Hong Kong."
SGRP,2016-12-31,NA,2197000,5405000,173000,25241000,29543000,2202000,2202000,-133000,441000,134324000,132122000,104781000,-5000,NA,1756000,173000,NA,income_statement,Specialty Business Services,"SPAR Group, Inc.","SPAR Group, Inc., together with its subsidiaries, provides merchandising and marketing services worldwide. The company offers syndicated services, such as product reordering and replenishment; authorized for distribution are in stock and on the shelf or sales floor; adding new products that are approved for distribution; implementing store planogram schematics; setting product category shelves; ensuring that product shelf tags are in place; checking for salability of the clients' products; placing new product and promotional items in prominent positions; and kiosk replenishment and maintenance services for retailers, manufacturers, and distributors. It also provides dedicated services, including syndicated services, as well as new store set-up, store remodel, and fixture installation services for a specific retailer or manufacturer. In addition, the company offers project services comprising specific in-store services initiated by retailers and manufacturers, such as new store openings, new product launches, special seasonal or promotional merchandising, focused product support, product recalls, and in-store product demonstration and sampling, as well as performs kiosk product replenishment, inventory control, new store sets and existing store resets, re-merchandising, remodels and category implementation, and under annual or stand-alone project contracts or agreements. Further, it assembles furniture, grills, and various other products in stores, homes, and offices; and offers in-store event staffing, retail compliance and price audit, mystery shopping, and data collection services. The company serves mass merchandisers; pharmacies; grocery, office supply, dollar, automotive, convenience, specialty, electronic, and home improvement stores; and other retail outlets. SPAR Group, Inc. was founded in 1967 and is headquartered in White Plains, New York."
SGRP,2017-12-31,NA,4154000,5905000,-923000,30564000,36780000,4090000,4090000,-337000,2977000,181381000,177291000,144601000,64000,NA,1177000,-923000,NA,income_statement,Specialty Business Services,"SPAR Group, Inc.","SPAR Group, Inc., together with its subsidiaries, provides merchandising and marketing services worldwide. The company offers syndicated services, such as product reordering and replenishment; authorized for distribution are in stock and on the shelf or sales floor; adding new products that are approved for distribution; implementing store planogram schematics; setting product category shelves; ensuring that product shelf tags are in place; checking for salability of the clients' products; placing new product and promotional items in prominent positions; and kiosk replenishment and maintenance services for retailers, manufacturers, and distributors. It also provides dedicated services, including syndicated services, as well as new store set-up, store remodel, and fixture installation services for a specific retailer or manufacturer. In addition, the company offers project services comprising specific in-store services initiated by retailers and manufacturers, such as new store openings, new product launches, special seasonal or promotional merchandising, focused product support, product recalls, and in-store product demonstration and sampling, as well as performs kiosk product replenishment, inventory control, new store sets and existing store resets, re-merchandising, remodels and category implementation, and under annual or stand-alone project contracts or agreements. Further, it assembles furniture, grills, and various other products in stores, homes, and offices; and offers in-store event staffing, retail compliance and price audit, mystery shopping, and data collection services. The company serves mass merchandisers; pharmacies; grocery, office supply, dollar, automotive, convenience, specialty, electronic, and home improvement stores; and other retail outlets. SPAR Group, Inc. was founded in 1967 and is headquartered in White Plains, New York."
SGRP,2018-12-31,NA,3040000,8476000,-1551000,38449000,44287000,3729000,3729000,-1095000,1402000,229191000,225462000,184904000,-689000,NA,1638000,-1551000,NA,income_statement,Specialty Business Services,"SPAR Group, Inc.","SPAR Group, Inc., together with its subsidiaries, provides merchandising and marketing services worldwide. The company offers syndicated services, such as product reordering and replenishment; authorized for distribution are in stock and on the shelf or sales floor; adding new products that are approved for distribution; implementing store planogram schematics; setting product category shelves; ensuring that product shelf tags are in place; checking for salability of the clients' products; placing new product and promotional items in prominent positions; and kiosk replenishment and maintenance services for retailers, manufacturers, and distributors. It also provides dedicated services, including syndicated services, as well as new store set-up, store remodel, and fixture installation services for a specific retailer or manufacturer. In addition, the company offers project services comprising specific in-store services initiated by retailers and manufacturers, such as new store openings, new product launches, special seasonal or promotional merchandising, focused product support, product recalls, and in-store product demonstration and sampling, as well as performs kiosk product replenishment, inventory control, new store sets and existing store resets, re-merchandising, remodels and category implementation, and under annual or stand-alone project contracts or agreements. Further, it assembles furniture, grills, and various other products in stores, homes, and offices; and offers in-store event staffing, retail compliance and price audit, mystery shopping, and data collection services. The company serves mass merchandisers; pharmacies; grocery, office supply, dollar, automotive, convenience, specialty, electronic, and home improvement stores; and other retail outlets. SPAR Group, Inc. was founded in 1967 and is headquartered in White Plains, New York."
SGRP,2019-12-31,NA,9411000,12406000,2419000,36869000,49250000,10191000,10191000,-1046000,3578000,252876000,242685000,203626000,-780000,NA,5833000,2419000,NA,income_statement,Specialty Business Services,"SPAR Group, Inc.","SPAR Group, Inc., together with its subsidiaries, provides merchandising and marketing services worldwide. The company offers syndicated services, such as product reordering and replenishment; authorized for distribution are in stock and on the shelf or sales floor; adding new products that are approved for distribution; implementing store planogram schematics; setting product category shelves; ensuring that product shelf tags are in place; checking for salability of the clients' products; placing new product and promotional items in prominent positions; and kiosk replenishment and maintenance services for retailers, manufacturers, and distributors. It also provides dedicated services, including syndicated services, as well as new store set-up, store remodel, and fixture installation services for a specific retailer or manufacturer. In addition, the company offers project services comprising specific in-store services initiated by retailers and manufacturers, such as new store openings, new product launches, special seasonal or promotional merchandising, focused product support, product recalls, and in-store product demonstration and sampling, as well as performs kiosk product replenishment, inventory control, new store sets and existing store resets, re-merchandising, remodels and category implementation, and under annual or stand-alone project contracts or agreements. Further, it assembles furniture, grills, and various other products in stores, homes, and offices; and offers in-store event staffing, retail compliance and price audit, mystery shopping, and data collection services. The company serves mass merchandisers; pharmacies; grocery, office supply, dollar, automotive, convenience, specialty, electronic, and home improvement stores; and other retail outlets. SPAR Group, Inc. was founded in 1967 and is headquartered in White Plains, New York."
SGRY,2016-12-31,NA,92178000,495518000,9453000,55154000,300030000,205678000,205678000,-100571000,7095000,1121226000,915548000,821196000,-113500000,NA,85083000,9453000,-353000,income_statement,Medical Care Facilities,"Surgery Partners, Inc.","Surgery Partners, Inc., through its subsidiaries, owns and operates a network of surgical facilities and related services in the United States. The company operates through three segments: Surgical Facility Services, Ancillary Services, and Optical Services. Its surgical facilities comprise ambulatory surgery centers and surgical hospitals that offer non-emergency surgical procedures in various specialties, including gastroenterology, general surgery, ophthalmology, orthopedics, and pain management. The company's surgical hospitals also provide ancillary services, such as diagnostic imaging, pharmacy, laboratory, obstetrics, oncology, physical therapy, and wound care; and ancillary services, which consist of a diagnostic laboratory, multi-specialty physician practices, urgent care facilities, anesthesia services, and optical services. It also operates optical laboratory that manufactures eyewear. As of March 31, 2020, the company owned or operated a portfolio of 127 surgical facilities, including 111 ambulatory surgical centers and 16 surgical hospitals in 30 states. Surgery Partners, Inc. was founded in 2004 and is headquartered in Brentwood, Tennessee."
SGRY,2017-12-31,NA,82300000,981195000,-53000000,69000000,298600000,178200000,178200000,-117700000,53600000,1312400000,1134200000,1013800000,-95900000,NA,28700000,-79100000,-500000,income_statement,Medical Care Facilities,"Surgery Partners, Inc.","Surgery Partners, Inc., through its subsidiaries, owns and operates a network of surgical facilities and related services in the United States. The company operates through three segments: Surgical Facility Services, Ancillary Services, and Optical Services. Its surgical facilities comprise ambulatory surgery centers and surgical hospitals that offer non-emergency surgical procedures in various specialties, including gastroenterology, general surgery, ophthalmology, orthopedics, and pain management. The company's surgical hospitals also provide ancillary services, such as diagnostic imaging, pharmacy, laboratory, obstetrics, oncology, physical therapy, and wound care; and ancillary services, which consist of a diagnostic laboratory, multi-specialty physician practices, urgent care facilities, anesthesia services, and optical services. It also operates optical laboratory that manufactures eyewear. As of March 31, 2020, the company owned or operated a portfolio of 127 surgical facilities, including 111 ambulatory surgical centers and 16 surgical hospitals in 30 states. Surgery Partners, Inc. was founded in 2004 and is headquartered in Brentwood, Tennessee."
SGRY,2018-12-31,NA,-69200000,1020900000,-205700000,92100000,410100000,254300000,254300000,-147000000,26400000,1771500000,1517200000,1361400000,-323500000,NA,-95600000,-238100000,-3700000,income_statement,Medical Care Facilities,"Surgery Partners, Inc.","Surgery Partners, Inc., through its subsidiaries, owns and operates a network of surgical facilities and related services in the United States. The company operates through three segments: Surgical Facility Services, Ancillary Services, and Optical Services. Its surgical facilities comprise ambulatory surgery centers and surgical hospitals that offer non-emergency surgical procedures in various specialties, including gastroenterology, general surgery, ophthalmology, orthopedics, and pain management. The company's surgical hospitals also provide ancillary services, such as diagnostic imaging, pharmacy, laboratory, obstetrics, oncology, physical therapy, and wound care; and ancillary services, which consist of a diagnostic laboratory, multi-specialty physician practices, urgent care facilities, anesthesia services, and optical services. It also operates optical laboratory that manufactures eyewear. As of March 31, 2020, the company owned or operated a portfolio of 127 surgical facilities, including 111 ambulatory surgical centers and 16 surgical hospitals in 30 states. Surgery Partners, Inc. was founded in 2004 and is headquartered in Brentwood, Tennessee."
SGRY,2019-12-31,NA,54600000,1007600000,-74800000,88600000,423800000,260100000,260100000,-178900000,9500000,1831400000,1571300000,1407600000,-205500000,NA,45100000,-110500000,-1400000,income_statement,Medical Care Facilities,"Surgery Partners, Inc.","Surgery Partners, Inc., through its subsidiaries, owns and operates a network of surgical facilities and related services in the United States. The company operates through three segments: Surgical Facility Services, Ancillary Services, and Optical Services. Its surgical facilities comprise ambulatory surgery centers and surgical hospitals that offer non-emergency surgical procedures in various specialties, including gastroenterology, general surgery, ophthalmology, orthopedics, and pain management. The company's surgical hospitals also provide ancillary services, such as diagnostic imaging, pharmacy, laboratory, obstetrics, oncology, physical therapy, and wound care; and ancillary services, which consist of a diagnostic laboratory, multi-specialty physician practices, urgent care facilities, anesthesia services, and optical services. It also operates optical laboratory that manufactures eyewear. As of March 31, 2020, the company owned or operated a portfolio of 127 surgical facilities, including 111 ambulatory surgical centers and 16 surgical hospitals in 30 states. Surgery Partners, Inc. was founded in 2004 and is headquartered in Brentwood, Tennessee."
SGTX,2018-12-31,NA,-22765000,NA,-22765000,6673000,-16402000,-23075000,-23075000,-289000,0,4637000,27712000,21039000,310000,NA,-22765000,-25755000,NA,income_statement,Biotechnology,"Sigilon Therapeutics, Inc.","Sigilon Therapeutics, Inc., a biopharmaceutical company, develops functional cures for patients with chronic diseases. Its lead product candidate is SIG-001, which is in Phase I/II clinical trial to prevent bleeding episodes in patients with moderate-severe to severe Hemophilia A. The company is also developing SIG-005 to treat the non-neurological manifestations of the disease in patients with mucopolysaccharidosis type 1; and SIG-002 designed to replace islet cells for the treatment of type 1 diabetes. The company was formerly known as Sigilon, Inc. and changed its name to Sigilon Therapeutics, Inc. in June 2017. Sigilon Therapeutics, Inc. was founded in 2015 and is headquartered in Cambridge, Massachusetts."
SGTX,2019-12-31,NA,-43925000,NA,-43925000,10170000,-33953000,-44123000,-44123000,-650000,0,14155000,58278000,48108000,198000,NA,-43925000,-43925000,NA,income_statement,Biotechnology,"Sigilon Therapeutics, Inc.","Sigilon Therapeutics, Inc., a biopharmaceutical company, develops functional cures for patients with chronic diseases. Its lead product candidate is SIG-001, which is in Phase I/II clinical trial to prevent bleeding episodes in patients with moderate-severe to severe Hemophilia A. The company is also developing SIG-005 to treat the non-neurological manifestations of the disease in patients with mucopolysaccharidosis type 1; and SIG-002 designed to replace islet cells for the treatment of type 1 diabetes. The company was formerly known as Sigilon, Inc. and changed its name to Sigilon Therapeutics, Inc. in June 2017. Sigilon Therapeutics, Inc. was founded in 2015 and is headquartered in Cambridge, Massachusetts."
SHBI,2017-12-31,NA,17959000,NA,11262000,28576000,51599000,0,19061000,NA,8734000,51599000,32538000,0,-1102000,2037000,9225000,11262000,3962000,income_statement,Banks—Regional,Shore Bancshares Inc,"Shore Bancshares, Inc. operates as a bank holding company for the Shore United Bank that provides various commercial banking products and services to individuals, businesses, and other organizations. It offers various deposit products, including checking, savings, and money market accounts; and regular and IRA certificates of deposit, as well as CDARS programs and cash management services. The company also provides commercial loans, such as secured and unsecured loans, working capital loans, lines of credit, term loans, accounts receivable financing, real estate acquisition and development loans, construction loans, and letters of credit; residential real estate construction loans; residential mortgage loans; and loans to consumers comprising home equity, automobile, installment, home improvement, and personal lines of credit. In addition, it offers safe deposit boxes; debit and credit cards; direct deposit of payroll; merchant credit card clearing services; telephone, mobile, and Internet banking services; and automatic teller machine (ATM) services. Further, the company provides non-deposit products, such as mutual funds and annuities, and discount brokerage services; and trust, asset management, and financial planning services. It operates 21 full service branches, 23 ATMs, 2 loan production offices in Baltimore City, Baltimore County, Howard County, Kent County, Queen Anne's County, Caroline County, Talbot County, Worcester, and Dorchester County in Maryland; Kent County, Delaware; and Accomack County, Virginia. Shore Bancshares, Inc. was founded in 1876 and is headquartered in Easton, Maryland."
SHBI,2018-12-31,NA,21143000,NA,24997000,30485000,57974000,0,23133000,NA,5380000,57974000,34841000,0,-1990000,9234000,15763000,24997000,4356000,income_statement,Banks—Regional,Shore Bancshares Inc,"Shore Bancshares, Inc. operates as a bank holding company for the Shore United Bank that provides various commercial banking products and services to individuals, businesses, and other organizations. It offers various deposit products, including checking, savings, and money market accounts; and regular and IRA certificates of deposit, as well as CDARS programs and cash management services. The company also provides commercial loans, such as secured and unsecured loans, working capital loans, lines of credit, term loans, accounts receivable financing, real estate acquisition and development loans, construction loans, and letters of credit; residential real estate construction loans; residential mortgage loans; and loans to consumers comprising home equity, automobile, installment, home improvement, and personal lines of credit. In addition, it offers safe deposit boxes; debit and credit cards; direct deposit of payroll; merchant credit card clearing services; telephone, mobile, and Internet banking services; and automatic teller machine (ATM) services. Further, the company provides non-deposit products, such as mutual funds and annuities, and discount brokerage services; and trust, asset management, and financial planning services. It operates 21 full service branches, 23 ATMs, 2 loan production offices in Baltimore City, Baltimore County, Howard County, Kent County, Queen Anne's County, Caroline County, Talbot County, Worcester, and Dorchester County in Maryland; Kent County, Delaware; and Accomack County, Virginia. Shore Bancshares, Inc. was founded in 1876 and is headquartered in Easton, Maryland."
SHBI,2019-12-31,NA,21894000,NA,16198000,31478000,59451000,0,23268000,NA,5610000,59451000,36183000,0,-1374000,-86000,16284000,16198000,4705000,income_statement,Banks—Regional,Shore Bancshares Inc,"Shore Bancshares, Inc. operates as a bank holding company for the Shore United Bank that provides various commercial banking products and services to individuals, businesses, and other organizations. It offers various deposit products, including checking, savings, and money market accounts; and regular and IRA certificates of deposit, as well as CDARS programs and cash management services. The company also provides commercial loans, such as secured and unsecured loans, working capital loans, lines of credit, term loans, accounts receivable financing, real estate acquisition and development loans, construction loans, and letters of credit; residential real estate construction loans; residential mortgage loans; and loans to consumers comprising home equity, automobile, installment, home improvement, and personal lines of credit. In addition, it offers safe deposit boxes; debit and credit cards; direct deposit of payroll; merchant credit card clearing services; telephone, mobile, and Internet banking services; and automatic teller machine (ATM) services. Further, the company provides non-deposit products, such as mutual funds and annuities, and discount brokerage services; and trust, asset management, and financial planning services. It operates 21 full service branches, 23 ATMs, 2 loan production offices in Baltimore City, Baltimore County, Howard County, Kent County, Queen Anne's County, Caroline County, Talbot County, Worcester, and Dorchester County in Maryland; Kent County, Delaware; and Accomack County, Virginia. Shore Bancshares, Inc. was founded in 1876 and is headquartered in Easton, Maryland."
SHBI,2020-12-31,NA,21047000,NA,15730000,32627000,59446000,0,22121000,NA,5317000,59446000,37325000,0,-1074000,NA,15730000,15730000,4698000,income_statement,Banks—Regional,Shore Bancshares Inc,"Shore Bancshares, Inc. operates as a bank holding company for the Shore United Bank that provides various commercial banking products and services to individuals, businesses, and other organizations. It offers various deposit products, including checking, savings, and money market accounts; and regular and IRA certificates of deposit, as well as CDARS programs and cash management services. The company also provides commercial loans, such as secured and unsecured loans, working capital loans, lines of credit, term loans, accounts receivable financing, real estate acquisition and development loans, construction loans, and letters of credit; residential real estate construction loans; residential mortgage loans; and loans to consumers comprising home equity, automobile, installment, home improvement, and personal lines of credit. In addition, it offers safe deposit boxes; debit and credit cards; direct deposit of payroll; merchant credit card clearing services; telephone, mobile, and Internet banking services; and automatic teller machine (ATM) services. Further, the company provides non-deposit products, such as mutual funds and annuities, and discount brokerage services; and trust, asset management, and financial planning services. It operates 21 full service branches, 23 ATMs, 2 loan production offices in Baltimore City, Baltimore County, Howard County, Kent County, Queen Anne's County, Caroline County, Talbot County, Worcester, and Dorchester County in Maryland; Kent County, Delaware; and Accomack County, Virginia. Shore Bancshares, Inc. was founded in 1876 and is headquartered in Easton, Maryland."
SHC,1998-03-31,1228824,8714156,14757000,5306473,11346912,22723541,10147805,10147805,-2315784,3407683,46954902,36807097,24231361,-1433649,NA,5306473,5306473,NA,income_statement,Diagnostics & Research,Sotera Health Company,"Sotera Health Company provides sterilization, and lab testing and advisory services to the medical device, pharmaceutical, and food products industries in the United States and internationally. Its sterilization services include gamma and electron beam irradiation, and EO processing; and lab services comprise analytical chemistry, medical device, and pharmaceutical lab testing, as well as microbiology testing. The company also provides Co-60 and gamma irradiators, which are principal components to the gamma sterilization process. Its microbiology testing services help customers to identify and measure the potential risks of microbes to a product and ensure that the quality of the products is maintained; and advisory services help customers in navigating the regulatory requirements applicable throughout the product lifecycle. The company was formerly known as Sotera Health Topco, Inc. and changed its name to Sotera Health Company in October 2020. Sotera Health Company was incorporated in 2017 and is based in Broadview Heights, Ohio."
SHC,1999-03-31,1282218,12816870,14757000,7767238,12836537,27000493,12881738,12881738,-2015368,5049632,54529020,41647282,27528527,-64868,NA,7767238,7767238,NA,income_statement,Diagnostics & Research,Sotera Health Company,"Sotera Health Company provides sterilization, and lab testing and advisory services to the medical device, pharmaceutical, and food products industries in the United States and internationally. Its sterilization services include gamma and electron beam irradiation, and EO processing; and lab services comprise analytical chemistry, medical device, and pharmaceutical lab testing, as well as microbiology testing. The company also provides Co-60 and gamma irradiators, which are principal components to the gamma sterilization process. Its microbiology testing services help customers to identify and measure the potential risks of microbes to a product and ensure that the quality of the products is maintained; and advisory services help customers in navigating the regulatory requirements applicable throughout the product lifecycle. The company was formerly known as Sotera Health Topco, Inc. and changed its name to Sotera Health Company in October 2020. Sotera Health Company was incorporated in 2017 and is based in Broadview Heights, Ohio."
SHC,2018-12-31,NA,24222000,14757000,-5870000,125542000,357252000,173735000,173735000,-143326000,30098000,746149000,572414000,388897000,-149513000,NA,-5876000,-5870000,NA,income_statement,Diagnostics & Research,Sotera Health Company,"Sotera Health Company provides sterilization, and lab testing and advisory services to the medical device, pharmaceutical, and food products industries in the United States and internationally. Its sterilization services include gamma and electron beam irradiation, and EO processing; and lab services comprise analytical chemistry, medical device, and pharmaceutical lab testing, as well as microbiology testing. The company also provides Co-60 and gamma irradiators, which are principal components to the gamma sterilization process. Its microbiology testing services help customers to identify and measure the potential risks of microbes to a product and ensure that the quality of the products is maintained; and advisory services help customers in navigating the regulatory requirements applicable throughout the product lifecycle. The company was formerly known as Sotera Health Topco, Inc. and changed its name to Sotera Health Company in October 2020. Sotera Health Company was incorporated in 2017 and is based in Broadview Heights, Ohio."
SHC,2019-12-31,NA,-916000,15067000,-20850000,126278000,396631000,211791000,211791000,-157729000,19509000,778327000,566536000,381696000,-212707000,NA,-20425000,-20850000,NA,income_statement,Diagnostics & Research,Sotera Health Company,"Sotera Health Company provides sterilization, and lab testing and advisory services to the medical device, pharmaceutical, and food products industries in the United States and internationally. Its sterilization services include gamma and electron beam irradiation, and EO processing; and lab services comprise analytical chemistry, medical device, and pharmaceutical lab testing, as well as microbiology testing. The company also provides Co-60 and gamma irradiators, which are principal components to the gamma sterilization process. Its microbiology testing services help customers to identify and measure the potential risks of microbes to a product and ensure that the quality of the products is maintained; and advisory services help customers in navigating the regulatory requirements applicable throughout the product lifecycle. The company was formerly known as Sotera Health Topco, Inc. and changed its name to Sotera Health Company in October 2020. Sotera Health Company was incorporated in 2017 and is based in Broadview Heights, Ohio."
SHEN,2016-12-31,NA,1945000,NA,-895000,122953000,343796000,77158000,77158000,-25102000,2840000,535288000,458130000,191492000,-75213000,NA,-895000,-895000,NA,income_statement,Telecom Services,Shenandoah Telecommunications C,"Shenandoah Telecommunications Company, together with its subsidiaries, provides wireless and broadband communication products and services in the United States. The company operates in three segments: Wireless, Broadband, and Tower. The Wireless segment provides wireless mobility communications network products. This segment provides its services in central and western Virginia, south-central Pennsylvania, West Virginia, Maryland, Kentucky, and Ohio. As of December 31, 2019, the company provides network service to 844,194 postpaid and 274,012 prepaid subscribers. The Broadband segment offers broadband, video and voice services to residential and commercial customers in Virginia, West Virginia, Maryland, and Kentucky. This segment also leases fiber and provides Ethernet and wavelength fiber optic services; and voice and digital subscriber line telephone services. The Tower segment owns 225 cell towers and leased spaces. The company provides its products and services under the Sprint and Shentel brands. Shenandoah Telecommunications Company was founded in 1902 and is based in Edinburg, Virginia."
SHEN,2017-12-31,NA,13257000,NA,66390000,165937000,400484000,57540000,57540000,-38237000,-53133000,611991000,554451000,211507000,-44283000,NA,66390000,66390000,NA,income_statement,Telecom Services,Shenandoah Telecommunications C,"Shenandoah Telecommunications Company, together with its subsidiaries, provides wireless and broadband communication products and services in the United States. The company operates in three segments: Wireless, Broadband, and Tower. The Wireless segment provides wireless mobility communications network products. This segment provides its services in central and western Virginia, south-central Pennsylvania, West Virginia, Maryland, Kentucky, and Ohio. As of December 31, 2019, the company provides network service to 844,194 postpaid and 274,012 prepaid subscribers. The Broadband segment offers broadband, video and voice services to residential and commercial customers in Virginia, West Virginia, Maryland, and Kentucky. This segment also leases fiber and provides Ethernet and wavelength fiber optic services; and voice and digital subscriber line telephone services. The Tower segment owns 225 cell towers and leased spaces. The company provides its products and services under the Sprint and Shentel brands. Shenandoah Telecommunications Company was founded in 1902 and is based in Edinburg, Virginia."
SHEN,2018-12-31,NA,62112000,NA,46595000,113222000,372873000,93246000,93246000,-34847000,15517000,630854000,537608000,257981000,-31134000,NA,46595000,46595000,NA,income_statement,Telecom Services,Shenandoah Telecommunications C,"Shenandoah Telecommunications Company, together with its subsidiaries, provides wireless and broadband communication products and services in the United States. The company operates in three segments: Wireless, Broadband, and Tower. The Wireless segment provides wireless mobility communications network products. This segment provides its services in central and western Virginia, south-central Pennsylvania, West Virginia, Maryland, Kentucky, and Ohio. As of December 31, 2019, the company provides network service to 844,194 postpaid and 274,012 prepaid subscribers. The Broadband segment offers broadband, video and voice services to residential and commercial customers in Virginia, West Virginia, Maryland, and Kentucky. This segment also leases fiber and provides Ethernet and wavelength fiber optic services; and voice and digital subscriber line telephone services. The Tower segment owns 225 cell towers and leased spaces. The company provides its products and services under the Sprint and Shentel brands. Shenandoah Telecommunications Company was founded in 1902 and is based in Edinburg, Virginia."
SHEN,2019-12-31,NA,71039000,NA,54935000,112540000,369239000,97046000,97046000,-29468000,16104000,633906000,536860000,264667000,-26007000,NA,54935000,54935000,NA,income_statement,Telecom Services,Shenandoah Telecommunications C,"Shenandoah Telecommunications Company, together with its subsidiaries, provides wireless and broadband communication products and services in the United States. The company operates in three segments: Wireless, Broadband, and Tower. The Wireless segment provides wireless mobility communications network products. This segment provides its services in central and western Virginia, south-central Pennsylvania, West Virginia, Maryland, Kentucky, and Ohio. As of December 31, 2019, the company provides network service to 844,194 postpaid and 274,012 prepaid subscribers. The Broadband segment offers broadband, video and voice services to residential and commercial customers in Virginia, West Virginia, Maryland, and Kentucky. This segment also leases fiber and provides Ethernet and wavelength fiber optic services; and voice and digital subscriber line telephone services. The Tower segment owns 225 cell towers and leased spaces. The company provides its products and services under the Sprint and Shentel brands. Shenandoah Telecommunications Company was founded in 1902 and is based in Edinburg, Virginia."
SHIP,2016-12-31,NA,-24589000,NA,-24623000,5029000,-1153000,-14713000,-14713000,-9824000,34000,34662000,49375000,35815000,-9876000,NA,-24623000,-24623000,NA,income_statement,Marine Shipping,Seanergy Maritime Holdings Corp,"Seanergy Maritime Holdings Corp., an international shipping company, engages in the seaborne transportation of dry bulk commodities worldwide. It owns a fleet of ten Capesize bulk carriers with a cargo-carrying capacity of approximately 1,748,581 deadweight tons and an average fleet age of 11 years. The company is headquartered in Athens, Greece."
SHIP,2017-12-31,NA,-3235000,NA,-3235000,6097000,19417000,2802000,2802000,-17338000,0,74834000,72032000,55417000,-6037000,NA,-3235000,-3235000,NA,income_statement,Marine Shipping,Seanergy Maritime Holdings Corp,"Seanergy Maritime Holdings Corp., an international shipping company, engages in the seaborne transportation of dry bulk commodities worldwide. It owns a fleet of ten Capesize bulk carriers with a cargo-carrying capacity of approximately 1,748,581 deadweight tons and an average fleet age of 11 years. The company is headquartered in Athens, Greece."
SHIP,2018-12-31,NA,-21042000,NA,-21058000,7542000,29960000,11542000,11542000,-24873000,16000,91520000,79978000,61560000,-32584000,NA,-21058000,-21058000,NA,income_statement,Marine Shipping,Seanergy Maritime Holdings Corp,"Seanergy Maritime Holdings Corp., an international shipping company, engages in the seaborne transportation of dry bulk commodities worldwide. It owns a fleet of ten Capesize bulk carriers with a cargo-carrying capacity of approximately 1,748,581 deadweight tons and an average fleet age of 11 years. The company is headquartered in Athens, Greece."
SHIP,2019-12-31,NA,-11644000,NA,-11698000,6978000,30034000,12040000,12040000,-19492000,54000,86499000,74459000,56465000,-24848000,NA,-11698000,-11698000,NA,income_statement,Marine Shipping,Seanergy Maritime Holdings Corp,"Seanergy Maritime Holdings Corp., an international shipping company, engages in the seaborne transportation of dry bulk commodities worldwide. It owns a fleet of ten Capesize bulk carriers with a cargo-carrying capacity of approximately 1,748,581 deadweight tons and an average fleet age of 11 years. The company is headquartered in Athens, Greece."
SHIPW,2014-12-31,NA,80348000,NA,80348000,3418000,-294000,-3753000,-3753000,-1453000,0,2010000,5763000,2304000,84101000,NA,80348000,80348000,NA,income_statement,NA,NA,NA
SHIPW,2015-12-31,NA,-8956000,NA,-8956000,3210000,-1950000,-7055000,-7055000,-2024000,0,11223000,18278000,13173000,-1901000,NA,-8956000,-8956000,NA,income_statement,NA,NA,NA
SHIPW,2016-12-31,NA,-24589000,NA,-24623000,5029000,-1153000,-14713000,-14713000,-9824000,34000,34662000,49375000,35815000,-9876000,NA,-24623000,-24623000,NA,income_statement,NA,NA,NA
SHIPW,2017-12-31,NA,-3235000,NA,-3235000,6097000,19417000,2802000,2802000,-17338000,0,74834000,72032000,55417000,-6037000,NA,-3235000,-3235000,NA,income_statement,NA,NA,NA
SHLS,2018-12-31,NA,8647000,NA,8647000,8904000,28168000,11087000,11087000,-2440000,0,103750000,92663000,75582000,-2440000,NA,8647000,8647000,NA,income_statement,Solar,"Shoals Technologies Group, Inc.","Shoals Technologies Group, Inc. provides electrical balance of system (EBOS) solutions for solar energy projects in the United States. It offers EBOS components, such as cable assemblies, inline fuses, combiners, disconnects, recombiners, wireless monitoring systems, junction boxes, transition enclosures, and splice boxes that carry the electric current produced by solar panels to an inverter and to the power grid. The company sells its products to engineering, procurement, and construction firms that build solar energy projects. Shoals Technologies Group, Inc. was founded in 1996 and is headquartered in Portland, Tennessee."
SHLS,2019-12-31,NA,25143000,NA,25143000,9065000,44212000,26930000,26930000,-1787000,0,144496000,117566000,100284000,-1787000,NA,25143000,25143000,NA,income_statement,Solar,"Shoals Technologies Group, Inc.","Shoals Technologies Group, Inc. provides electrical balance of system (EBOS) solutions for solar energy projects in the United States. It offers EBOS components, such as cable assemblies, inline fuses, combiners, disconnects, recombiners, wireless monitoring systems, junction boxes, transition enclosures, and splice boxes that carry the electric current produced by solar panels to an inverter and to the power grid. The company sells its products to engineering, procurement, and construction firms that build solar energy projects. Shoals Technologies Group, Inc. was founded in 1996 and is headquartered in Portland, Tennessee."
SHOO,2016-12-31,NA,171000000,205000,120911000,345152000,521983000,168751000,168751000,NA,49726000,1399551000,1230800000,877568000,2246000,NA,121274000,120911000,-11788000,income_statement,Footwear & Accessories,"Steven Madden, Ltd.","Steven Madden, Ltd. designs, sources, markets, and sells fashion-forward name brand and private label footwear for women, men, and children in the United States and internationally. Its Wholesale Footwear segment provides footwear under the Steve Madden Women's, Madden Girl, Steve Madden Men's, Madden, Madden NYC, Report, Dolce Vita, DV by Dolce Vita, Mad Love, Steven by Steve Madden, Superga, Betsey Johnson, Betseyville, Steve Madden Kids, Stevies, GREATS, Blondo, and Anne Klein brands, as well as private label footwear. The company's Wholesale Accessories segment offers Steve Madden, Steven by Steve Madden, Madden Girl, Betsey Johnson, Madden NYC, Big Buddha, DKNY, Anne Klein, Jocelyn, Luv Betsey, BB Dakota, Cupcakes & Cashmere, and accessories brands; private label fashion handbags and accessories to department stores, mass merchants, value priced retailers, online retailers, and specialty stores; and cold weather accessories, fashion scarves, wraps, and other trend accessories primarily under the Steve Madden, BB Dakota, Cejon, Betsey Johnson, and Big Buddha brand names, as well as private labels to department stores and specialty stores. Its Retail segment operates Steve Madden, Steven, Superga, GREATS, and International retail stores, as well as Steve Madden, Superga, Betsey Johnson, Blondo, Dolce Vita, BB Dakota, and Jocelyn e-commerce websites. The company's Licensing segment licenses its Steve Madden, Steven by Steve Madden, Madden Girl, and FREEBIRD by Steven trademarks. Its First Cost segment operates as a buying agent for footwear products under private labels for mass-market merchandisers, shoe chains, and other mid-tier retailers. As of December 31, 2019, it owned and operated 227 retail stores, including 146 Steve Madden full-price stores, 68 Steve Madden outlet stores, 2 Steven stores, 2 GREATS stores, and 1 Superga store, as well as 8 e-commerce websites. Steven Madden, Ltd. was founded in 1990 and is headquartered in Long Island City, New York."
SHOO,2017-12-31,NA,172327000,6111000,117948000,413136000,598726000,165185000,165185000,NA,53189000,1567083000,1401898000,968357000,7132000,NA,119138000,117948000,NA,income_statement,Footwear & Accessories,"Steven Madden, Ltd.","Steven Madden, Ltd. designs, sources, markets, and sells fashion-forward name brand and private label footwear for women, men, and children in the United States and internationally. Its Wholesale Footwear segment provides footwear under the Steve Madden Women's, Madden Girl, Steve Madden Men's, Madden, Madden NYC, Report, Dolce Vita, DV by Dolce Vita, Mad Love, Steven by Steve Madden, Superga, Betsey Johnson, Betseyville, Steve Madden Kids, Stevies, GREATS, Blondo, and Anne Klein brands, as well as private label footwear. The company's Wholesale Accessories segment offers Steve Madden, Steven by Steve Madden, Madden Girl, Betsey Johnson, Madden NYC, Big Buddha, DKNY, Anne Klein, Jocelyn, Luv Betsey, BB Dakota, Cupcakes & Cashmere, and accessories brands; private label fashion handbags and accessories to department stores, mass merchants, value priced retailers, online retailers, and specialty stores; and cold weather accessories, fashion scarves, wraps, and other trend accessories primarily under the Steve Madden, BB Dakota, Cejon, Betsey Johnson, and Big Buddha brand names, as well as private labels to department stores and specialty stores. Its Retail segment operates Steve Madden, Steven, Superga, GREATS, and International retail stores, as well as Steve Madden, Superga, Betsey Johnson, Blondo, Dolce Vita, BB Dakota, and Jocelyn e-commerce websites. The company's Licensing segment licenses its Steve Madden, Steven by Steve Madden, Madden Girl, and FREEBIRD by Steven trademarks. Its First Cost segment operates as a buying agent for footwear products under private labels for mass-market merchandisers, shoe chains, and other mid-tier retailers. As of December 31, 2019, it owned and operated 227 retail stores, including 146 Steve Madden full-price stores, 68 Steve Madden outlet stores, 2 Steven stores, 2 GREATS stores, and 1 Superga store, as well as 8 e-commerce websites. Steven Madden, Ltd. was founded in 1990 and is headquartered in Long Island City, New York."
SHOO,2018-12-31,NA,177340000,8868000,129136000,426761000,640163000,191648000,191648000,NA,46841000,1677734000,1486086000,1037571000,-14308000,NA,130499000,129136000,NA,income_statement,Footwear & Accessories,"Steven Madden, Ltd.","Steven Madden, Ltd. designs, sources, markets, and sells fashion-forward name brand and private label footwear for women, men, and children in the United States and internationally. Its Wholesale Footwear segment provides footwear under the Steve Madden Women's, Madden Girl, Steve Madden Men's, Madden, Madden NYC, Report, Dolce Vita, DV by Dolce Vita, Mad Love, Steven by Steve Madden, Superga, Betsey Johnson, Betseyville, Steve Madden Kids, Stevies, GREATS, Blondo, and Anne Klein brands, as well as private label footwear. The company's Wholesale Accessories segment offers Steve Madden, Steven by Steve Madden, Madden Girl, Betsey Johnson, Madden NYC, Big Buddha, DKNY, Anne Klein, Jocelyn, Luv Betsey, BB Dakota, Cupcakes & Cashmere, and accessories brands; private label fashion handbags and accessories to department stores, mass merchants, value priced retailers, online retailers, and specialty stores; and cold weather accessories, fashion scarves, wraps, and other trend accessories primarily under the Steve Madden, BB Dakota, Cejon, Betsey Johnson, and Big Buddha brand names, as well as private labels to department stores and specialty stores. Its Retail segment operates Steve Madden, Steven, Superga, GREATS, and International retail stores, as well as Steve Madden, Superga, Betsey Johnson, Blondo, Dolce Vita, BB Dakota, and Jocelyn e-commerce websites. The company's Licensing segment licenses its Steve Madden, Steven by Steve Madden, Madden Girl, and FREEBIRD by Steven trademarks. Its First Cost segment operates as a buying agent for footwear products under private labels for mass-market merchandisers, shoe chains, and other mid-tier retailers. As of December 31, 2019, it owned and operated 227 retail stores, including 146 Steve Madden full-price stores, 68 Steve Madden outlet stores, 2 Steven stores, 2 GREATS stores, and 1 Superga store, as well as 8 e-commerce websites. Steven Madden, Ltd. was founded in 1990 and is headquartered in Long Island City, New York."
SHOO,2019-12-31,NA,181226000,12723000,141311000,478302000,686017000,185464000,185464000,NA,39504000,1787157000,1601693000,1101140000,-4238000,NA,141722000,141311000,NA,income_statement,Footwear & Accessories,"Steven Madden, Ltd.","Steven Madden, Ltd. designs, sources, markets, and sells fashion-forward name brand and private label footwear for women, men, and children in the United States and internationally. Its Wholesale Footwear segment provides footwear under the Steve Madden Women's, Madden Girl, Steve Madden Men's, Madden, Madden NYC, Report, Dolce Vita, DV by Dolce Vita, Mad Love, Steven by Steve Madden, Superga, Betsey Johnson, Betseyville, Steve Madden Kids, Stevies, GREATS, Blondo, and Anne Klein brands, as well as private label footwear. The company's Wholesale Accessories segment offers Steve Madden, Steven by Steve Madden, Madden Girl, Betsey Johnson, Madden NYC, Big Buddha, DKNY, Anne Klein, Jocelyn, Luv Betsey, BB Dakota, Cupcakes & Cashmere, and accessories brands; private label fashion handbags and accessories to department stores, mass merchants, value priced retailers, online retailers, and specialty stores; and cold weather accessories, fashion scarves, wraps, and other trend accessories primarily under the Steve Madden, BB Dakota, Cejon, Betsey Johnson, and Big Buddha brand names, as well as private labels to department stores and specialty stores. Its Retail segment operates Steve Madden, Steven, Superga, GREATS, and International retail stores, as well as Steve Madden, Superga, Betsey Johnson, Blondo, Dolce Vita, BB Dakota, and Jocelyn e-commerce websites. The company's Licensing segment licenses its Steve Madden, Steven by Steve Madden, Madden Girl, and FREEBIRD by Steven trademarks. Its First Cost segment operates as a buying agent for footwear products under private labels for mass-market merchandisers, shoe chains, and other mid-tier retailers. As of December 31, 2019, it owned and operated 227 retail stores, including 146 Steve Madden full-price stores, 68 Steve Madden outlet stores, 2 Steven stores, 2 GREATS stores, and 1 Superga store, as well as 8 e-commerce websites. Steven Madden, Ltd. was founded in 1990 and is headquartered in Long Island City, New York."
SHSP,2016-12-31,2277957,-7585163,NA,4951010,9578839,7162806,-6054095,-6054095,-298213,-1869188,11541702,17595797,4378896,-1531068,10666985,-5715975,4951010,NA,income_statement,Software—Application,"SharpSpring, Inc.","SharpSpring, Inc. operates as a cloud-based marketing technology company worldwide. The company offers SharpSpring, a marketing automation Software as Service platform that uses features, such as web tracking, lead scoring, and automated workflow; and SharpSpring Mail+ product, a subset of the full suite solution, which focuses on traditional email marketing. It also provides Perfect Audience, a cloud-based platform that offers display retargeting software products and services. The company serves various organizations, including marketing agencies and small and medium size businesses, associations, and non-profits. It markets and sells its products and services through internal sales teams and third party resellers. The company was formerly known as SMTP, Inc. and changed its name to SharpSpring, Inc. in December 2015. SharpSpring, Inc. was founded in 1998 and is headquartered in Gainesville, Florida."
SHSP,2017-12-31,2883714,-6773943,NA,-4669835,12023943,8452007,-6983118,-6983118,-298213,-2104108,13448752,20431870,4996745,209175,NA,-4669835,-4669835,NA,income_statement,Software—Application,"SharpSpring, Inc.","SharpSpring, Inc. operates as a cloud-based marketing technology company worldwide. The company offers SharpSpring, a marketing automation Software as Service platform that uses features, such as web tracking, lead scoring, and automated workflow; and SharpSpring Mail+ product, a subset of the full suite solution, which focuses on traditional email marketing. It also provides Perfect Audience, a cloud-based platform that offers display retargeting software products and services. The company serves various organizations, including marketing agencies and small and medium size businesses, associations, and non-profits. It markets and sells its products and services through internal sales teams and third party resellers. The company was formerly known as SMTP, Inc. and changed its name to SharpSpring, Inc. in December 2015. SharpSpring, Inc. was founded in 1998 and is headquartered in Gainesville, Florida."
SHSP,2018-12-31,4298031,-9809816,NA,-9478822,16200778,12853256,-8614114,-8614114,-298213,-330994,18651525,27265639,5798269,-1195702,NA,-9478822,-9478822,NA,income_statement,Software—Application,"SharpSpring, Inc.","SharpSpring, Inc. operates as a cloud-based marketing technology company worldwide. The company offers SharpSpring, a marketing automation Software as Service platform that uses features, such as web tracking, lead scoring, and automated workflow; and SharpSpring Mail+ product, a subset of the full suite solution, which focuses on traditional email marketing. It also provides Perfect Audience, a cloud-based platform that offers display retargeting software products and services. The company serves various organizations, including marketing agencies and small and medium size businesses, associations, and non-profits. It markets and sells its products and services through internal sales teams and third party resellers. The company was formerly known as SMTP, Inc. and changed its name to SharpSpring, Inc. in December 2015. SharpSpring, Inc. was founded in 1998 and is headquartered in Gainesville, Florida."
SHSP,2019-12-31,5036613,-12358627,NA,-12387976,20092300,15556970,-9952943,-9952943,-142275,29349,22699386,32652329,7142416,-2405684,NA,-12387976,-12387976,NA,income_statement,Software—Application,"SharpSpring, Inc.","SharpSpring, Inc. operates as a cloud-based marketing technology company worldwide. The company offers SharpSpring, a marketing automation Software as Service platform that uses features, such as web tracking, lead scoring, and automated workflow; and SharpSpring Mail+ product, a subset of the full suite solution, which focuses on traditional email marketing. It also provides Perfect Audience, a cloud-based platform that offers display retargeting software products and services. The company serves various organizations, including marketing agencies and small and medium size businesses, associations, and non-profits. It markets and sells its products and services through internal sales teams and third party resellers. The company was formerly known as SMTP, Inc. and changed its name to SharpSpring, Inc. in December 2015. SharpSpring, Inc. was founded in 1998 and is headquartered in Gainesville, Florida."
SHW,2017-12-31,NA,1469300000,NA,1727900000,4781900000,6718800000,1714700000,1714700000,-263500000,-300200000,14983800000,13269100000,8265000000,-245400000,-41600000,1769500000,1727900000,15400000,income_statement,NA,NA,NA
SHW,2018-12-31,NA,1359700000,NA,1108700000,5060600000,7418600000,1863600000,1863600000,-366700000,251000000,17534500000,15670900000,10115900000,-503900000,NA,1108700000,1108700000,176300000,income_statement,NA,NA,NA
SHW,2019-12-31,NA,1981800000,NA,1541300000,5366100000,8036100000,2385000000,2385000000,-349300000,440500000,17900800000,15515800000,9864700000,-403200000,NA,1541300000,1541300000,-27800000,income_statement,NA,NA,NA
SHW,2020-12-31,NA,2519200000,NA,2030400000,5477900000,8682600000,2854200000,2854200000,-340400000,488800000,18361700000,15507500000,9679100000,-335000000,NA,2030400000,2030400000,37100000,income_statement,NA,NA,NA
SHYF,2016-12-31,6772000,8703000,-657000,8610000,56172000,73070000,10126000,10126000,-410000,100000,590777000,580651000,517707000,-1423000,-1537000,8603000,8610000,NA,income_statement,Farm & Heavy Construction Machinery,"The Shyft Group, Inc.","The Shyft Group, Inc., through its subsidiary Spartan Motors USA, Inc., manufactures and assembles specialty vehicles for the commercial vehicle and recreational vehicle industries in the United States and internationally. It operates through two segments, Fleet Vehicles and Services (FVS), and Specialty Chassis and Vehicles (SCV). The FVS segment manufactures and sells various commercial vehicles that are used in the e-commerce/last mile/parcel delivery, beverage and grocery delivery, laundry and linen, mobile retail, and trades and construction industries. This segment markets its commercial vehicles under the Aeromaster, Velocity, Ultimate, Trademaster, Metromaster, Utilivan, Utilimaster Upfit Services, and Reach brand names. It also installs specialty interior and exterior up-fit equipment for walk-in vans, truck bodies, and passenger vans under Specialty Up-fit name; and provides aftermarket support, including parts sales and field services. The SCV engages in the engineering and manufacture of luxury class A diesel motor home chassis; manufacture and assemble of truck body options for various trades, service truck bodies, stake body trucks, contractor trucks, and dump bed trucks; and provision of chassis and complete vehicle assembly services for military vehicles, drill rigs, shuttle bus chassis, and other specialty chassis and vehicles. This segment also offers assembly services for Isuzu N-gas and F-series chassis; and parts and accessories for its motor home, defense, and specialty chassis, as well as maintenance and repair services for its motor home and specialty chassis. The company sells its products to commercial users, original equipment manufacturers, dealers, individual end users, and municipalities and other governmental entities. The company was formerly known as Spartan Motors, Inc. and changed its name to The Shyft Group, Inc. in June 2020. The Shyft Group, Inc. was founded in 1975 and is headquartered in Novi, Michigan."
SHYF,2017-12-31,3596000,19853000,-658000,15935000,39329000,63072000,20147000,20147000,-98000,2382000,404248000,384101000,341176000,-294000,-1537000,17471000,15935000,NA,income_statement,Farm & Heavy Construction Machinery,"The Shyft Group, Inc.","The Shyft Group, Inc., through its subsidiary Spartan Motors USA, Inc., manufactures and assembles specialty vehicles for the commercial vehicle and recreational vehicle industries in the United States and internationally. It operates through two segments, Fleet Vehicles and Services (FVS), and Specialty Chassis and Vehicles (SCV). The FVS segment manufactures and sells various commercial vehicles that are used in the e-commerce/last mile/parcel delivery, beverage and grocery delivery, laundry and linen, mobile retail, and trades and construction industries. This segment markets its commercial vehicles under the Aeromaster, Velocity, Ultimate, Trademaster, Metromaster, Utilivan, Utilimaster Upfit Services, and Reach brand names. It also installs specialty interior and exterior up-fit equipment for walk-in vans, truck bodies, and passenger vans under Specialty Up-fit name; and provides aftermarket support, including parts sales and field services. The SCV engages in the engineering and manufacture of luxury class A diesel motor home chassis; manufacture and assemble of truck body options for various trades, service truck bodies, stake body trucks, contractor trucks, and dump bed trucks; and provision of chassis and complete vehicle assembly services for military vehicles, drill rigs, shuttle bus chassis, and other specialty chassis and vehicles. This segment also offers assembly services for Isuzu N-gas and F-series chassis; and parts and accessories for its motor home, defense, and specialty chassis, as well as maintenance and repair services for its motor home and specialty chassis. The company sells its products to commercial users, original equipment manufacturers, dealers, individual end users, and municipalities and other governmental entities. The company was formerly known as Spartan Motors, Inc. and changed its name to The Shyft Group, Inc. in June 2020. The Shyft Group, Inc. was founded in 1975 and is headquartered in Novi, Michigan."
SHYF,2018-12-31,3771000,21450000,-658000,15012000,46206000,73157000,23180000,23180000,-1080000,3334000,570527000,547347000,497370000,510000,-3104000,18116000,15012000,NA,income_statement,Farm & Heavy Construction Machinery,"The Shyft Group, Inc.","The Shyft Group, Inc., through its subsidiary Spartan Motors USA, Inc., manufactures and assembles specialty vehicles for the commercial vehicle and recreational vehicle industries in the United States and internationally. It operates through two segments, Fleet Vehicles and Services (FVS), and Specialty Chassis and Vehicles (SCV). The FVS segment manufactures and sells various commercial vehicles that are used in the e-commerce/last mile/parcel delivery, beverage and grocery delivery, laundry and linen, mobile retail, and trades and construction industries. This segment markets its commercial vehicles under the Aeromaster, Velocity, Ultimate, Trademaster, Metromaster, Utilivan, Utilimaster Upfit Services, and Reach brand names. It also installs specialty interior and exterior up-fit equipment for walk-in vans, truck bodies, and passenger vans under Specialty Up-fit name; and provides aftermarket support, including parts sales and field services. The SCV engages in the engineering and manufacture of luxury class A diesel motor home chassis; manufacture and assemble of truck body options for various trades, service truck bodies, stake body trucks, contractor trucks, and dump bed trucks; and provision of chassis and complete vehicle assembly services for military vehicles, drill rigs, shuttle bus chassis, and other specialty chassis and vehicles. This segment also offers assembly services for Isuzu N-gas and F-series chassis; and parts and accessories for its motor home, defense, and specialty chassis, as well as maintenance and repair services for its motor home and specialty chassis. The company sells its products to commercial users, original equipment manufacturers, dealers, individual end users, and municipalities and other governmental entities. The company was formerly known as Spartan Motors, Inc. and changed its name to The Shyft Group, Inc. in June 2020. The Shyft Group, Inc. was founded in 1975 and is headquartered in Novi, Michigan."
SHYF,2019-12-31,4864000,47145000,-518000,-12566000,62782000,117033000,49387000,49387000,-1839000,10355000,756542000,707155000,639509000,-2242000,-49216000,36790000,-12566000,NA,income_statement,Farm & Heavy Construction Machinery,"The Shyft Group, Inc.","The Shyft Group, Inc., through its subsidiary Spartan Motors USA, Inc., manufactures and assembles specialty vehicles for the commercial vehicle and recreational vehicle industries in the United States and internationally. It operates through two segments, Fleet Vehicles and Services (FVS), and Specialty Chassis and Vehicles (SCV). The FVS segment manufactures and sells various commercial vehicles that are used in the e-commerce/last mile/parcel delivery, beverage and grocery delivery, laundry and linen, mobile retail, and trades and construction industries. This segment markets its commercial vehicles under the Aeromaster, Velocity, Ultimate, Trademaster, Metromaster, Utilivan, Utilimaster Upfit Services, and Reach brand names. It also installs specialty interior and exterior up-fit equipment for walk-in vans, truck bodies, and passenger vans under Specialty Up-fit name; and provides aftermarket support, including parts sales and field services. The SCV engages in the engineering and manufacture of luxury class A diesel motor home chassis; manufacture and assemble of truck body options for various trades, service truck bodies, stake body trucks, contractor trucks, and dump bed trucks; and provision of chassis and complete vehicle assembly services for military vehicles, drill rigs, shuttle bus chassis, and other specialty chassis and vehicles. This segment also offers assembly services for Isuzu N-gas and F-series chassis; and parts and accessories for its motor home, defense, and specialty chassis, as well as maintenance and repair services for its motor home and specialty chassis. The company sells its products to commercial users, original equipment manufacturers, dealers, individual end users, and municipalities and other governmental entities. The company was formerly known as Spartan Motors, Inc. and changed its name to The Shyft Group, Inc. in June 2020. The Shyft Group, Inc. was founded in 1975 and is headquartered in Novi, Michigan."
SIBN,2016-12-31,5380000,-20589000,NA,-20589000,49121000,36936000,-17565000,-17565000,-3308000,0,42101000,59666000,5165000,-3024000,NA,-20589000,-20589000,NA,income_statement,Medical Devices,"SI-BONE, Inc.","SI-BONE, Inc., a medical device company, develops implantable devices used in the surgical treatment of the sacropelvic anatomy in the United States and Internationally. The company offers iFuse, a minimally invasive surgical implant system, which is intended to fuse the sacroiliac joint to treat sacroiliac joint dysfunction that causes lower back pain. SI-BONE, Inc. was founded in 2008 and is headquartered in Santa Clara, California."
SIBN,2017-12-31,4513000,-23039000,NA,-23039000,55708000,42871000,-17350000,-17350000,-6204000,0,47983000,65333000,5112000,-5689000,NA,-23039000,-23039000,NA,income_statement,Medical Devices,"SI-BONE, Inc.","SI-BONE, Inc., a medical device company, develops implantable devices used in the surgical treatment of the sacropelvic anatomy in the United States and Internationally. The company offers iFuse, a minimally invasive surgical implant system, which is intended to fuse the sacroiliac joint to treat sacroiliac joint dysfunction that causes lower back pain. SI-BONE, Inc. was founded in 2008 and is headquartered in Santa Clara, California."
SIBN,2018-12-31,4176000,-17453000,NA,-17453000,58336000,50547000,-11965000,-11965000,-5108000,0,55380000,67345000,4833000,-5488000,NA,-17453000,-17453000,NA,income_statement,Medical Devices,"SI-BONE, Inc.","SI-BONE, Inc., a medical device company, develops implantable devices used in the surgical treatment of the sacropelvic anatomy in the United States and Internationally. The company offers iFuse, a minimally invasive surgical implant system, which is intended to fuse the sacroiliac joint to treat sacroiliac joint dysfunction that causes lower back pain. SI-BONE, Inc. was founded in 2008 and is headquartered in Santa Clara, California."
SIBN,2019-12-31,6079000,-38403000,NA,-38403000,87235000,60511000,-32803000,-32803000,-4949000,0,67301000,100104000,6790000,-5600000,NA,-38403000,-38403000,NA,income_statement,Medical Devices,"SI-BONE, Inc.","SI-BONE, Inc., a medical device company, develops implantable devices used in the surgical treatment of the sacropelvic anatomy in the United States and Internationally. The company offers iFuse, a minimally invasive surgical implant system, which is intended to fuse the sacroiliac joint to treat sacroiliac joint dysfunction that causes lower back pain. SI-BONE, Inc. was founded in 2008 and is headquartered in Santa Clara, California."
SIC,2016-12-31,NA,9689000,NA,7055000,51905000,66830000,14925000,14925000,-4735000,2634000,233868000,218943000,167038000,-5236000,NA,7055000,7055000,NA,income_statement,Residential Construction,"Select Interior Concepts, Inc.","Select Interior Concepts, Inc., together with its subsidiaries, installs and distributes interior building products for residential interior design services markets in the United States. The company operates through two segments, Residential Design Services and Architectural Surfaces Group. The Residential Design Services segment provides an integrated, outsourced solution for the design, consultation, sourcing, distribution, and installation needs of homebuyer customers. It works with homebuyers in the selection of an array of interior products and finishes, including flooring, cabinets, countertops, wall tile, and related interior items, primarily for newly constructed homes; and coordinates the ordering, fulfillment, and installation of interior products. The Architectural Surfaces Group segment imports and distributes natural and engineered stone slabs, such as marble, granite, porcelain, and quartz for kitchen and bathroom countertops; and ceramic and porcelain tiles for flooring, backsplash, and wall tile applications, as well as tile. It markets these materials through a network of 23 distribution centers and showrooms. The company serves new residential and commercial construction markets, as well as distributes its products to the repair and remodel market. The company was incorporated in 2015 and is headquartered in Atlanta, Georgia."
SIC,2017-12-31,NA,-8026000,NA,-11346000,92127000,103889000,9962000,9962000,-12761000,3320000,352952000,342990000,249063000,-17988000,NA,-11346000,-5689000,NA,income_statement,Residential Construction,"Select Interior Concepts, Inc.","Select Interior Concepts, Inc., together with its subsidiaries, installs and distributes interior building products for residential interior design services markets in the United States. The company operates through two segments, Residential Design Services and Architectural Surfaces Group. The Residential Design Services segment provides an integrated, outsourced solution for the design, consultation, sourcing, distribution, and installation needs of homebuyer customers. It works with homebuyers in the selection of an array of interior products and finishes, including flooring, cabinets, countertops, wall tile, and related interior items, primarily for newly constructed homes; and coordinates the ordering, fulfillment, and installation of interior products. The Architectural Surfaces Group segment imports and distributes natural and engineered stone slabs, such as marble, granite, porcelain, and quartz for kitchen and bathroom countertops; and ceramic and porcelain tiles for flooring, backsplash, and wall tile applications, as well as tile. It markets these materials through a network of 23 distribution centers and showrooms. The company serves new residential and commercial construction markets, as well as distributes its products to the repair and remodel market. The company was incorporated in 2015 and is headquartered in Atlanta, Georgia."
SIC,2018-12-31,NA,-1486000,NA,-2475000,117257000,133454000,13297000,13297000,-11426000,989000,489757000,476460000,356303000,-14783000,NA,-2475000,-2475000,NA,income_statement,Residential Construction,"Select Interior Concepts, Inc.","Select Interior Concepts, Inc., together with its subsidiaries, installs and distributes interior building products for residential interior design services markets in the United States. The company operates through two segments, Residential Design Services and Architectural Surfaces Group. The Residential Design Services segment provides an integrated, outsourced solution for the design, consultation, sourcing, distribution, and installation needs of homebuyer customers. It works with homebuyers in the selection of an array of interior products and finishes, including flooring, cabinets, countertops, wall tile, and related interior items, primarily for newly constructed homes; and coordinates the ordering, fulfillment, and installation of interior products. The Architectural Surfaces Group segment imports and distributes natural and engineered stone slabs, such as marble, granite, porcelain, and quartz for kitchen and bathroom countertops; and ceramic and porcelain tiles for flooring, backsplash, and wall tile applications, as well as tile. It markets these materials through a network of 23 distribution centers and showrooms. The company serves new residential and commercial construction markets, as well as distributes its products to the repair and remodel market. The company was incorporated in 2015 and is headquartered in Atlanta, Georgia."
SIC,2019-12-31,NA,8505000,NA,6984000,139716000,164074000,19658000,19658000,-17220000,1521000,610373000,590715000,446299000,-11153000,NA,6984000,6984000,NA,income_statement,Residential Construction,"Select Interior Concepts, Inc.","Select Interior Concepts, Inc., together with its subsidiaries, installs and distributes interior building products for residential interior design services markets in the United States. The company operates through two segments, Residential Design Services and Architectural Surfaces Group. The Residential Design Services segment provides an integrated, outsourced solution for the design, consultation, sourcing, distribution, and installation needs of homebuyer customers. It works with homebuyers in the selection of an array of interior products and finishes, including flooring, cabinets, countertops, wall tile, and related interior items, primarily for newly constructed homes; and coordinates the ordering, fulfillment, and installation of interior products. The Architectural Surfaces Group segment imports and distributes natural and engineered stone slabs, such as marble, granite, porcelain, and quartz for kitchen and bathroom countertops; and ceramic and porcelain tiles for flooring, backsplash, and wall tile applications, as well as tile. It markets these materials through a network of 23 distribution centers and showrooms. The company serves new residential and commercial construction markets, as well as distributes its products to the repair and remodel market. The company was incorporated in 2015 and is headquartered in Atlanta, Georgia."
SIEB,2016-12-31,NA,-5578000,NA,-5578000,11032000,8484000,0,-2548000,NA,0,9812000,12360000,1328000,-3030000,NA,-5578000,-5578000,NA,income_statement,Capital Markets,Siebert Financial Corp.,"Siebert Financial Corp., through its subsidiaries, engages in the retail discount brokerage and investment advisory businesses. The company provides online and traditional brokerage, and related services to retail investors through a broker on the telephone, a wireless device, or through the Internet; various value added services, such as access to account information; independent retail execution services; and retail customer services. It also offers self-directed retirement accounts; and custodial services, as well as lends customers a portion of the market value of marginable securities held in the customer's account. In addition, the company provides data technology platform that offers services, such as email and messaging, market data systems and third party trading systems, business productivity tools, and customer relationship management systems. Further, it offers a Robo-Advisor that provides clients with an automated wealth management solution; and various insurance products, such as fixed annuities and property and casualty insurance. Siebert Financial Corp. maintains 18 retail discount brokerage offices. The company was founded in 1886 and is headquartered in New York, New York."
SIEB,2017-12-31,NA,2310000,NA,2157000,9244000,11669000,0,2310000,NA,153000,13110000,10800000,1441000,0,NA,2157000,2157000,NA,income_statement,Capital Markets,Siebert Financial Corp.,"Siebert Financial Corp., through its subsidiaries, engages in the retail discount brokerage and investment advisory businesses. The company provides online and traditional brokerage, and related services to retail investors through a broker on the telephone, a wireless device, or through the Internet; various value added services, such as access to account information; independent retail execution services; and retail customer services. It also offers self-directed retirement accounts; and custodial services, as well as lends customers a portion of the market value of marginable securities held in the customer's account. In addition, the company provides data technology platform that offers services, such as email and messaging, market data systems and third party trading systems, business productivity tools, and customer relationship management systems. Further, it offers a Robo-Advisor that provides clients with an automated wealth management solution; and various insurance products, such as fixed annuities and property and casualty insurance. Siebert Financial Corp. maintains 18 retail discount brokerage offices. The company was founded in 1886 and is headquartered in New York, New York."
SIEB,2018-12-31,NA,7360000,NA,11962000,18672000,26176000,0,7360000,NA,-4602000,30036000,22676000,3860000,0,NA,11962000,11962000,NA,income_statement,Capital Markets,Siebert Financial Corp.,"Siebert Financial Corp., through its subsidiaries, engages in the retail discount brokerage and investment advisory businesses. The company provides online and traditional brokerage, and related services to retail investors through a broker on the telephone, a wireless device, or through the Internet; various value added services, such as access to account information; independent retail execution services; and retail customer services. It also offers self-directed retirement accounts; and custodial services, as well as lends customers a portion of the market value of marginable securities held in the customer's account. In addition, the company provides data technology platform that offers services, such as email and messaging, market data systems and third party trading systems, business productivity tools, and customer relationship management systems. Further, it offers a Robo-Advisor that provides clients with an automated wealth management solution; and various insurance products, such as fixed annuities and property and casualty insurance. Siebert Financial Corp. maintains 18 retail discount brokerage offices. The company was founded in 1886 and is headquartered in New York, New York."
SIEB,2019-12-31,NA,4725000,NA,3607000,18801000,24575000,0,4791000,NA,1118000,28583000,23792000,4008000,-66000,NA,3607000,3607000,NA,income_statement,Capital Markets,Siebert Financial Corp.,"Siebert Financial Corp., through its subsidiaries, engages in the retail discount brokerage and investment advisory businesses. The company provides online and traditional brokerage, and related services to retail investors through a broker on the telephone, a wireless device, or through the Internet; various value added services, such as access to account information; independent retail execution services; and retail customer services. It also offers self-directed retirement accounts; and custodial services, as well as lends customers a portion of the market value of marginable securities held in the customer's account. In addition, the company provides data technology platform that offers services, such as email and messaging, market data systems and third party trading systems, business productivity tools, and customer relationship management systems. Further, it offers a Robo-Advisor that provides clients with an automated wealth management solution; and various insurance products, such as fixed annuities and property and casualty insurance. Siebert Financial Corp. maintains 18 retail discount brokerage offices. The company was founded in 1886 and is headquartered in New York, New York."
SIEN,2016-12-31,9704000,-40105000,NA,-40166000,42266000,13915000,-38055000,-38055000,-98000,61000,20734000,58789000,6819000,-2050000,NA,-40166000,-40166000,NA,income_statement,Medical Devices,"Sientra, Inc.","Sientra, Inc., a medical aesthetics company, develops and sells medical aesthetics products to plastic surgeons in the United States. It operates through two segments, Breast Products and miraDry. The company offers silicone gel breast implants for use in breast augmentation and breast reconstruction procedures; breast tissue expanders; and scar management products under the Sientra, AlloX2, OPUS, Dermaspan, Softspan, and BIOCORNEUM brand names. It also provides body contouring products; facial and nasal implants; saline filled breast implant sizers; and miraDry System, a non-surgical device for the permanent reduction of underarm sweat, odor, and hair of all colors. The company was formerly known as Juliet Medical, Inc. and changed its name to Sientra, Inc. in April 2007. Sientra, Inc. was incorporated in 2003 and is headquartered in Santa Barbara, California."
SIEN,2017-12-31,9813000,-64045000,NA,-64028000,61213000,22371000,-48655000,-48655000,-1232000,-17000,36542000,85197000,14171000,-15390000,NA,-64028000,-64028000,NA,income_statement,Medical Devices,"Sientra, Inc.","Sientra, Inc., a medical aesthetics company, develops and sells medical aesthetics products to plastic surgeons in the United States. It operates through two segments, Breast Products and miraDry. The company offers silicone gel breast implants for use in breast augmentation and breast reconstruction procedures; breast tissue expanders; and scar management products under the Sientra, AlloX2, OPUS, Dermaspan, Softspan, and BIOCORNEUM brand names. It also provides body contouring products; facial and nasal implants; saline filled breast implant sizers; and miraDry System, a non-surgical device for the permanent reduction of underarm sweat, odor, and hair of all colors. The company was formerly known as Juliet Medical, Inc. and changed its name to Sientra, Inc. in April 2007. Sientra, Inc. was incorporated in 2003 and is headquartered in Santa Barbara, California."
SIEN,2018-12-31,10945000,-82631000,NA,-82627000,107605000,41304000,-77246000,-77246000,-3428000,-4000,68126000,145372000,26822000,-5385000,NA,-82627000,-82627000,NA,income_statement,Medical Devices,"Sientra, Inc.","Sientra, Inc., a medical aesthetics company, develops and sells medical aesthetics products to plastic surgeons in the United States. It operates through two segments, Breast Products and miraDry. The company offers silicone gel breast implants for use in breast augmentation and breast reconstruction procedures; breast tissue expanders; and scar management products under the Sientra, AlloX2, OPUS, Dermaspan, Softspan, and BIOCORNEUM brand names. It also provides body contouring products; facial and nasal implants; saline filled breast implant sizers; and miraDry System, a non-surgical device for the permanent reduction of underarm sweat, odor, and hair of all colors. The company was formerly known as Juliet Medical, Inc. and changed its name to Sientra, Inc. in April 2007. Sientra, Inc. was incorporated in 2003 and is headquartered in Santa Barbara, California."
SIEN,2019-12-31,13537000,-106784000,NA,-106818000,123316000,50687000,-86166000,-86166000,-4568000,34000,83699000,169865000,33012000,-20618000,NA,-106818000,-106818000,NA,income_statement,Medical Devices,"Sientra, Inc.","Sientra, Inc., a medical aesthetics company, develops and sells medical aesthetics products to plastic surgeons in the United States. It operates through two segments, Breast Products and miraDry. The company offers silicone gel breast implants for use in breast augmentation and breast reconstruction procedures; breast tissue expanders; and scar management products under the Sientra, AlloX2, OPUS, Dermaspan, Softspan, and BIOCORNEUM brand names. It also provides body contouring products; facial and nasal implants; saline filled breast implant sizers; and miraDry System, a non-surgical device for the permanent reduction of underarm sweat, odor, and hair of all colors. The company was formerly known as Juliet Medical, Inc. and changed its name to Sientra, Inc. in April 2007. Sientra, Inc. was incorporated in 2003 and is headquartered in Santa Barbara, California."
SIFY,2017-03-31,NA,643097000,NA,642399000,3991273000,6561799000,956541000,956541000,-343411000,698000,18432020000,17475479000,11870221000,-313444000,NA,642399000,642399000,-144791000,income_statement,Telecom Services,Sify Technologies Limited - Ame,"Sify Technologies Limited provides integrated ICT solutions and services in India and internationally. The company operates in five segments: Telecom Services, Data Center Services, Cloud and Managed Services, Technology Integration Services, and Applications Integration Services. The Telecom Services segment offers internet protocol based virtual private network services, including intranets, extranets, and remote access applications; and last mile connectivity services. The Data Center Services segment provides co-location, regular backup, server load balancing, and remote backup solutions; shared hosting, network, and security services; storage and virtualization services; and managed voice services to resident enterprises. The Cloud and Managed Services segment offers on-demand hosting services; and remote and onsite infrastructure management services that manages and supports customer operating systems, applications, and database layers, as well as utility-based on-demand storage services. The Technology Integration Services segment provides data center build, network integration, information security, end user computing, and collaborative tools and solutions. The Applications Integration Services segment offers online assessment, web development, supply chain solutions, content management, sale of digital certificates; sale, implementation, and maintenance of industry specific application; and operates online portfolio, including sify.com and samachar.com, gateway to the Internet by offering communication and search tools. The company was formerly known as Sify Limited and changed its name to Sify Technologies Limited in October 2007. The company was founded in 1995 and is headquartered in Chennai, India."
SIFY,2018-03-31,NA,923595000,NA,923401000,4394814000,7250663000,1288497000,1288497000,-404448000,194000,20685613000,19397116000,13434950000,-364902000,NA,923401000,923401000,-187185000,income_statement,Telecom Services,Sify Technologies Limited - Ame,"Sify Technologies Limited provides integrated ICT solutions and services in India and internationally. The company operates in five segments: Telecom Services, Data Center Services, Cloud and Managed Services, Technology Integration Services, and Applications Integration Services. The Telecom Services segment offers internet protocol based virtual private network services, including intranets, extranets, and remote access applications; and last mile connectivity services. The Data Center Services segment provides co-location, regular backup, server load balancing, and remote backup solutions; shared hosting, network, and security services; storage and virtualization services; and managed voice services to resident enterprises. The Cloud and Managed Services segment offers on-demand hosting services; and remote and onsite infrastructure management services that manages and supports customer operating systems, applications, and database layers, as well as utility-based on-demand storage services. The Technology Integration Services segment provides data center build, network integration, information security, end user computing, and collaborative tools and solutions. The Applications Integration Services segment offers online assessment, web development, supply chain solutions, content management, sale of digital certificates; sale, implementation, and maintenance of industry specific application; and operates online portfolio, including sify.com and samachar.com, gateway to the Internet by offering communication and search tools. The company was formerly known as Sify Limited and changed its name to Sify Technologies Limited in October 2007. The company was founded in 1995 and is headquartered in Chennai, India."
SIFY,2019-03-31,NA,1071315000,NA,1068703000,4874620000,7944661000,1746127000,1746127000,-630587000,2612000,21546885000,19800758000,13602224000,-674812000,NA,1068703000,1068703000,-209998000,income_statement,Telecom Services,Sify Technologies Limited - Ame,"Sify Technologies Limited provides integrated ICT solutions and services in India and internationally. The company operates in five segments: Telecom Services, Data Center Services, Cloud and Managed Services, Technology Integration Services, and Applications Integration Services. The Telecom Services segment offers internet protocol based virtual private network services, including intranets, extranets, and remote access applications; and last mile connectivity services. The Data Center Services segment provides co-location, regular backup, server load balancing, and remote backup solutions; shared hosting, network, and security services; storage and virtualization services; and managed voice services to resident enterprises. The Cloud and Managed Services segment offers on-demand hosting services; and remote and onsite infrastructure management services that manages and supports customer operating systems, applications, and database layers, as well as utility-based on-demand storage services. The Technology Integration Services segment provides data center build, network integration, information security, end user computing, and collaborative tools and solutions. The Applications Integration Services segment offers online assessment, web development, supply chain solutions, content management, sale of digital certificates; sale, implementation, and maintenance of industry specific application; and operates online portfolio, including sify.com and samachar.com, gateway to the Internet by offering communication and search tools. The company was formerly known as Sify Limited and changed its name to Sify Technologies Limited in October 2007. The company was founded in 1995 and is headquartered in Chennai, India."
SIFY,2020-03-31,NA,1019716000,NA,705377000,4513646000,8587240000,1890130000,1890130000,-935842000,314339000,22952067000,21061937000,14364827000,-870414000,NA,705377000,705377000,-107313000,income_statement,Telecom Services,Sify Technologies Limited - Ame,"Sify Technologies Limited provides integrated ICT solutions and services in India and internationally. The company operates in five segments: Telecom Services, Data Center Services, Cloud and Managed Services, Technology Integration Services, and Applications Integration Services. The Telecom Services segment offers internet protocol based virtual private network services, including intranets, extranets, and remote access applications; and last mile connectivity services. The Data Center Services segment provides co-location, regular backup, server load balancing, and remote backup solutions; shared hosting, network, and security services; storage and virtualization services; and managed voice services to resident enterprises. The Cloud and Managed Services segment offers on-demand hosting services; and remote and onsite infrastructure management services that manages and supports customer operating systems, applications, and database layers, as well as utility-based on-demand storage services. The Technology Integration Services segment provides data center build, network integration, information security, end user computing, and collaborative tools and solutions. The Applications Integration Services segment offers online assessment, web development, supply chain solutions, content management, sale of digital certificates; sale, implementation, and maintenance of industry specific application; and operates online portfolio, including sify.com and samachar.com, gateway to the Internet by offering communication and search tools. The company was formerly known as Sify Limited and changed its name to Sify Technologies Limited in October 2007. The company was founded in 1995 and is headquartered in Chennai, India."
SIGA,2016-12-31,NA,-39684076,NA,-39697960,13713635,-5632421,-19346056,-19346056,-14064417,13884,14987628,34333684,20620049,-20338020,NA,-39697960,-39697960,NA,income_statement,Biotechnology,SIGA Technologies Inc.,"SIGA Technologies, Inc., a commercial-stage pharmaceutical company, focuses on the health security and infectious disease markets in the United States. Its lead product is TPOXX, an orally administered antiviral drug for the treatment of human smallpox disease caused by variola virus. The company was founded in 1995 and is headquartered in New York, New York."
SIGA,2017-12-31,NA,-38329274,NA,-36235484,12303050,-5320698,-17623748,-17623748,-14758140,-2093790,12268960,29892708,17589658,-20705526,NA,-36235484,-36235484,NA,income_statement,Biotechnology,SIGA Technologies Inc.,"SIGA Technologies, Inc., a commercial-stage pharmaceutical company, focuses on the health security and infectious disease markets in the United States. Its lead product is TPOXX, an orally administered antiviral drug for the treatment of human smallpox disease caused by variola virus. The company was founded in 1995 and is headquartered in New York, New York."
SIGA,2018-12-31,NA,411639556,NA,421807828,12879738,367979136,355099398,355099398,-15478203,-10168272,477053782,121954384,109074646,56540158,NA,421807828,421807828,NA,income_statement,Biotechnology,SIGA Technologies Inc.,"SIGA Technologies, Inc., a commercial-stage pharmaceutical company, focuses on the health security and infectious disease markets in the United States. Its lead product is TPOXX, an orally administered antiviral drug for the treatment of human smallpox disease caused by variola virus. The company was founded in 1995 and is headquartered in New York, New York."
SIGA,2019-12-31,NA,-10178423,NA,-7241147,13252136,10929993,-2322143,-2322143,-15769768,-2937276,26742085,29064228,15812092,-7856280,NA,-7241147,-7241147,NA,income_statement,Biotechnology,SIGA Technologies Inc.,"SIGA Technologies, Inc., a commercial-stage pharmaceutical company, focuses on the health security and infectious disease markets in the United States. Its lead product is TPOXX, an orally administered antiviral drug for the treatment of human smallpox disease caused by variola virus. The company was founded in 1995 and is headquartered in New York, New York."
SIGI,2017-12-31,NA,261968000,NA,168826000,36255000,655674000,286322000,286322000,-24354000,93142000,2469984000,2183662000,1814310000,-24354000,NA,168826000,168826000,333097000,income_statement,Insurance—Property & Casualty,"Selective Insurance Group, Inc.","Selective Insurance Group, Inc., together with its subsidiaries, provides insurance products and services in the United States. It operates through four segments: Standard Commercial Lines, Standard Personal Lines, E&S Lines, and Investments. The company offers property insurance products, which covers the financial consequences of accidental loss of an insured's real and/or personal property, or earnings; and casualty insurance products that covers the financial consequences of employee injuries in the course of employment, and bodily injury and/or property damage to a third party as a result of an insured's negligent acts, omissions, or legal liabilities, as well as flood insurance products. It also invests in fixed income investments and commercial mortgage loans, equity securities, and alternative investment portfolio. The company provides its insurance products and services to businesses, non-profit organizations, local government agencies, and individuals through independent retail agents and wholesale general agents. Selective Insurance Group, Inc. was founded in 1926 and is headquartered in Branchville, New Jersey."
SIGI,2018-12-31,NA,211721000,NA,178939000,25446000,592904000,236140000,236140000,-24419000,32782000,2586080000,2349940000,1993176000,-24419000,NA,178939000,178939000,331318000,income_statement,Insurance—Property & Casualty,"Selective Insurance Group, Inc.","Selective Insurance Group, Inc., together with its subsidiaries, provides insurance products and services in the United States. It operates through four segments: Standard Commercial Lines, Standard Personal Lines, E&S Lines, and Investments. The company offers property insurance products, which covers the financial consequences of accidental loss of an insured's real and/or personal property, or earnings; and casualty insurance products that covers the financial consequences of employee injuries in the course of employment, and bodily injury and/or property damage to a third party as a result of an insured's negligent acts, omissions, or legal liabilities, as well as flood insurance products. It also invests in fixed income investments and commercial mortgage loans, equity securities, and alternative investment portfolio. The company provides its insurance products and services to businesses, non-profit organizations, local government agencies, and individuals through independent retail agents and wholesale general agents. Selective Insurance Group, Inc. was founded in 1926 and is headquartered in Branchville, New Jersey."
SIGI,2019-12-31,NA,336390000,NA,271623000,41921000,758652000,369683000,369683000,-33668000,64767000,2846491000,2476808000,2087839000,-33193000,NA,271623000,271623000,347048000,income_statement,Insurance—Property & Casualty,"Selective Insurance Group, Inc.","Selective Insurance Group, Inc., together with its subsidiaries, provides insurance products and services in the United States. It operates through four segments: Standard Commercial Lines, Standard Personal Lines, E&S Lines, and Investments. The company offers property insurance products, which covers the financial consequences of accidental loss of an insured's real and/or personal property, or earnings; and casualty insurance products that covers the financial consequences of employee injuries in the course of employment, and bodily injury and/or property damage to a third party as a result of an insured's negligent acts, omissions, or legal liabilities, as well as flood insurance products. It also invests in fixed income investments and commercial mortgage loans, equity securities, and alternative investment portfolio. The company provides its insurance products and services to businesses, non-profit organizations, local government agencies, and individuals through independent retail agents and wholesale general agents. Selective Insurance Group, Inc. was founded in 1926 and is headquartered in Branchville, New Jersey."
SIGI,2020-12-31,NA,302988000,NA,246355000,37679000,726500000,334147000,334147000,-30839000,56633000,2922274000,2588127000,2195774000,-31159000,NA,246355000,246355000,354674000,income_statement,Insurance—Property & Casualty,"Selective Insurance Group, Inc.","Selective Insurance Group, Inc., together with its subsidiaries, provides insurance products and services in the United States. It operates through four segments: Standard Commercial Lines, Standard Personal Lines, E&S Lines, and Investments. The company offers property insurance products, which covers the financial consequences of accidental loss of an insured's real and/or personal property, or earnings; and casualty insurance products that covers the financial consequences of employee injuries in the course of employment, and bodily injury and/or property damage to a third party as a result of an insured's negligent acts, omissions, or legal liabilities, as well as flood insurance products. It also invests in fixed income investments and commercial mortgage loans, equity securities, and alternative investment portfolio. The company provides its insurance products and services to businesses, non-profit organizations, local government agencies, and individuals through independent retail agents and wholesale general agents. Selective Insurance Group, Inc. was founded in 1926 and is headquartered in Branchville, New Jersey."
SILC,2017-12-31,13915000,25582000,NA,21714000,11229000,45928000,20784000,20784000,NA,3868000,125690000,104906000,79762000,4798000,NA,21714000,21714000,NA,income_statement,Communication Equipment,Silicom Ltd,"Silicom Ltd., together with its subsidiaries, designs, manufactures, markets, and supports networking and data infrastructure solutions for a range of servers, server based systems, and communications devices in North America, Europe, and the Asia Pacific. The company offers server network interface cards; and smart Card products include smart server adapters, such as redirector and switching cards, encryption and data compression hardware acceleration cards, and field programmable gate array based packet processing cards. The company also offers virtualized and universal customer premise equipment edge networking devices for SD-WAN and NFV deployments; networking targeted appliances; and bypass switches and intelligent bypass switches. It serves original equipment manufacturing, cloud, telco, and service provider customers. The company was founded in 1987 and is headquartered in Kfar Sava, Israel."
SILC,2018-12-31,14820000,17574000,NA,14637000,10585000,45256000,19851000,19851000,NA,2937000,133753000,113902000,88497000,-2277000,NA,14637000,14637000,NA,income_statement,Communication Equipment,Silicom Ltd,"Silicom Ltd., together with its subsidiaries, designs, manufactures, markets, and supports networking and data infrastructure solutions for a range of servers, server based systems, and communications devices in North America, Europe, and the Asia Pacific. The company offers server network interface cards; and smart Card products include smart server adapters, such as redirector and switching cards, encryption and data compression hardware acceleration cards, and field programmable gate array based packet processing cards. The company also offers virtualized and universal customer premise equipment edge networking devices for SD-WAN and NFV deployments; networking targeted appliances; and bypass switches and intelligent bypass switches. It serves original equipment manufacturing, cloud, telco, and service provider customers. The company was founded in 1987 and is headquartered in Kfar Sava, Israel."
SILC,2019-12-31,15075000,11859000,NA,10236000,10806000,36094000,10213000,10213000,NA,1623000,105240000,95027000,69146000,1646000,NA,10236000,10236000,NA,income_statement,Communication Equipment,Silicom Ltd,"Silicom Ltd., together with its subsidiaries, designs, manufactures, markets, and supports networking and data infrastructure solutions for a range of servers, server based systems, and communications devices in North America, Europe, and the Asia Pacific. The company offers server network interface cards; and smart Card products include smart server adapters, such as redirector and switching cards, encryption and data compression hardware acceleration cards, and field programmable gate array based packet processing cards. The company also offers virtualized and universal customer premise equipment edge networking devices for SD-WAN and NFV deployments; networking targeted appliances; and bypass switches and intelligent bypass switches. It serves original equipment manufacturing, cloud, telco, and service provider customers. The company was founded in 1987 and is headquartered in Kfar Sava, Israel."
SILC,2020-12-31,17244000,7282000,NA,5725000,10274000,35423000,7905000,7905000,NA,1557000,107398000,99493000,71975000,-623000,NA,5725000,5725000,NA,income_statement,Communication Equipment,Silicom Ltd,"Silicom Ltd., together with its subsidiaries, designs, manufactures, markets, and supports networking and data infrastructure solutions for a range of servers, server based systems, and communications devices in North America, Europe, and the Asia Pacific. The company offers server network interface cards; and smart Card products include smart server adapters, such as redirector and switching cards, encryption and data compression hardware acceleration cards, and field programmable gate array based packet processing cards. The company also offers virtualized and universal customer premise equipment edge networking devices for SD-WAN and NFV deployments; networking targeted appliances; and bypass switches and intelligent bypass switches. It serves original equipment manufacturing, cloud, telco, and service provider customers. The company was founded in 1987 and is headquartered in Kfar Sava, Israel."
SILK,2017-12-31,7242000,-19356000,NA,-19356000,20261000,9129000,-18374000,-18374000,-3943000,0,14258000,32632000,5129000,-982000,NA,-19356000,-19356000,NA,income_statement,Medical Devices,"Silk Road Medical, Inc.","Silk Road Medical, Inc. operates as a medical device company in the United States. The company offers various products for the treatment of carotid artery disease called transcarotid artery revascularization. Its products includes ENROUTE Transcarotid Neuroprotection System that is used to directly access the common carotid artery and initiate temporary blood flow reversal; ENROUTE Transcarotid Stent System, a self-expanding, self-tapering stent with clinical data regarding lasting safety outcomes; ENHANCE Transcarotid Peripheral Access Kit for use in gaining initial access to the common carotid artery; and ENROUTE 0.014 Guidewire for navigating and crossing the target lesion for delivery of interventional devices. The company was founded in 2007 and is headquartered in Sunnyvale, California."
SILK,2018-12-31,10258000,-37616000,NA,-37629000,34820000,23683000,-21395000,-21395000,-4361000,14000,34557000,55952000,10874000,-16221000,NA,-37630000,-37629000,NA,income_statement,Medical Devices,"Silk Road Medical, Inc.","Silk Road Medical, Inc. operates as a medical device company in the United States. The company offers various products for the treatment of carotid artery disease called transcarotid artery revascularization. Its products includes ENROUTE Transcarotid Neuroprotection System that is used to directly access the common carotid artery and initiate temporary blood flow reversal; ENROUTE Transcarotid Stent System, a self-expanding, self-tapering stent with clinical data regarding lasting safety outcomes; ENHANCE Transcarotid Peripheral Access Kit for use in gaining initial access to the common carotid artery; and ENROUTE 0.014 Guidewire for navigating and crossing the target lesion for delivery of interventional devices. The company was founded in 2007 and is headquartered in Sunnyvale, California."
SILK,2019-12-31,12272000,-52407000,NA,-52415000,63220000,47427000,-28065000,-28065000,-4952000,8000,63354000,91419000,15927000,-24342000,NA,-52415000,-52415000,NA,income_statement,Medical Devices,"Silk Road Medical, Inc.","Silk Road Medical, Inc. operates as a medical device company in the United States. The company offers various products for the treatment of carotid artery disease called transcarotid artery revascularization. Its products includes ENROUTE Transcarotid Neuroprotection System that is used to directly access the common carotid artery and initiate temporary blood flow reversal; ENROUTE Transcarotid Stent System, a self-expanding, self-tapering stent with clinical data regarding lasting safety outcomes; ENHANCE Transcarotid Peripheral Access Kit for use in gaining initial access to the common carotid artery; and ENROUTE 0.014 Guidewire for navigating and crossing the target lesion for delivery of interventional devices. The company was founded in 2007 and is headquartered in Sunnyvale, California."
SIMO,2017-12-31,102053000,99001000,NA,74955000,42801000,251194000,103806000,103806000,-423000,24046000,523404000,419598000,272210000,-4805000,NA,74955000,74955000,NA,income_statement,Semiconductors,Silicon Motion Technology Corpo,"Silicon Motion Technology Corporation, together with its subsidiaries, designs, develops, and markets NAND flash controllers for solid-state storage devices. It offers solid-state drive (SSDs) used in PCs and other devices, as well as embedded multimediacard (eMMC) and UFS mobile embedded storage used in smartphones. The company also provides enterprise-grade SSDs used in data centers; and small form-factor specialized SSDs used in industrial, commercial, and automotive applications. It sells its controllers under the SMI brand; data center SSDs under the Shannon brand; and single-chip industrial-grade SSDs under the Ferri SSD and Ferri-eMMC brands. The company markets and sells its products through direct sales personnel and independent electronics distributors to flash makers, module makers, hyperscalers, and OEMs. It operates in Taiwan, the United States, Korea, China, Malaysia, Singapore, and internationally. Silicon Motion Technology Corporation was founded in 1995 and is based in Kowloon, Hong Kong."
SIMO,2018-12-31,102028000,109861000,NA,98070000,46912000,260807000,108903000,108903000,-378000,11791000,530348000,421445000,269541000,958000,NA,98070000,98070000,NA,income_statement,Semiconductors,Silicon Motion Technology Corpo,"Silicon Motion Technology Corporation, together with its subsidiaries, designs, develops, and markets NAND flash controllers for solid-state storage devices. It offers solid-state drive (SSDs) used in PCs and other devices, as well as embedded multimediacard (eMMC) and UFS mobile embedded storage used in smartphones. The company also provides enterprise-grade SSDs used in data centers; and small form-factor specialized SSDs used in industrial, commercial, and automotive applications. It sells its controllers under the SMI brand; data center SSDs under the Shannon brand; and single-chip industrial-grade SSDs under the Ferri SSD and Ferri-eMMC brands. The company markets and sells its products through direct sales personnel and independent electronics distributors to flash makers, module makers, hyperscalers, and OEMs. It operates in Taiwan, the United States, Korea, China, Malaysia, Singapore, and internationally. Silicon Motion Technology Corporation was founded in 1995 and is based in Kowloon, Hong Kong."
SIMO,2019-12-31,110305000,72074000,NA,64398000,42986000,222172000,68115000,68115000,-3000,7676000,457253000,389138000,235081000,3959000,NA,64398000,64398000,NA,income_statement,Semiconductors,Silicon Motion Technology Corpo,"Silicon Motion Technology Corporation, together with its subsidiaries, designs, develops, and markets NAND flash controllers for solid-state storage devices. It offers solid-state drive (SSDs) used in PCs and other devices, as well as embedded multimediacard (eMMC) and UFS mobile embedded storage used in smartphones. The company also provides enterprise-grade SSDs used in data centers; and small form-factor specialized SSDs used in industrial, commercial, and automotive applications. It sells its controllers under the SMI brand; data center SSDs under the Shannon brand; and single-chip industrial-grade SSDs under the Ferri SSD and Ferri-eMMC brands. The company markets and sells its products through direct sales personnel and independent electronics distributors to flash makers, module makers, hyperscalers, and OEMs. It operates in Taiwan, the United States, Korea, China, Malaysia, Singapore, and internationally. Silicon Motion Technology Corporation was founded in 1995 and is based in Kowloon, Hong Kong."
SIMO,2020-12-31,121784000,85558000,NA,79746000,40409000,264928000,102735000,102735000,NA,5812000,539521000,436786000,274593000,-17177000,NA,79746000,79746000,NA,income_statement,Semiconductors,Silicon Motion Technology Corpo,"Silicon Motion Technology Corporation, together with its subsidiaries, designs, develops, and markets NAND flash controllers for solid-state storage devices. It offers solid-state drive (SSDs) used in PCs and other devices, as well as embedded multimediacard (eMMC) and UFS mobile embedded storage used in smartphones. The company also provides enterprise-grade SSDs used in data centers; and small form-factor specialized SSDs used in industrial, commercial, and automotive applications. It sells its controllers under the SMI brand; data center SSDs under the Shannon brand; and single-chip industrial-grade SSDs under the Ferri SSD and Ferri-eMMC brands. The company markets and sells its products through direct sales personnel and independent electronics distributors to flash makers, module makers, hyperscalers, and OEMs. It operates in Taiwan, the United States, Korea, China, Malaysia, Singapore, and internationally. Silicon Motion Technology Corporation was founded in 1995 and is based in Kowloon, Hong Kong."
SINA,2016-12-31,216228000,304527000,411389000,225087000,346542000,676240000,113470000,113470000,-13118000,27219000,1030936000,917466000,354696000,191057000,NA,277308000,225087000,NA,income_statement,Internet Content & Information,Sina Corporation,"SINA Corporation, together with its subsidiaries, operates as an online media company in the People's Republic of China and internationally. The company operates SINA.com, an online media property that provides region-focused format and content, including feeds from news providers; business news coverage and personal finance columns; sporting events information; entertainment news and events; automobile-related news and service information; technology updates; interactive video products, such as news, sports, and entertainment; and education, digital, fashion, luxury, health, collectibles, travel, and other interest-based channels. It also offers SINA mobile, a mobile portal, which provides news information and entertainment content from SINA.com for mobile users in mobile browser and application format. In addition, it operates Weibo.com that offers discovery products to help users discover content; self-expression products to enable users to express themselves on Weibo platform; social products to promote social interaction between users on Weibo platform; advertising and marketing solutions; and tools and services. Further, the company offers online loan facilitation and payment, VIP membership, live streaming, and game-related services. SINA Corporation was founded in 1993 and is headquartered in Beijing, the People's Republic of China."
SINA,2017-12-31,267392000,424239000,752887000,156569000,513779000,1169747000,388576000,388576000,-4557000,74676000,1583884000,1195308000,414137000,35663000,NA,349563000,156569000,NA,income_statement,Internet Content & Information,Sina Corporation,"SINA Corporation, together with its subsidiaries, operates as an online media company in the People's Republic of China and internationally. The company operates SINA.com, an online media property that provides region-focused format and content, including feeds from news providers; business news coverage and personal finance columns; sporting events information; entertainment news and events; automobile-related news and service information; technology updates; interactive video products, such as news, sports, and entertainment; and education, digital, fashion, luxury, health, collectibles, travel, and other interest-based channels. It also offers SINA mobile, a mobile portal, which provides news information and entertainment content from SINA.com for mobile users in mobile browser and application format. In addition, it operates Weibo.com that offers discovery products to help users discover content; self-expression products to enable users to express themselves on Weibo platform; social products to promote social interaction between users on Weibo platform; advertising and marketing solutions; and tools and services. Further, the company offers online loan facilitation and payment, VIP membership, live streaming, and game-related services. SINA Corporation was founded in 1993 and is headquartered in Beijing, the People's Republic of China."
SINA,2018-12-31,345942000,555410000,1045081000,125562000,820146000,1656287000,490199000,490199000,-20749000,129084000,2108327000,1618128000,452040000,65211000,NA,426326000,125562000,NA,income_statement,Internet Content & Information,Sina Corporation,"SINA Corporation, together with its subsidiaries, operates as an online media company in the People's Republic of China and internationally. The company operates SINA.com, an online media property that provides region-focused format and content, including feeds from news providers; business news coverage and personal finance columns; sporting events information; entertainment news and events; automobile-related news and service information; technology updates; interactive video products, such as news, sports, and entertainment; and education, digital, fashion, luxury, health, collectibles, travel, and other interest-based channels. It also offers SINA mobile, a mobile portal, which provides news information and entertainment content from SINA.com for mobile users in mobile browser and application format. In addition, it operates Weibo.com that offers discovery products to help users discover content; self-expression products to enable users to express themselves on Weibo platform; social products to promote social interaction between users on Weibo platform; advertising and marketing solutions; and tools and services. Further, the company offers online loan facilitation and payment, VIP membership, live streaming, and game-related services. SINA Corporation was founded in 1993 and is headquartered in Beijing, the People's Republic of China."
SINA,2019-12-31,372818000,255192000,1259432000,-70542000,800630000,1669527000,496079000,496079000,-34595000,146465000,2162955000,1666876000,493428000,-240887000,NA,108727000,-70542000,NA,income_statement,Internet Content & Information,Sina Corporation,"SINA Corporation, together with its subsidiaries, operates as an online media company in the People's Republic of China and internationally. The company operates SINA.com, an online media property that provides region-focused format and content, including feeds from news providers; business news coverage and personal finance columns; sporting events information; entertainment news and events; automobile-related news and service information; technology updates; interactive video products, such as news, sports, and entertainment; and education, digital, fashion, luxury, health, collectibles, travel, and other interest-based channels. It also offers SINA mobile, a mobile portal, which provides news information and entertainment content from SINA.com for mobile users in mobile browser and application format. In addition, it operates Weibo.com that offers discovery products to help users discover content; self-expression products to enable users to express themselves on Weibo platform; social products to promote social interaction between users on Weibo platform; advertising and marketing solutions; and tools and services. Further, the company offers online loan facilitation and payment, VIP membership, live streaming, and game-related services. SINA Corporation was founded in 1993 and is headquartered in Beijing, the People's Republic of China."
SINO,2017-06-30,NA,3131460,-4768779,3624892,3363840,6465022,3101182,3101182,NA,-472084,11445613,8344431,4980591,30278,NA,3603544,3624892,NA,income_statement,Integrated Freight & Logistics,"Sino-Global Shipping America, L","Sino-Global Shipping America, Ltd. provides shipping and freight logistics integrated solutions in the United States, China, and Hong Kong. Its services include shipping agency services and management services, such as loading/discharging and protective agency services; inland transportation management, and container trucking services. The company was founded in 2001 and is headquartered in Roslyn, New York."
SINO,2018-06-30,NA,1472766,-4812828,459051,3270623,7478870,818149,818149,NA,949659,23064563,22246414,15585693,654617,NA,523107,459051,NA,income_statement,Integrated Freight & Logistics,"Sino-Global Shipping America, L","Sino-Global Shipping America, Ltd. provides shipping and freight logistics integrated solutions in the United States, China, and Hong Kong. Its services include shipping agency services and management services, such as loading/discharging and protective agency services; inland transportation management, and container trucking services. The company was founded in 2001 and is headquartered in Roslyn, New York."
SINO,2019-06-30,NA,-6091244,-5173622,-6533844,5063189,5764537,-5545378,-5545378,NA,920869,41771047,47316425,36006510,-545866,NA,-7012113,-6533844,NA,income_statement,Integrated Freight & Logistics,"Sino-Global Shipping America, L","Sino-Global Shipping America, Ltd. provides shipping and freight logistics integrated solutions in the United States, China, and Hong Kong. Its services include shipping agency services and management services, such as loading/discharging and protective agency services; inland transportation management, and container trucking services. The company was founded in 2001 and is headquartered in Roslyn, New York."
SINO,2020-06-30,NA,-17742626,-6542361,-16452894,3780307,2857093,-17410472,-17410472,NA,186021,6535956,23946428,3678863,-332154,NA,-17928647,-16452894,NA,income_statement,Integrated Freight & Logistics,"Sino-Global Shipping America, L","Sino-Global Shipping America, Ltd. provides shipping and freight logistics integrated solutions in the United States, China, and Hong Kong. Its services include shipping agency services and management services, such as loading/discharging and protective agency services; inland transportation management, and container trucking services. The company was founded in 2001 and is headquartered in Roslyn, New York."
SINT,2016-12-31,6345000,-14763000,NA,-14763000,15939000,11601000,-10683000,-10683000,-4511000,0,15226000,25909000,3625000,-4080000,-3568000,-14763000,-21041000,NA,income_statement,Medical Devices,"SiNtx Technologies, Inc.","Sintx Technologies, Inc., a biomaterial company, researches, develops, manufactures, and commercializes a range of medical implant products manufactured with silicon nitride in the United States, Europe, and South America. It offers ceramic based biomaterial solutions in various medical and industrial applications. The company provides spine implant products under the Valeo brand to surgeons and hospitals for use in cervical and thoracolumbar spine surgery. Sintx Technologies, Inc. markets and sells its products directly; and through direct sales organizations, distributors, as well as original equipment manufacturer and private label partnerships. The company was formerly known as Amedica Corporation and changed its name to Sintx Technologies, Inc. in October 2018. Sintx Technologies, Inc. was founded in 1996 and is headquartered in Salt Lake City, Utah."
SINT,2017-12-31,3506000,-5761000,NA,-9329000,3979000,9425000,-7485000,-7485000,-1263000,0,11227000,7485000,1802000,-2826000,-3568000,-5761000,-9329000,NA,income_statement,Medical Devices,"SiNtx Technologies, Inc.","Sintx Technologies, Inc., a biomaterial company, researches, develops, manufactures, and commercializes a range of medical implant products manufactured with silicon nitride in the United States, Europe, and South America. It offers ceramic based biomaterial solutions in various medical and industrial applications. The company provides spine implant products under the Valeo brand to surgeons and hospitals for use in cervical and thoracolumbar spine surgery. Sintx Technologies, Inc. markets and sells its products directly; and through direct sales organizations, distributors, as well as original equipment manufacturer and private label partnerships. The company was formerly known as Amedica Corporation and changed its name to Sintx Technologies, Inc. in October 2018. Sintx Technologies, Inc. was founded in 1996 and is headquartered in Salt Lake City, Utah."
SINT,2018-12-31,2991000,-9689000,NA,-8652000,4001000,39000,-6953000,-6953000,-1388000,0,95000,7048000,56000,-2736000,1037000,-9689000,-22552000,NA,income_statement,Medical Devices,"SiNtx Technologies, Inc.","Sintx Technologies, Inc., a biomaterial company, researches, develops, manufactures, and commercializes a range of medical implant products manufactured with silicon nitride in the United States, Europe, and South America. It offers ceramic based biomaterial solutions in various medical and industrial applications. The company provides spine implant products under the Valeo brand to surgeons and hospitals for use in cervical and thoracolumbar spine surgery. Sintx Technologies, Inc. markets and sells its products directly; and through direct sales organizations, distributors, as well as original equipment manufacturer and private label partnerships. The company was formerly known as Amedica Corporation and changed its name to Sintx Technologies, Inc. in October 2018. Sintx Technologies, Inc. was founded in 1996 and is headquartered in Salt Lake City, Utah."
SINT,2019-12-31,3394000,-4797000,NA,-4797000,3338000,138000,-6594000,-6594000,-4000,0,689000,7283000,551000,1797000,NA,-4797000,-7500000,NA,income_statement,Medical Devices,"SiNtx Technologies, Inc.","Sintx Technologies, Inc., a biomaterial company, researches, develops, manufactures, and commercializes a range of medical implant products manufactured with silicon nitride in the United States, Europe, and South America. It offers ceramic based biomaterial solutions in various medical and industrial applications. The company provides spine implant products under the Valeo brand to surgeons and hospitals for use in cervical and thoracolumbar spine surgery. Sintx Technologies, Inc. markets and sells its products directly; and through direct sales organizations, distributors, as well as original equipment manufacturer and private label partnerships. The company was formerly known as Amedica Corporation and changed its name to Sintx Technologies, Inc. in October 2018. Sintx Technologies, Inc. was founded in 1996 and is headquartered in Salt Lake City, Utah."
SIOX,2017-03-31,134778000,-182011000,NA,-180951000,45721000,0,-180499000,-180499000,-1143000,-1060000,0,180499000,0,-1512000,NA,-180951000,-180951000,NA,income_statement,Biotechnology,Sio Gene Therapies Inc.,"Sio Gene Therapies, Inc., a clinical-stage gene therapy company, focuses on developing various product candidates for debilitating neurodegenerative diseases. The company's clinical-stage programs include AXO-Lenti-PD program for the treatment of Parkinson's disease; AXO-AAV-GM1 program for the treatment of GM1 gangliosidosis; and AXO-AAV-GM2 program for the treatment of GM2 gangliosidosis. It has a license agreement with Oxford BioMedica (UK) Ltd. and The University of Massachusetts Medical School. The company was formerly known as Axovant Gene Therapies Ltd. and changed its name to Sio Gene Therapies, Inc. in November 2020. Sio Gene Therapies, Inc. was founded in 2014 and is based in New York, New York."
SIOX,2018-03-31,141412000,-220652000,NA,-221573000,71906000,0,-213318000,-213318000,-7545000,921000,0,213318000,0,-7334000,NA,-221573000,-221573000,NA,income_statement,Biotechnology,Sio Gene Therapies Inc.,"Sio Gene Therapies, Inc., a clinical-stage gene therapy company, focuses on developing various product candidates for debilitating neurodegenerative diseases. The company's clinical-stage programs include AXO-Lenti-PD program for the treatment of Parkinson's disease; AXO-AAV-GM1 program for the treatment of GM1 gangliosidosis; and AXO-AAV-GM2 program for the treatment of GM2 gangliosidosis. It has a license agreement with Oxford BioMedica (UK) Ltd. and The University of Massachusetts Medical School. The company was formerly known as Axovant Gene Therapies Ltd. and changed its name to Sio Gene Therapies, Inc. in November 2020. Sio Gene Therapies, Inc. was founded in 2014 and is based in New York, New York."
SIOX,2019-03-31,87552000,-128932000,NA,-129065000,39466000,0,-127018000,-127018000,-7530000,133000,0,127018000,0,-1914000,NA,-129065000,-129065000,NA,income_statement,Biotechnology,Sio Gene Therapies Inc.,"Sio Gene Therapies, Inc., a clinical-stage gene therapy company, focuses on developing various product candidates for debilitating neurodegenerative diseases. The company's clinical-stage programs include AXO-Lenti-PD program for the treatment of Parkinson's disease; AXO-AAV-GM1 program for the treatment of GM1 gangliosidosis; and AXO-AAV-GM2 program for the treatment of GM2 gangliosidosis. It has a license agreement with Oxford BioMedica (UK) Ltd. and The University of Massachusetts Medical School. The company was formerly known as Axovant Gene Therapies Ltd. and changed its name to Sio Gene Therapies, Inc. in November 2020. Sio Gene Therapies, Inc. was founded in 2014 and is based in New York, New York."
SIOX,2020-03-31,47110000,-72190000,NA,-72628000,22061000,0,-69171000,-69171000,-4377000,438000,0,69171000,0,-3019000,NA,-72628000,-72628000,NA,income_statement,Biotechnology,Sio Gene Therapies Inc.,"Sio Gene Therapies, Inc., a clinical-stage gene therapy company, focuses on developing various product candidates for debilitating neurodegenerative diseases. The company's clinical-stage programs include AXO-Lenti-PD program for the treatment of Parkinson's disease; AXO-AAV-GM1 program for the treatment of GM1 gangliosidosis; and AXO-AAV-GM2 program for the treatment of GM2 gangliosidosis. It has a license agreement with Oxford BioMedica (UK) Ltd. and The University of Massachusetts Medical School. The company was formerly known as Axovant Gene Therapies Ltd. and changed its name to Sio Gene Therapies, Inc. in November 2020. Sio Gene Therapies, Inc. was founded in 2014 and is based in New York, New York."
SIRI,2017-12-31,112000000,1264000000,NA,648000000,773000000,2870000000,1686000000,1686000000,-346000000,616000000,5425000000,3739000000,2555000000,-422000000,NA,648000000,648000000,NA,income_statement,Broadcasting,Sirius XM Holdings Inc.,"Sirius XM Holdings Inc. provides satellite radio services on a subscription fee basis in the United States. It broadcasts music, sports, entertainment, comedy, talk, news, traffic, and weather channels, including various music genres, such as rock, pop and hip-hop, country, dance, jazz, Latin, and classical; live play-by-play sports from various leagues and colleges; various talk and entertainment channels for a range of audiences; national, international, and financial news; and limited run channels. The company also provides streaming service that includes a range of music and non-music channels, and podcasts, as well as channels that are not available on its satellite radio service; and offers applications to allow consumers to access its streaming service on smartphones, tablets, computers, home devices, and other consumer electronic equipment. In addition, it distributes satellite radios through automakers and retailers, as well as its website. Further, the company provides location-based services through two-way wireless connectivity, including safety, security, convenience, remote vehicles diagnostic, maintenance and data, and stolen or parked vehicle locator services. Additionally, it offers satellite television services, which offer music channels on the DISH Network satellite television service as a programming package; Travel Link, a suite of data services that include graphical weather, fuel prices, sports schedule and scores, and movie listings; and real-time traffic and weather services. The company was incorporated in 2013 and is headquartered in New York, New York. Sirius XM Holdings Inc. is a subsidiary of Liberty Media Corporation."
SIRI,2018-12-31,123000000,1421000000,NA,1176000000,838000000,3061000000,1799000000,1799000000,-350000000,245000000,5771000000,3972000000,2710000000,-378000000,NA,1176000000,1176000000,NA,income_statement,Broadcasting,Sirius XM Holdings Inc.,"Sirius XM Holdings Inc. provides satellite radio services on a subscription fee basis in the United States. It broadcasts music, sports, entertainment, comedy, talk, news, traffic, and weather channels, including various music genres, such as rock, pop and hip-hop, country, dance, jazz, Latin, and classical; live play-by-play sports from various leagues and colleges; various talk and entertainment channels for a range of audiences; national, international, and financial news; and limited run channels. The company also provides streaming service that includes a range of music and non-music channels, and podcasts, as well as channels that are not available on its satellite radio service; and offers applications to allow consumers to access its streaming service on smartphones, tablets, computers, home devices, and other consumer electronic equipment. In addition, it distributes satellite radios through automakers and retailers, as well as its website. Further, the company provides location-based services through two-way wireless connectivity, including safety, security, convenience, remote vehicles diagnostic, maintenance and data, and stolen or parked vehicle locator services. Additionally, it offers satellite television services, which offer music channels on the DISH Network satellite television service as a programming package; Travel Link, a suite of data services that include graphical weather, fuel prices, sports schedule and scores, and movie listings; and real-time traffic and weather services. The company was incorporated in 2013 and is headquartered in New York, New York. Sirius XM Holdings Inc. is a subsidiary of Liberty Media Corporation."
SIRI,2019-12-31,280000000,1197000000,NA,914000000,1436000000,3940000000,1756000000,1756000000,-390000000,283000000,7794000000,6038000000,3854000000,-559000000,NA,914000000,914000000,NA,income_statement,Broadcasting,Sirius XM Holdings Inc.,"Sirius XM Holdings Inc. provides satellite radio services on a subscription fee basis in the United States. It broadcasts music, sports, entertainment, comedy, talk, news, traffic, and weather channels, including various music genres, such as rock, pop and hip-hop, country, dance, jazz, Latin, and classical; live play-by-play sports from various leagues and colleges; various talk and entertainment channels for a range of audiences; national, international, and financial news; and limited run channels. The company also provides streaming service that includes a range of music and non-music channels, and podcasts, as well as channels that are not available on its satellite radio service; and offers applications to allow consumers to access its streaming service on smartphones, tablets, computers, home devices, and other consumer electronic equipment. In addition, it distributes satellite radios through automakers and retailers, as well as its website. Further, the company provides location-based services through two-way wireless connectivity, including safety, security, convenience, remote vehicles diagnostic, maintenance and data, and stolen or parked vehicle locator services. Additionally, it offers satellite television services, which offer music channels on the DISH Network satellite television service as a programming package; Travel Link, a suite of data services that include graphical weather, fuel prices, sports schedule and scores, and movie listings; and real-time traffic and weather services. The company was incorporated in 2013 and is headquartered in New York, New York. Sirius XM Holdings Inc. is a subsidiary of Liberty Media Corporation."
SIRI,2020-12-31,263000000,430000000,NA,131000000,1468000000,4099000000,1862000000,1862000000,-394000000,299000000,8040000000,6178000000,3941000000,-1432000000,NA,131000000,131000000,NA,income_statement,Broadcasting,Sirius XM Holdings Inc.,"Sirius XM Holdings Inc. provides satellite radio services on a subscription fee basis in the United States. It broadcasts music, sports, entertainment, comedy, talk, news, traffic, and weather channels, including various music genres, such as rock, pop and hip-hop, country, dance, jazz, Latin, and classical; live play-by-play sports from various leagues and colleges; various talk and entertainment channels for a range of audiences; national, international, and financial news; and limited run channels. The company also provides streaming service that includes a range of music and non-music channels, and podcasts, as well as channels that are not available on its satellite radio service; and offers applications to allow consumers to access its streaming service on smartphones, tablets, computers, home devices, and other consumer electronic equipment. In addition, it distributes satellite radios through automakers and retailers, as well as its website. Further, the company provides location-based services through two-way wireless connectivity, including safety, security, convenience, remote vehicles diagnostic, maintenance and data, and stolen or parked vehicle locator services. Additionally, it offers satellite television services, which offer music channels on the DISH Network satellite television service as a programming package; Travel Link, a suite of data services that include graphical weather, fuel prices, sports schedule and scores, and movie listings; and real-time traffic and weather services. The company was incorporated in 2013 and is headquartered in New York, New York. Sirius XM Holdings Inc. is a subsidiary of Liberty Media Corporation."
SITM,2017-12-31,20988000,4691000,NA,4723000,21340000,47918000,5590000,5590000,-870000,-32000,101065000,95475000,53147000,-899000,NA,4723000,4723000,NA,income_statement,Semiconductors,SiTime Corporation,"SiTime Corporation provides silicon timing systems in Taiwan, Hong Kong, the United States, and internationally. It provides resonators and clock integrated circuits, and various types of oscillators. The company's solutions are used in various markets, including enterprise and telecommunications infrastructure, automotive, industrial, Internet of Things, mobile, and aerospace and defense. It offers its products through distributors and resellers. The company was incorporated in 2003 and is headquartered in Santa Clara, California. SiTime Corporation was formerly a subsidiary of MegaChips Corporation."
SITM,2018-12-31,22775000,-9368000,NA,-9342000,21220000,36205000,-7790000,-7790000,-1512000,-26000,85214000,93004000,49009000,-1578000,NA,-9342000,-9342000,NA,income_statement,Semiconductors,SiTime Corporation,"SiTime Corporation provides silicon timing systems in Taiwan, Hong Kong, the United States, and internationally. It provides resonators and clock integrated circuits, and various types of oscillators. The company's solutions are used in various markets, including enterprise and telecommunications infrastructure, automotive, industrial, Internet of Things, mobile, and aerospace and defense. It offers its products through distributors and resellers. The company was incorporated in 2003 and is headquartered in Santa Clara, California. SiTime Corporation was formerly a subsidiary of MegaChips Corporation."
SITM,2019-12-31,23795000,-6615000,NA,-6607000,20636000,39558000,-4873000,-4873000,-1714000,-8000,84074000,88947000,44516000,-1742000,NA,-6607000,-6607000,NA,income_statement,Semiconductors,SiTime Corporation,"SiTime Corporation provides silicon timing systems in Taiwan, Hong Kong, the United States, and internationally. It provides resonators and clock integrated circuits, and various types of oscillators. The company's solutions are used in various markets, including enterprise and telecommunications infrastructure, automotive, industrial, Internet of Things, mobile, and aerospace and defense. It offers its products through distributors and resellers. The company was incorporated in 2003 and is headquartered in Santa Clara, California. SiTime Corporation was formerly a subsidiary of MegaChips Corporation."
SITM,2020-12-31,30693000,-9371000,NA,-9372000,34893000,57932000,-7654000,-7654000,-726000,1000,116156000,123810000,58224000,-1717000,NA,-9372000,-9372000,NA,income_statement,Semiconductors,SiTime Corporation,"SiTime Corporation provides silicon timing systems in Taiwan, Hong Kong, the United States, and internationally. It provides resonators and clock integrated circuits, and various types of oscillators. The company's solutions are used in various markets, including enterprise and telecommunications infrastructure, automotive, industrial, Internet of Things, mobile, and aerospace and defense. It offers its products through distributors and resellers. The company was incorporated in 2003 and is headquartered in Santa Clara, California. SiTime Corporation was formerly a subsidiary of MegaChips Corporation."
SIVB,2017-12-31,NA,874641000,139620000,490506000,890465000,1882565000,0,906979000,NA,355463000,1882565000,975586000,0,-32338000,NA,519178000,490506000,85121000,income_statement,NA,NA,NA
SIVB,2018-12-31,NA,1362909000,148634000,973840000,1057866000,2551102000,0,1405985000,NA,351561000,2551102000,1145117000,0,-43076000,NA,1011348000,973840000,87251000,income_statement,NA,NA,NA
SIVB,2019-12-31,NA,1610402000,150773000,1136856000,1429255000,3220624000,0,1639186000,NA,425685000,3220624000,1581438000,0,-28784000,NA,1184717000,1136856000,152183000,income_statement,NA,NA,NA
SIVB,2020-12-31,NA,1741881000,213791000,1208368000,1817279000,3776922000,0,1769468000,NA,447587000,3776922000,2007454000,0,-27587000,NA,1294294000,1191217000,190175000,income_statement,NA,NA,NA
SIVBP,2017-12-31,NA,874641000,139620000,490506000,890465000,1882565000,0,906979000,NA,355463000,1882565000,975586000,0,-32338000,NA,519178000,490506000,85121000,income_statement,Banks—Regional,SVB Financial Group - Depositar,"SVB Financial Group, a diversified financial services company, provides various banking and financial products and services. The company operates through four segments: Global Commercial Bank, SVB Private Bank, SVB Capital, and SVB Leerink. The Global Commercial Bank segment offers deposit products, such as business and analysis checking, money market, multi-currency, in-country bank, and sweep accounts, as well as merchant, remote capture, lockbox, electronic deposit capture, and fraud control services; credit products and services comprising term loans, equipment loans, asset-based loans, revolving lines of credit, accounts-receivable-based lines of credit, capital call lines of credit, and credit cards; and payment and cash management products and services, including wire transfer and automated clearing house payment, bill pay, debit and credit cards, account analysis, and disbursement, as well as online and mobile banking services. This segment also provides foreign exchange services; export, import, and standby letter of credit; investment services and solutions; investment advisory services; vineyard development loans; and debt fund investment services. The SVB Private Bank segment offers private banking services, such as mortgages, home equity and capital call lines of credit, restricted stock purchase loans, and other secured and unsecured lending products, as well as cash and wealth management services. The SVB Capital segment provides venture capital investment services that manage funds on behalf of third party limited partner investors. The SVB Leerink segment engages in equity and convertible capital markets, mergers and acquisitions, equity research and sales, trading, and investment banking services. It operates through 30 offices in the United States; and offices in Canada, the United Kingdom, Israel, Germany, Denmark, India, Hong Kong, and China. SVB Financial Group was founded in 1983 and is headquartered in Santa Clara, California."
SIVBP,2018-12-31,NA,1362909000,148634000,973840000,1057866000,2551102000,0,1405985000,NA,351561000,2551102000,1145117000,0,-43076000,NA,1011348000,973840000,87251000,income_statement,Banks—Regional,SVB Financial Group - Depositar,"SVB Financial Group, a diversified financial services company, provides various banking and financial products and services. The company operates through four segments: Global Commercial Bank, SVB Private Bank, SVB Capital, and SVB Leerink. The Global Commercial Bank segment offers deposit products, such as business and analysis checking, money market, multi-currency, in-country bank, and sweep accounts, as well as merchant, remote capture, lockbox, electronic deposit capture, and fraud control services; credit products and services comprising term loans, equipment loans, asset-based loans, revolving lines of credit, accounts-receivable-based lines of credit, capital call lines of credit, and credit cards; and payment and cash management products and services, including wire transfer and automated clearing house payment, bill pay, debit and credit cards, account analysis, and disbursement, as well as online and mobile banking services. This segment also provides foreign exchange services; export, import, and standby letter of credit; investment services and solutions; investment advisory services; vineyard development loans; and debt fund investment services. The SVB Private Bank segment offers private banking services, such as mortgages, home equity and capital call lines of credit, restricted stock purchase loans, and other secured and unsecured lending products, as well as cash and wealth management services. The SVB Capital segment provides venture capital investment services that manage funds on behalf of third party limited partner investors. The SVB Leerink segment engages in equity and convertible capital markets, mergers and acquisitions, equity research and sales, trading, and investment banking services. It operates through 30 offices in the United States; and offices in Canada, the United Kingdom, Israel, Germany, Denmark, India, Hong Kong, and China. SVB Financial Group was founded in 1983 and is headquartered in Santa Clara, California."
SIVBP,2019-12-31,NA,1610402000,150773000,1136856000,1429255000,3220624000,0,1639186000,NA,425685000,3220624000,1581438000,0,-28784000,NA,1184717000,1136856000,152183000,income_statement,Banks—Regional,SVB Financial Group - Depositar,"SVB Financial Group, a diversified financial services company, provides various banking and financial products and services. The company operates through four segments: Global Commercial Bank, SVB Private Bank, SVB Capital, and SVB Leerink. The Global Commercial Bank segment offers deposit products, such as business and analysis checking, money market, multi-currency, in-country bank, and sweep accounts, as well as merchant, remote capture, lockbox, electronic deposit capture, and fraud control services; credit products and services comprising term loans, equipment loans, asset-based loans, revolving lines of credit, accounts-receivable-based lines of credit, capital call lines of credit, and credit cards; and payment and cash management products and services, including wire transfer and automated clearing house payment, bill pay, debit and credit cards, account analysis, and disbursement, as well as online and mobile banking services. This segment also provides foreign exchange services; export, import, and standby letter of credit; investment services and solutions; investment advisory services; vineyard development loans; and debt fund investment services. The SVB Private Bank segment offers private banking services, such as mortgages, home equity and capital call lines of credit, restricted stock purchase loans, and other secured and unsecured lending products, as well as cash and wealth management services. The SVB Capital segment provides venture capital investment services that manage funds on behalf of third party limited partner investors. The SVB Leerink segment engages in equity and convertible capital markets, mergers and acquisitions, equity research and sales, trading, and investment banking services. It operates through 30 offices in the United States; and offices in Canada, the United Kingdom, Israel, Germany, Denmark, India, Hong Kong, and China. SVB Financial Group was founded in 1983 and is headquartered in Santa Clara, California."
SIVBP,2020-12-31,NA,1741881000,213791000,1208368000,1817279000,3776922000,0,1769468000,NA,447587000,3776922000,2007454000,0,-27587000,NA,1294294000,1191217000,190175000,income_statement,Banks—Regional,SVB Financial Group - Depositar,"SVB Financial Group, a diversified financial services company, provides various banking and financial products and services. The company operates through four segments: Global Commercial Bank, SVB Private Bank, SVB Capital, and SVB Leerink. The Global Commercial Bank segment offers deposit products, such as business and analysis checking, money market, multi-currency, in-country bank, and sweep accounts, as well as merchant, remote capture, lockbox, electronic deposit capture, and fraud control services; credit products and services comprising term loans, equipment loans, asset-based loans, revolving lines of credit, accounts-receivable-based lines of credit, capital call lines of credit, and credit cards; and payment and cash management products and services, including wire transfer and automated clearing house payment, bill pay, debit and credit cards, account analysis, and disbursement, as well as online and mobile banking services. This segment also provides foreign exchange services; export, import, and standby letter of credit; investment services and solutions; investment advisory services; vineyard development loans; and debt fund investment services. The SVB Private Bank segment offers private banking services, such as mortgages, home equity and capital call lines of credit, restricted stock purchase loans, and other secured and unsecured lending products, as well as cash and wealth management services. The SVB Capital segment provides venture capital investment services that manage funds on behalf of third party limited partner investors. The SVB Leerink segment engages in equity and convertible capital markets, mergers and acquisitions, equity research and sales, trading, and investment banking services. It operates through 30 offices in the United States; and offices in Canada, the United Kingdom, Israel, Germany, Denmark, India, Hong Kong, and China. SVB Financial Group was founded in 1983 and is headquartered in Santa Clara, California."
SJ,2018-12-31,10957000,111367000,NA,106740000,21270000,148934000,109881000,109881000,NA,4627000,743018000,633137000,594084000,1486000,NA,106740000,106740000,NA,income_statement,Broadcasting,Scienjoy Holding Corporation,"Sixiang Wuxian (Beijing) Technology Co., Ltd. is based in Beijing, China. Scienjoy Holding Corporation operates as a subsidiary of Scienjoy International Limited."
SJ,2019-12-31,21523000,156541000,NA,149918000,15761000,193989000,155851000,155851000,NA,6623000,914626000,758775000,720637000,690000,NA,149918000,149918000,NA,income_statement,Broadcasting,Scienjoy Holding Corporation,"Sixiang Wuxian (Beijing) Technology Co., Ltd. is based in Beijing, China. Scienjoy Holding Corporation operates as a subsidiary of Scienjoy International Limited."
SJM,2017-04-30,NA,878400000,NA,592300000,1340000000,2841000000,1298000000,1298000000,-163100000,286100000,7392300000,6094300000,4551300000,-419600000,NA,592300000,592300000,-4300000,income_statement,NA,NA,NA
SJM,2018-04-30,NA,861000000,NA,1338600000,1362900000,2840000000,1270200000,1270200000,-174100000,-477600000,7357100000,6086900000,4517100000,-409200000,NA,1338600000,1338600000,100000,income_statement,NA,NA,NA
SJM,2019-04-30,NA,701600000,NA,514400000,1508600000,2915700000,1170100000,1170100000,-207900000,187200000,7838000000,6667900000,4922300000,-468500000,NA,514400000,514400000,-3300000,income_statement,NA,NA,NA
SJM,2020-04-30,NA,1026700000,NA,779500000,1474300000,3002000000,1292000000,1292000000,-189200000,247200000,7801000000,6509000000,4799000000,-265300000,NA,779500000,779500000,-600000,income_statement,NA,NA,NA
SKYW,2017-12-31,NA,288183000,NA,428907000,NA,931745000,388199000,388199000,-104925000,-140724000,3122592000,2734393000,2190847000,-100016000,NA,428907000,428907000,250778000,income_statement,Airlines,"SkyWest, Inc.","SkyWest, Inc., through its subsidiaries, operates a regional airline in the United States. The company operates through two segment, SkyWest Airlines and SkyWest Leasing. It also engages into leasing aircraft and spare engines to third parties. As of December 31, 2019, the company provided scheduled passenger and air freight services with approximately 2,300 total daily departures to various destinations in the United States, Canada, Mexico, and provides airport customer and ground handling services for other airlines throughout its system. SkyWest, Inc. was founded in 1972 and is headquartered in St. George, Utah."
SKYW,2018-12-31,NA,366314000,NA,280372000,NA,1081695000,474280000,474280000,-120409000,85942000,3221679000,2747399000,2139984000,-107966000,NA,280372000,280372000,272826000,income_statement,Airlines,"SkyWest, Inc.","SkyWest, Inc., through its subsidiaries, operates a regional airline in the United States. The company operates through two segment, SkyWest Airlines and SkyWest Leasing. It also engages into leasing aircraft and spare engines to third parties. As of December 31, 2019, the company provided scheduled passenger and air freight services with approximately 2,300 total daily departures to various destinations in the United States, Canada, Mexico, and provides airport customer and ground handling services for other airlines throughout its system. SkyWest, Inc. was founded in 1972 and is headquartered in St. George, Utah."
SKYW,2019-12-31,NA,446305000,NA,340099000,NA,1145954000,534127000,534127000,-127755000,106206000,2971963000,2437836000,1826009000,-87822000,NA,340099000,340099000,243729000,income_statement,Airlines,"SkyWest, Inc.","SkyWest, Inc., through its subsidiaries, operates a regional airline in the United States. The company operates through two segment, SkyWest Airlines and SkyWest Leasing. It also engages into leasing aircraft and spare engines to third parties. As of December 31, 2019, the company provided scheduled passenger and air freight services with approximately 2,300 total daily departures to various destinations in the United States, Canada, Mexico, and provides airport customer and ground handling services for other airlines throughout its system. SkyWest, Inc. was founded in 1972 and is headquartered in St. George, Utah."
SKYW,2020-12-31,NA,-7327000,NA,-8515000,NA,461067000,-236689000,-236689000,-123173000,1188000,2127106000,2363795000,1666039000,229362000,NA,-8515000,-8515000,222797000,income_statement,Airlines,"SkyWest, Inc.","SkyWest, Inc., through its subsidiaries, operates a regional airline in the United States. The company operates through two segment, SkyWest Airlines and SkyWest Leasing. It also engages into leasing aircraft and spare engines to third parties. As of December 31, 2019, the company provided scheduled passenger and air freight services with approximately 2,300 total daily departures to various destinations in the United States, Canada, Mexico, and provides airport customer and ground handling services for other airlines throughout its system. SkyWest, Inc. was founded in 1972 and is headquartered in St. George, Utah."
SLAB,2017-12-30,209491000,76903000,NA,47092000,159726000,454191000,84974000,84974000,-14128000,29811000,768867000,683893000,314676000,-8071000,NA,47092000,47092000,NA,income_statement,Semiconductors,"Silicon Laboratories, Inc.","Silicon Laboratories Inc., a fabless semiconductor company, provides mixed-signal integrated circuits (ICs) in the United States, China, and internationally. The company offers microcontrollers and wireless products, including 8-bit mixed-signal and ultra-low-power 32-bit microcontrollers (MCU); wireless MCU connectivity solutions; single and multi-protocol system-on-chip (SoC) devices and modules; wireless protocols, MCUs, and SoCs; in-house protocol stacks; Micrium, a real-time operating system that helps simplify software development for IoT developers.It also provides sensor products comprising optical, relative humidity/temperature, and hall effect magnetic sensors; timing devices; multi-channel isolators, isolated drivers, isolated power converters, and mixed-signal devices; broadcast products, which include single-chip hybrid TV tuners and digital video demodulators, as well as AM/FM, HD radio, and DAB/DAB+ receivers; and hybrid software defined radio tuners, data receivers, and digital radio coprocessors. In addition, the company offers ProSLIC, a subscriber line interface circuits for voice over IP; ISOmodem embedded modems; and Power over Ethernet power source equipment and powered device ICs. It primarily markets its products to Internet of Things, Internet infrastructure, industrial automation, consumer, and automotive markets through direct sales force, as well as through a network of independent sales representatives and distributors. Silicon Laboratories Inc. was founded in 1996 and is headquartered in Austin, Texas."
SLAB,2018-12-29,238347000,72161000,NA,83591000,197844000,521399000,85208000,85208000,-19694000,-11430000,868267000,783059000,346868000,-13047000,NA,83591000,83591000,NA,income_statement,Semiconductors,"Silicon Laboratories, Inc.","Silicon Laboratories Inc., a fabless semiconductor company, provides mixed-signal integrated circuits (ICs) in the United States, China, and internationally. The company offers microcontrollers and wireless products, including 8-bit mixed-signal and ultra-low-power 32-bit microcontrollers (MCU); wireless MCU connectivity solutions; single and multi-protocol system-on-chip (SoC) devices and modules; wireless protocols, MCUs, and SoCs; in-house protocol stacks; Micrium, a real-time operating system that helps simplify software development for IoT developers.It also provides sensor products comprising optical, relative humidity/temperature, and hall effect magnetic sensors; timing devices; multi-channel isolators, isolated drivers, isolated power converters, and mixed-signal devices; broadcast products, which include single-chip hybrid TV tuners and digital video demodulators, as well as AM/FM, HD radio, and DAB/DAB+ receivers; and hybrid software defined radio tuners, data receivers, and digital radio coprocessors. In addition, the company offers ProSLIC, a subscriber line interface circuits for voice over IP; ISOmodem embedded modems; and Power over Ethernet power source equipment and powered device ICs. It primarily markets its products to Internet of Things, Internet infrastructure, industrial automation, consumer, and automotive markets through direct sales force, as well as through a network of independent sales representatives and distributors. Silicon Laboratories Inc. was founded in 1996 and is headquartered in Austin, Texas."
SLAB,2019-12-28,257150000,49649000,NA,19265000,196437000,510284000,56697000,56697000,-20233000,30384000,837554000,780857000,327270000,-7048000,NA,19265000,19265000,NA,income_statement,Semiconductors,"Silicon Laboratories, Inc.","Silicon Laboratories Inc., a fabless semiconductor company, provides mixed-signal integrated circuits (ICs) in the United States, China, and internationally. The company offers microcontrollers and wireless products, including 8-bit mixed-signal and ultra-low-power 32-bit microcontrollers (MCU); wireless MCU connectivity solutions; single and multi-protocol system-on-chip (SoC) devices and modules; wireless protocols, MCUs, and SoCs; in-house protocol stacks; Micrium, a real-time operating system that helps simplify software development for IoT developers.It also provides sensor products comprising optical, relative humidity/temperature, and hall effect magnetic sensors; timing devices; multi-channel isolators, isolated drivers, isolated power converters, and mixed-signal devices; broadcast products, which include single-chip hybrid TV tuners and digital video demodulators, as well as AM/FM, HD radio, and DAB/DAB+ receivers; and hybrid software defined radio tuners, data receivers, and digital radio coprocessors. In addition, the company offers ProSLIC, a subscriber line interface circuits for voice over IP; ISOmodem embedded modems; and Power over Ethernet power source equipment and powered device ICs. It primarily markets its products to Internet of Things, Internet infrastructure, industrial automation, consumer, and automotive markets through direct sales force, as well as through a network of independent sales representatives and distributors. Silicon Laboratories Inc. was founded in 1996 and is headquartered in Austin, Texas."
SLAB,2021-01-02,287887000,15301000,NA,12531000,199839000,527526000,39800000,39800000,-34142000,2770000,886677000,846877000,359151000,-24499000,NA,12531000,12531000,NA,income_statement,Semiconductors,"Silicon Laboratories, Inc.","Silicon Laboratories Inc., a fabless semiconductor company, provides mixed-signal integrated circuits (ICs) in the United States, China, and internationally. The company offers microcontrollers and wireless products, including 8-bit mixed-signal and ultra-low-power 32-bit microcontrollers (MCU); wireless MCU connectivity solutions; single and multi-protocol system-on-chip (SoC) devices and modules; wireless protocols, MCUs, and SoCs; in-house protocol stacks; Micrium, a real-time operating system that helps simplify software development for IoT developers.It also provides sensor products comprising optical, relative humidity/temperature, and hall effect magnetic sensors; timing devices; multi-channel isolators, isolated drivers, isolated power converters, and mixed-signal devices; broadcast products, which include single-chip hybrid TV tuners and digital video demodulators, as well as AM/FM, HD radio, and DAB/DAB+ receivers; and hybrid software defined radio tuners, data receivers, and digital radio coprocessors. In addition, the company offers ProSLIC, a subscriber line interface circuits for voice over IP; ISOmodem embedded modems; and Power over Ethernet power source equipment and powered device ICs. It primarily markets its products to Internet of Things, Internet infrastructure, industrial automation, consumer, and automotive markets through direct sales force, as well as through a network of independent sales representatives and distributors. Silicon Laboratories Inc. was founded in 1996 and is headquartered in Austin, Texas."
SLB,2017-12-31,787000000,-1183000000,419000000,-1505000000,432000000,4142000000,2923000000,2923000000,-566000000,330000000,30440000000,27517000000,26298000000,-4106000000,NA,-1513000000,-1505000000,NA,income_statement,NA,NA,NA
SLB,2018-12-31,702000000,2624000000,424000000,2138000000,444000000,4337000000,3191000000,3191000000,-575000000,447000000,32815000000,29624000000,28478000000,-567000000,NA,2177000000,2138000000,NA,income_statement,NA,NA,NA
SLB,2019-12-31,717000000,-10418000000,416000000,-10137000000,511000000,4197000000,2969000000,2969000000,-609000000,-311000000,32917000000,29948000000,28720000000,-13387000000,NA,-10107000000,-10137000000,NA,income_statement,NA,NA,NA
SLB,2020-12-31,580000000,-11298000000,418000000,-10518000000,365000000,2601000000,1656000000,1656000000,-563000000,-812000000,23601000000,21945000000,21000000000,-12954000000,NA,-10486000000,-10518000000,NA,income_statement,NA,NA,NA
SLCT,2017-12-31,NA,8897000,NA,3185000,20182000,36216000,0,12391000,NA,5712000,36216000,23825000,0,-3494000,NA,3185000,3185000,3643000,income_statement,Banks—Regional,"Select Bancorp, Inc.","Select Bancorp, Inc. operates as the bank holding company for Select Bank & Trust Company that provides banking services to individuals and small to medium-sized businesses. The company accepts deposit products, such as non-interest-bearing demand deposits, money market deposit accounts, NOW accounts, savings accounts, and time deposits, as well as certificates of deposit. Its loan products include 1-to-4 family residential, commercial real estate, multi-family residential, construction, and commercial and industrial loans; loans to individuals; and home equity lines of credit and overdrafts. As of April 17, 2020, it had 19 offices in Burlington, Charlotte, Clinton, Cornelius, Dunn, Elizabeth City, Fayetteville, Goldsboro, Greenville, Holly Springs, Leland, Lillington, Lumberton, Morehead City, Raleigh, and Wilmington, North Carolina; Blacksburg and Rock Hill, South Carolina; and Virginia Beach, as well as loan production offices in Durham, Wilson, and Winston-Salem, North Carolina. The company was formerly known as New Century Bancorp, Inc. and changed its name to Select Bancorp, Inc. in July 2014. Select Bancorp, Inc. was founded in 2000 and is headquartered in Dunn, North Carolina."
SLCT,2018-12-31,NA,17692000,NA,13782000,26736000,52242000,0,21277000,NA,3910000,52242000,30965000,0,-3585000,NA,13782000,13782000,4229000,income_statement,Banks—Regional,"Select Bancorp, Inc.","Select Bancorp, Inc. operates as the bank holding company for Select Bank & Trust Company that provides banking services to individuals and small to medium-sized businesses. The company accepts deposit products, such as non-interest-bearing demand deposits, money market deposit accounts, NOW accounts, savings accounts, and time deposits, as well as certificates of deposit. Its loan products include 1-to-4 family residential, commercial real estate, multi-family residential, construction, and commercial and industrial loans; loans to individuals; and home equity lines of credit and overdrafts. As of April 17, 2020, it had 19 offices in Burlington, Charlotte, Clinton, Cornelius, Dunn, Elizabeth City, Fayetteville, Goldsboro, Greenville, Holly Springs, Leland, Lillington, Lumberton, Morehead City, Raleigh, and Wilmington, North Carolina; Blacksburg and Rock Hill, South Carolina; and Virginia Beach, as well as loan production offices in Durham, Wilson, and Winston-Salem, North Carolina. The company was formerly known as New Century Bancorp, Inc. and changed its name to Select Bancorp, Inc. in July 2014. Select Bancorp, Inc. was founded in 2000 and is headquartered in Dunn, North Carolina."
SLCT,2019-12-31,NA,16731000,NA,13035000,29351000,51871000,0,18286000,NA,3696000,51871000,33585000,0,-1555000,NA,13035000,13035000,4234000,income_statement,Banks—Regional,"Select Bancorp, Inc.","Select Bancorp, Inc. operates as the bank holding company for Select Bank & Trust Company that provides banking services to individuals and small to medium-sized businesses. The company accepts deposit products, such as non-interest-bearing demand deposits, money market deposit accounts, NOW accounts, savings accounts, and time deposits, as well as certificates of deposit. Its loan products include 1-to-4 family residential, commercial real estate, multi-family residential, construction, and commercial and industrial loans; loans to individuals; and home equity lines of credit and overdrafts. As of April 17, 2020, it had 19 offices in Burlington, Charlotte, Clinton, Cornelius, Dunn, Elizabeth City, Fayetteville, Goldsboro, Greenville, Holly Springs, Leland, Lillington, Lumberton, Morehead City, Raleigh, and Wilmington, North Carolina; Blacksburg and Rock Hill, South Carolina; and Virginia Beach, as well as loan production offices in Durham, Wilson, and Winston-Salem, North Carolina. The company was formerly known as New Century Bancorp, Inc. and changed its name to Select Bancorp, Inc. in July 2014. Select Bancorp, Inc. was founded in 2000 and is headquartered in Dunn, North Carolina."
SLCT,2020-12-31,NA,10378000,NA,8163000,32802000,52325000,0,15036000,NA,2215000,52325000,37289000,0,-4658000,NA,8163000,8163000,4487000,income_statement,Banks—Regional,"Select Bancorp, Inc.","Select Bancorp, Inc. operates as the bank holding company for Select Bank & Trust Company that provides banking services to individuals and small to medium-sized businesses. The company accepts deposit products, such as non-interest-bearing demand deposits, money market deposit accounts, NOW accounts, savings accounts, and time deposits, as well as certificates of deposit. Its loan products include 1-to-4 family residential, commercial real estate, multi-family residential, construction, and commercial and industrial loans; loans to individuals; and home equity lines of credit and overdrafts. As of April 17, 2020, it had 19 offices in Burlington, Charlotte, Clinton, Cornelius, Dunn, Elizabeth City, Fayetteville, Goldsboro, Greenville, Holly Springs, Leland, Lillington, Lumberton, Morehead City, Raleigh, and Wilmington, North Carolina; Blacksburg and Rock Hill, South Carolina; and Virginia Beach, as well as loan production offices in Durham, Wilson, and Winston-Salem, North Carolina. The company was formerly known as New Century Bancorp, Inc. and changed its name to Select Bancorp, Inc. in July 2014. Select Bancorp, Inc. was founded in 2000 and is headquartered in Dunn, North Carolina."
SLDB,2016-12-31,20116000,-23773000,46474000,-21539000,5460000,0,-25576000,-25576000,NA,0,0,25576000,0,1803000,NA,-23773000,-17230000,NA,income_statement,Drug Manufacturers—Specialty & Generic,Solid Biosciences Inc.,"Solid Biosciences Inc., a life science company, engages in developing therapies for duchenne muscular dystrophy (DMD) in the United States. The company's lead product candidate is SGT-001, a gene transfer candidate, which is in a Phase I/II clinical trial to derive functional dystrophin protein expression in patients' muscles. Its portfolio also comprises Anti-LTBP4, a complementary disease modifying program that identifies and develops a monoclonal antibody intended to reduce fibrosis and inflammation by targeting and stabilizing the LTBP4 protein. In addition, the company engages in developing biomarkers and sensors; and Solid Suit program that includes the development of wearable assistive devices that focus on providing functional and therapeutic benefits. Solid Biosciences Inc. has strategic collaboration with Ultragenyx to develop and commercialize new gene therapies for Duchenne Muscular Dystrophy. Solid Biosciences Inc. was founded in 2013 and is headquartered in Cambridge, Massachusetts."
SLDB,2017-12-31,39905000,-53178000,NA,-52118000,14952000,0,-54857000,-54857000,NA,0,0,54857000,0,1679000,NA,-53178000,-39317000,NA,income_statement,Drug Manufacturers—Specialty & Generic,Solid Biosciences Inc.,"Solid Biosciences Inc., a life science company, engages in developing therapies for duchenne muscular dystrophy (DMD) in the United States. The company's lead product candidate is SGT-001, a gene transfer candidate, which is in a Phase I/II clinical trial to derive functional dystrophin protein expression in patients' muscles. Its portfolio also comprises Anti-LTBP4, a complementary disease modifying program that identifies and develops a monoclonal antibody intended to reduce fibrosis and inflammation by targeting and stabilizing the LTBP4 protein. In addition, the company engages in developing biomarkers and sensors; and Solid Suit program that includes the development of wearable assistive devices that focus on providing functional and therapeutic benefits. Solid Biosciences Inc. has strategic collaboration with Ultragenyx to develop and commercialize new gene therapies for Duchenne Muscular Dystrophy. Solid Biosciences Inc. was founded in 2013 and is headquartered in Cambridge, Massachusetts."
SLDB,2018-12-31,57965000,-74798000,NA,-74798000,17722000,0,-75687000,-75687000,NA,0,0,75687000,0,889000,NA,-74798000,-74798000,NA,income_statement,Drug Manufacturers—Specialty & Generic,Solid Biosciences Inc.,"Solid Biosciences Inc., a life science company, engages in developing therapies for duchenne muscular dystrophy (DMD) in the United States. The company's lead product candidate is SGT-001, a gene transfer candidate, which is in a Phase I/II clinical trial to derive functional dystrophin protein expression in patients' muscles. Its portfolio also comprises Anti-LTBP4, a complementary disease modifying program that identifies and develops a monoclonal antibody intended to reduce fibrosis and inflammation by targeting and stabilizing the LTBP4 protein. In addition, the company engages in developing biomarkers and sensors; and Solid Suit program that includes the development of wearable assistive devices that focus on providing functional and therapeutic benefits. Solid Biosciences Inc. has strategic collaboration with Ultragenyx to develop and commercialize new gene therapies for Duchenne Muscular Dystrophy. Solid Biosciences Inc. was founded in 2013 and is headquartered in Cambridge, Massachusetts."
SLDB,2019-12-31,94737000,-117223000,NA,-117223000,24581000,0,-119318000,-119318000,NA,0,0,119318000,0,2095000,NA,-117223000,-117223000,NA,income_statement,Drug Manufacturers—Specialty & Generic,Solid Biosciences Inc.,"Solid Biosciences Inc., a life science company, engages in developing therapies for duchenne muscular dystrophy (DMD) in the United States. The company's lead product candidate is SGT-001, a gene transfer candidate, which is in a Phase I/II clinical trial to derive functional dystrophin protein expression in patients' muscles. Its portfolio also comprises Anti-LTBP4, a complementary disease modifying program that identifies and develops a monoclonal antibody intended to reduce fibrosis and inflammation by targeting and stabilizing the LTBP4 protein. In addition, the company engages in developing biomarkers and sensors; and Solid Suit program that includes the development of wearable assistive devices that focus on providing functional and therapeutic benefits. Solid Biosciences Inc. has strategic collaboration with Ultragenyx to develop and commercialize new gene therapies for Duchenne Muscular Dystrophy. Solid Biosciences Inc. was founded in 2013 and is headquartered in Cambridge, Massachusetts."
SLG,2017-12-31,NA,101069000,1128050000,112775000,100498000,962447000,458629000,458629000,-275127000,0,1533365000,1074736000,570918000,-357560000,NA,101069000,85953000,-3200000,income_statement,NA,NA,NA
SLG,2018-12-31,NA,270856000,734566000,258646000,92631000,782840000,413902000,413902000,-223034000,0,1231503000,817601000,448663000,-143046000,NA,270856000,231760000,-3200000,income_statement,NA,NA,NA
SLG,2019-12-31,NA,291487000,769030000,281345000,100875000,752549000,381816000,381816000,-206298000,0,1211177000,829361000,458628000,-90329000,NA,291487000,253745000,-2500000,income_statement,NA,NA,NA
SLG,2020-12-31,NA,414758000,586463000,379802000,91826000,638991000,233497000,233497000,-128473000,0,1027549000,794052000,388558000,181261000,NA,414758000,356105000,NA,income_statement,NA,NA,NA
SLGG,2016-12-31,142380,-12365402,NA,-12365402,11032476,-1190546,-12365402,-12365402,-4469000,0,269892,12635294,1460438,0,NA,-12365402,-12365402,NA,income_statement,Electronic Gaming & Multimedia,"Super League Gaming, Inc.","Super League Gaming, Inc. operates an amateur esports content network. The company engages in capturing, generating, aggregating, and distributing content in various esports through social media, live streaming, and video-on-demand, as well as continuous gameplay and leaderboards. It offers Framerate, an independent social video esports network with user-generated reels; and Minehut, a social and gameplay forum for the avid Minecraft community. The company was formerly known as Nth Games, Inc. and changed its name to Super League Gaming, Inc. in June 2015. Super League Gaming, Inc. was incorporated in 2014 and is based in Santa Monica, California."
SLGG,2017-12-31,61543,-14955408,NA,-14955408,13607142,-1286723,-14955408,-14955408,-4469000,0,201182,15156590,1487905,0,NA,-14955408,-14955408,NA,income_statement,Electronic Gaming & Multimedia,"Super League Gaming, Inc.","Super League Gaming, Inc. operates an amateur esports content network. The company engages in capturing, generating, aggregating, and distributing content in various esports through social media, live streaming, and video-on-demand, as well as continuous gameplay and leaderboards. It offers Framerate, an independent social video esports network with user-generated reels; and Minehut, a social and gameplay forum for the avid Minecraft community. The company was formerly known as Nth Games, Inc. and changed its name to Super League Gaming, Inc. in June 2015. Super League Gaming, Inc. was incorporated in 2014 and is based in Santa Monica, California."
SLGG,2018-12-31,4183000,-20627000,NA,-20627000,12339000,362000,-16160000,-16160000,-4469000,0,1046000,17206000,684000,-4467000,NA,-20627000,-20627000,NA,income_statement,Electronic Gaming & Multimedia,"Super League Gaming, Inc.","Super League Gaming, Inc. operates an amateur esports content network. The company engages in capturing, generating, aggregating, and distributing content in various esports through social media, live streaming, and video-on-demand, as well as continuous gameplay and leaderboards. It offers Framerate, an independent social video esports network with user-generated reels; and Minehut, a social and gameplay forum for the avid Minecraft community. The company was formerly known as Nth Games, Inc. and changed its name to Super League Gaming, Inc. in June 2015. Super League Gaming, Inc. was incorporated in 2014 and is based in Santa Monica, California."
SLGG,2019-12-31,4520000,-30679000,NA,-30679000,16763000,571000,-20712000,-20712000,-9938000,0,1084000,21796000,513000,-9967000,NA,-30679000,-30679000,NA,income_statement,Electronic Gaming & Multimedia,"Super League Gaming, Inc.","Super League Gaming, Inc. operates an amateur esports content network. The company engages in capturing, generating, aggregating, and distributing content in various esports through social media, live streaming, and video-on-demand, as well as continuous gameplay and leaderboards. It offers Framerate, an independent social video esports network with user-generated reels; and Minehut, a social and gameplay forum for the avid Minecraft community. The company was formerly known as Nth Games, Inc. and changed its name to Super League Gaming, Inc. in June 2015. Super League Gaming, Inc. was incorporated in 2014 and is based in Santa Monica, California."
SLGL,2016-12-31,17023000,-20771000,NA,-20771000,3733000,0,-20756000,-20756000,-15000,0,0,20756000,0,-15000,NA,-20771000,-20771000,NA,income_statement,Biotechnology,Sol-Gel Technologies Ltd.,"Sol-Gel Technologies Ltd., a clinical stage specialty pharmaceutical company, focuses on developing and commercializing topical dermatological drug products based on its proprietary microencapsulation delivery system in Israel. The company's lead product candidates include Twyneo, which has completed Phase II clinical trials for the treatment of acne vulgaris; Epsolay that has completed Phase II clinical trials for the treatment of papulopustular rosacea; SGT-210, a epidermal growth factor receptor inhibitor, which is in development for the treatment of palmoplantar keratoderma and non-melanoma skin cancer; and tapinarof and roflumilast to treat psoriasis and other dermatological indications. It is also involved in the development of generic topical dermatological drug products. Sol-Gel Technologies Ltd. has collaboration with Perrigo; and Douglas Pharmaceuticals for the development and commercialization of a generic product candidate. The company was founded in 1997 and is headquartered in Ness Ziona, Israel."
SLGL,2017-12-31,NA,-31568000,NA,-31568000,6002000,-25631000,-31633000,-31633000,NA,0,174000,31807000,25805000,65000,NA,-31568000,-31568000,NA,income_statement,Biotechnology,Sol-Gel Technologies Ltd.,"Sol-Gel Technologies Ltd., a clinical stage specialty pharmaceutical company, focuses on developing and commercializing topical dermatological drug products based on its proprietary microencapsulation delivery system in Israel. The company's lead product candidates include Twyneo, which has completed Phase II clinical trials for the treatment of acne vulgaris; Epsolay that has completed Phase II clinical trials for the treatment of papulopustular rosacea; SGT-210, a epidermal growth factor receptor inhibitor, which is in development for the treatment of palmoplantar keratoderma and non-melanoma skin cancer; and tapinarof and roflumilast to treat psoriasis and other dermatological indications. It is also involved in the development of generic topical dermatological drug products. Sol-Gel Technologies Ltd. has collaboration with Perrigo; and Douglas Pharmaceuticals for the development and commercialization of a generic product candidate. The company was founded in 1997 and is headquartered in Ness Ziona, Israel."
SLGL,2018-12-31,NA,-32203000,NA,-32203000,5504000,-28017000,-33521000,-33521000,NA,0,129000,33650000,28146000,1318000,NA,-32203000,-32203000,NA,income_statement,Biotechnology,Sol-Gel Technologies Ltd.,"Sol-Gel Technologies Ltd., a clinical stage specialty pharmaceutical company, focuses on developing and commercializing topical dermatological drug products based on its proprietary microencapsulation delivery system in Israel. The company's lead product candidates include Twyneo, which has completed Phase II clinical trials for the treatment of acne vulgaris; Epsolay that has completed Phase II clinical trials for the treatment of papulopustular rosacea; SGT-210, a epidermal growth factor receptor inhibitor, which is in development for the treatment of palmoplantar keratoderma and non-melanoma skin cancer; and tapinarof and roflumilast to treat psoriasis and other dermatological indications. It is also involved in the development of generic topical dermatological drug products. Sol-Gel Technologies Ltd. has collaboration with Perrigo; and Douglas Pharmaceuticals for the development and commercialization of a generic product candidate. The company was founded in 1997 and is headquartered in Ness Ziona, Israel."
SLGL,2019-12-31,NA,-24576000,NA,-24609000,8276000,-17674000,-25950000,-25950000,NA,33000,22904000,48854000,40578000,1374000,NA,-24609000,-24609000,NA,income_statement,Biotechnology,Sol-Gel Technologies Ltd.,"Sol-Gel Technologies Ltd., a clinical stage specialty pharmaceutical company, focuses on developing and commercializing topical dermatological drug products based on its proprietary microencapsulation delivery system in Israel. The company's lead product candidates include Twyneo, which has completed Phase II clinical trials for the treatment of acne vulgaris; Epsolay that has completed Phase II clinical trials for the treatment of papulopustular rosacea; SGT-210, a epidermal growth factor receptor inhibitor, which is in development for the treatment of palmoplantar keratoderma and non-melanoma skin cancer; and tapinarof and roflumilast to treat psoriasis and other dermatological indications. It is also involved in the development of generic topical dermatological drug products. Sol-Gel Technologies Ltd. has collaboration with Perrigo; and Douglas Pharmaceuticals for the development and commercialization of a generic product candidate. The company was founded in 1997 and is headquartered in Ness Ziona, Israel."
SLGN,2017-12-31,NA,239681000,NA,269659000,244032000,634548000,390516000,390516000,-110257000,-29978000,4089854000,3699338000,3455306000,-150835000,NA,269659000,269659000,NA,income_statement,Packaging & Containers,Silgan Holdings Inc.,"Silgan Holdings Inc., together with its subsidiaries, manufactures and sells rigid packaging for consumer goods products in North America, Europe, and internationally. It operates through three segments: Metal Containers, Closures, and Plastic Containers. The Metal Containers segment manufactures and sells steel and aluminum containers for food products, such as pet food, vegetables, soups, proteins, tomato based products, adult nutritional drinks, fruits, and other miscellaneous food products, as well as general line metal containers primarily for chemicals. The Closures segment offers a range of metal and plastic closures, and dispensing systems for use in food, beverage, health care, garden, personal care, home, and beauty products, as well as capping/sealing equipment and detection systems. The Plastic Containers segment manufactures and sells custom designed and stock plastic containers for use in personal care and health care; food and beverage; household and industrial chemical; pharmaceutical; pet food and care; agricultural; automotive; and marine chemical products. This segment also provides plastic thermoformed barrier and non-barrier bowls, and trays for food products, such as soups, other ready-to-eat meals, and pet food products, as well as thermoformed plastic tubs for food, household, and personal care products, including soft fabric wipes. The company markets its products primarily through direct sales force, as well as through a network of distributors and an online shopping catalog. Silgan Holdings Inc. was founded in 1987 and is headquartered in Stamford, Connecticut."
SLGN,2018-12-31,NA,293301000,NA,223994000,271410000,689763000,418353000,418353000,-116306000,69307000,4448875000,4030522000,3759112000,-125052000,NA,223994000,223994000,NA,income_statement,Packaging & Containers,Silgan Holdings Inc.,"Silgan Holdings Inc., together with its subsidiaries, manufactures and sells rigid packaging for consumer goods products in North America, Europe, and internationally. It operates through three segments: Metal Containers, Closures, and Plastic Containers. The Metal Containers segment manufactures and sells steel and aluminum containers for food products, such as pet food, vegetables, soups, proteins, tomato based products, adult nutritional drinks, fruits, and other miscellaneous food products, as well as general line metal containers primarily for chemicals. The Closures segment offers a range of metal and plastic closures, and dispensing systems for use in food, beverage, health care, garden, personal care, home, and beauty products, as well as capping/sealing equipment and detection systems. The Plastic Containers segment manufactures and sells custom designed and stock plastic containers for use in personal care and health care; food and beverage; household and industrial chemical; pharmaceutical; pet food and care; agricultural; automotive; and marine chemical products. This segment also provides plastic thermoformed barrier and non-barrier bowls, and trays for food products, such as soups, other ready-to-eat meals, and pet food products, as well as thermoformed plastic tubs for food, household, and personal care products, including soft fabric wipes. The company markets its products primarily through direct sales force, as well as through a network of distributors and an online shopping catalog. Silgan Holdings Inc. was founded in 1987 and is headquartered in Stamford, Connecticut."
SLGN,2019-12-31,NA,252136000,NA,193814000,296107000,713744000,417637000,417637000,-105674000,58322000,4489927000,4072290000,3776183000,-165501000,NA,193814000,193814000,NA,income_statement,Packaging & Containers,Silgan Holdings Inc.,"Silgan Holdings Inc., together with its subsidiaries, manufactures and sells rigid packaging for consumer goods products in North America, Europe, and internationally. It operates through three segments: Metal Containers, Closures, and Plastic Containers. The Metal Containers segment manufactures and sells steel and aluminum containers for food products, such as pet food, vegetables, soups, proteins, tomato based products, adult nutritional drinks, fruits, and other miscellaneous food products, as well as general line metal containers primarily for chemicals. The Closures segment offers a range of metal and plastic closures, and dispensing systems for use in food, beverage, health care, garden, personal care, home, and beauty products, as well as capping/sealing equipment and detection systems. The Plastic Containers segment manufactures and sells custom designed and stock plastic containers for use in personal care and health care; food and beverage; household and industrial chemical; pharmaceutical; pet food and care; agricultural; automotive; and marine chemical products. This segment also provides plastic thermoformed barrier and non-barrier bowls, and trays for food products, such as soups, other ready-to-eat meals, and pet food products, as well as thermoformed plastic tubs for food, household, and personal care products, including soft fabric wipes. The company markets its products primarily through direct sales force, as well as through a network of distributors and an online shopping catalog. Silgan Holdings Inc. was founded in 1987 and is headquartered in Stamford, Connecticut."
SLGN,2020-12-31,NA,407100000,NA,308700000,339000000,867400000,528400000,528400000,-103800000,98400000,4921900000,4393500000,4054500000,-121300000,NA,308700000,308700000,NA,income_statement,Packaging & Containers,Silgan Holdings Inc.,"Silgan Holdings Inc., together with its subsidiaries, manufactures and sells rigid packaging for consumer goods products in North America, Europe, and internationally. It operates through three segments: Metal Containers, Closures, and Plastic Containers. The Metal Containers segment manufactures and sells steel and aluminum containers for food products, such as pet food, vegetables, soups, proteins, tomato based products, adult nutritional drinks, fruits, and other miscellaneous food products, as well as general line metal containers primarily for chemicals. The Closures segment offers a range of metal and plastic closures, and dispensing systems for use in food, beverage, health care, garden, personal care, home, and beauty products, as well as capping/sealing equipment and detection systems. The Plastic Containers segment manufactures and sells custom designed and stock plastic containers for use in personal care and health care; food and beverage; household and industrial chemical; pharmaceutical; pet food and care; agricultural; automotive; and marine chemical products. This segment also provides plastic thermoformed barrier and non-barrier bowls, and trays for food products, such as soups, other ready-to-eat meals, and pet food products, as well as thermoformed plastic tubs for food, household, and personal care products, including soft fabric wipes. The company markets its products primarily through direct sales force, as well as through a network of distributors and an online shopping catalog. Silgan Holdings Inc. was founded in 1987 and is headquartered in Stamford, Connecticut."
SLM,2017-12-31,NA,491465000,NA,288934000,242269000,940554000,0,491465000,NA,202531000,940554000,449089000,0,0,NA,288934000,273220000,206820000,income_statement,Credit Services,SLM Corporation,"SLM Corporation, through its subsidiaries, originates and services private education loans to students and their families to finance the cost of their education in the United States. It also offers retail deposit accounts, including certificates of deposit, money market deposit accounts, and high-yield savings accounts; omnibus accounts; and a consumer savings network that provides financial rewards on everyday purchases to help families save for college. It has a strategic partnership with EVERFI, Inc. to deliver a specialized financial literacy curriculum to California high schools. The company was formerly known as New BLC Corporation and changed its name to SLM Corporation in December 2013. SLM Corporation was founded in 1972 and is headquartered in Newark, Delaware."
SLM,2018-12-31,NA,559329000,NA,487476000,285132000,1116305000,0,559329000,NA,71853000,1116305000,556976000,0,0,NA,487476000,471836000,271844000,income_statement,Credit Services,SLM Corporation,"SLM Corporation, through its subsidiaries, originates and services private education loans to students and their families to finance the cost of their education in the United States. It also offers retail deposit accounts, including certificates of deposit, money market deposit accounts, and high-yield savings accounts; omnibus accounts; and a consumer savings network that provides financial rewards on everyday purchases to help families save for college. It has a strategic partnership with EVERFI, Inc. to deliver a specialized financial literacy curriculum to California high schools. The company was formerly known as New BLC Corporation and changed its name to SLM Corporation in December 2013. SLM Corporation was founded in 1972 and is headquartered in Newark, Delaware."
SLM,2019-12-31,NA,743740000,NA,578276000,311081000,1317993000,0,743740000,NA,165464000,1317993000,574253000,0,0,NA,578276000,561439000,263172000,income_statement,Credit Services,SLM Corporation,"SLM Corporation, through its subsidiaries, originates and services private education loans to students and their families to finance the cost of their education in the United States. It also offers retail deposit accounts, including certificates of deposit, money market deposit accounts, and high-yield savings accounts; omnibus accounts; and a consumer savings network that provides financial rewards on everyday purchases to help families save for college. It has a strategic partnership with EVERFI, Inc. to deliver a specialized financial literacy curriculum to California high schools. The company was formerly known as New BLC Corporation and changed its name to SLM Corporation in December 2013. SLM Corporation was founded in 1972 and is headquartered in Newark, Delaware."
SLM,2020-12-31,NA,1154006000,NA,880690000,304453000,1718309000,0,1180221000,NA,273316000,1718309000,538088000,0,-26215000,NA,880690000,870956000,233635000,income_statement,Credit Services,SLM Corporation,"SLM Corporation, through its subsidiaries, originates and services private education loans to students and their families to finance the cost of their education in the United States. It also offers retail deposit accounts, including certificates of deposit, money market deposit accounts, and high-yield savings accounts; omnibus accounts; and a consumer savings network that provides financial rewards on everyday purchases to help families save for college. It has a strategic partnership with EVERFI, Inc. to deliver a specialized financial literacy curriculum to California high schools. The company was formerly known as New BLC Corporation and changed its name to SLM Corporation in December 2013. SLM Corporation was founded in 1972 and is headquartered in Newark, Delaware."
SLMBP,2017-12-31,NA,491465000,NA,288934000,242269000,940554000,0,491465000,NA,202531000,940554000,449089000,0,0,NA,288934000,273220000,206820000,income_statement,Credit Services,SLM Corporation - Floating Rate,"SLM Corporation, through its subsidiaries, originates and services private education loans to students and their families to finance the cost of their education in the United States. It also offers retail deposit accounts, including certificates of deposit, money market deposit accounts, and high-yield savings accounts; omnibus accounts; and a consumer savings network that provides financial rewards on everyday purchases to help families save for college. It has a strategic partnership with EVERFI, Inc. to deliver a specialized financial literacy curriculum to California high schools. The company was formerly known as New BLC Corporation and changed its name to SLM Corporation in December 2013. SLM Corporation was founded in 1972 and is headquartered in Newark, Delaware."
SLMBP,2018-12-31,NA,559329000,NA,487476000,285132000,1116305000,0,559329000,NA,71853000,1116305000,556976000,0,0,NA,487476000,471836000,271844000,income_statement,Credit Services,SLM Corporation - Floating Rate,"SLM Corporation, through its subsidiaries, originates and services private education loans to students and their families to finance the cost of their education in the United States. It also offers retail deposit accounts, including certificates of deposit, money market deposit accounts, and high-yield savings accounts; omnibus accounts; and a consumer savings network that provides financial rewards on everyday purchases to help families save for college. It has a strategic partnership with EVERFI, Inc. to deliver a specialized financial literacy curriculum to California high schools. The company was formerly known as New BLC Corporation and changed its name to SLM Corporation in December 2013. SLM Corporation was founded in 1972 and is headquartered in Newark, Delaware."
SLMBP,2019-12-31,NA,743740000,NA,578276000,311081000,1317993000,0,743740000,NA,165464000,1317993000,574253000,0,0,NA,578276000,561439000,263172000,income_statement,Credit Services,SLM Corporation - Floating Rate,"SLM Corporation, through its subsidiaries, originates and services private education loans to students and their families to finance the cost of their education in the United States. It also offers retail deposit accounts, including certificates of deposit, money market deposit accounts, and high-yield savings accounts; omnibus accounts; and a consumer savings network that provides financial rewards on everyday purchases to help families save for college. It has a strategic partnership with EVERFI, Inc. to deliver a specialized financial literacy curriculum to California high schools. The company was formerly known as New BLC Corporation and changed its name to SLM Corporation in December 2013. SLM Corporation was founded in 1972 and is headquartered in Newark, Delaware."
SLMBP,2020-12-31,NA,1154006000,NA,880690000,304453000,1718309000,0,1180221000,NA,273316000,1718309000,538088000,0,-26215000,NA,880690000,870956000,233635000,income_statement,Credit Services,SLM Corporation - Floating Rate,"SLM Corporation, through its subsidiaries, originates and services private education loans to students and their families to finance the cost of their education in the United States. It also offers retail deposit accounts, including certificates of deposit, money market deposit accounts, and high-yield savings accounts; omnibus accounts; and a consumer savings network that provides financial rewards on everyday purchases to help families save for college. It has a strategic partnership with EVERFI, Inc. to deliver a specialized financial literacy curriculum to California high schools. The company was formerly known as New BLC Corporation and changed its name to SLM Corporation in December 2013. SLM Corporation was founded in 1972 and is headquartered in Newark, Delaware."
SLN,2016-12-31,NA,-10362000,NA,-8440000,3965000,-7941000,-11906000,-11906000,-15000,-1922000,770000,12676000,8711000,1544000,NA,-8440000,-8440000,NA,income_statement,Biotechnology,Silence Therapeutics Plc - Amer,"Silence Therapeutics plc focuses on the discovery, development, and delivery of novel RNA therapeutics in hematology, cardiovascular, and other rare and metabolic indications. The company designs short interfering RNA (siRNA) molecules that trigger the RNAi pathway and mediate the degradation of specific target messenger RNAs. It is developing various product candidates, including SLN124 for the treatment of iron overload disorders; SLN360 for the cardiovascular disease with high lipoprotein; and SLN500 for the treatment of complement-mediated diseases. Silence Therapeutics plc has a strategic collaboration with AstraZeneca to discover, develop, and commercialize small interfering RNA therapeutics for the treatment of cardiovascular, renal, metabolic, and respiratory diseases; and collaboration with Genomics England Limited. The company was formerly known as SR Pharma plc and changed its name to Silence Therapeutics plc in May 2007. Silence Therapeutics plc is headquartered in London, the United Kingdom."
SLN,2017-12-31,NA,-3775000,NA,-1618000,6464000,-7927000,-14391000,-14391000,-15000,-2157000,16000,14407000,7943000,10616000,NA,-1618000,-1618000,NA,income_statement,Biotechnology,Silence Therapeutics Plc - Amer,"Silence Therapeutics plc focuses on the discovery, development, and delivery of novel RNA therapeutics in hematology, cardiovascular, and other rare and metabolic indications. The company designs short interfering RNA (siRNA) molecules that trigger the RNAi pathway and mediate the degradation of specific target messenger RNAs. It is developing various product candidates, including SLN124 for the treatment of iron overload disorders; SLN360 for the cardiovascular disease with high lipoprotein; and SLN500 for the treatment of complement-mediated diseases. Silence Therapeutics plc has a strategic collaboration with AstraZeneca to discover, develop, and commercialize small interfering RNA therapeutics for the treatment of cardiovascular, renal, metabolic, and respiratory diseases; and collaboration with Genomics England Limited. The company was formerly known as SR Pharma plc and changed its name to Silence Therapeutics plc in May 2007. Silence Therapeutics plc is headquartered in London, the United Kingdom."
SLN,2018-12-31,NA,-20526000,NA,-18411000,10828000,-9743000,-20571000,-20571000,-33000,-2115000,0,20571000,9743000,45000,NA,-18411000,-18411000,NA,income_statement,Biotechnology,Silence Therapeutics Plc - Amer,"Silence Therapeutics plc focuses on the discovery, development, and delivery of novel RNA therapeutics in hematology, cardiovascular, and other rare and metabolic indications. The company designs short interfering RNA (siRNA) molecules that trigger the RNAi pathway and mediate the degradation of specific target messenger RNAs. It is developing various product candidates, including SLN124 for the treatment of iron overload disorders; SLN360 for the cardiovascular disease with high lipoprotein; and SLN500 for the treatment of complement-mediated diseases. Silence Therapeutics plc has a strategic collaboration with AstraZeneca to discover, develop, and commercialize small interfering RNA therapeutics for the treatment of cardiovascular, renal, metabolic, and respiratory diseases; and collaboration with Genomics England Limited. The company was formerly known as SR Pharma plc and changed its name to Silence Therapeutics plc in May 2007. Silence Therapeutics plc is headquartered in London, the United Kingdom."
SLN,2019-12-31,NA,-22870000,NA,-19582000,9642000,-13092000,-22734000,-22734000,-33000,-3288000,244000,22978000,13336000,-136000,NA,-19582000,-19582000,NA,income_statement,Biotechnology,Silence Therapeutics Plc - Amer,"Silence Therapeutics plc focuses on the discovery, development, and delivery of novel RNA therapeutics in hematology, cardiovascular, and other rare and metabolic indications. The company designs short interfering RNA (siRNA) molecules that trigger the RNAi pathway and mediate the degradation of specific target messenger RNAs. It is developing various product candidates, including SLN124 for the treatment of iron overload disorders; SLN360 for the cardiovascular disease with high lipoprotein; and SLN500 for the treatment of complement-mediated diseases. Silence Therapeutics plc has a strategic collaboration with AstraZeneca to discover, develop, and commercialize small interfering RNA therapeutics for the treatment of cardiovascular, renal, metabolic, and respiratory diseases; and collaboration with Genomics England Limited. The company was formerly known as SR Pharma plc and changed its name to Silence Therapeutics plc in May 2007. Silence Therapeutics plc is headquartered in London, the United Kingdom."
SLNO,2016-12-31,2247141,-6737620,NA,-12065214,5901976,0,-8149117,-8149117,-590000,0,0,8149117,0,1411497,-5327594,-6737620,-15716386,NA,income_statement,Diagnostics & Research,"Soleno Therapeutics, Inc.","Soleno Therapeutics, Inc., a clinical-stage biopharmaceutical company, focuses on the development and commercialization of novel therapeutics for the treatment of rare diseases. Its lead candidate is Diazoxide Choline Controlled Release (DCCR), a once-daily oral tablet for the treatment of Prader-Willi Syndrome (PWS), is being evaluated in a Phase III clinical development program. The company was formerly known as Capnia, Inc. and changed its name to Soleno Therapeutics, Inc. in May 2017. Soleno Therapeutics, Inc. was incorporated in 1999 and is headquartered in Redwood City, California."
SLNO,2017-12-31,3069000,-13442000,NA,-15385000,6610000,0,-9679000,-9679000,-590000,-1650000,0,9679000,0,-3763000,-3593000,-11792000,-15385000,NA,income_statement,Diagnostics & Research,"Soleno Therapeutics, Inc.","Soleno Therapeutics, Inc., a clinical-stage biopharmaceutical company, focuses on the development and commercialization of novel therapeutics for the treatment of rare diseases. Its lead candidate is Diazoxide Choline Controlled Release (DCCR), a once-daily oral tablet for the treatment of Prader-Willi Syndrome (PWS), is being evaluated in a Phase III clinical development program. The company was formerly known as Capnia, Inc. and changed its name to Soleno Therapeutics, Inc. in May 2017. Soleno Therapeutics, Inc. was incorporated in 1999 and is headquartered in Redwood City, California."
SLNO,2018-12-31,7178000,-11841000,NA,-13335000,6556000,0,-13734000,-13734000,-62000,0,0,13734000,0,1893000,-1494000,-11841000,-13335000,NA,income_statement,Diagnostics & Research,"Soleno Therapeutics, Inc.","Soleno Therapeutics, Inc., a clinical-stage biopharmaceutical company, focuses on the development and commercialization of novel therapeutics for the treatment of rare diseases. Its lead candidate is Diazoxide Choline Controlled Release (DCCR), a once-daily oral tablet for the treatment of Prader-Willi Syndrome (PWS), is being evaluated in a Phase III clinical development program. The company was formerly known as Capnia, Inc. and changed its name to Soleno Therapeutics, Inc. in May 2017. Soleno Therapeutics, Inc. was incorporated in 1999 and is headquartered in Redwood City, California."
SLNO,2019-12-31,16267000,-30774000,NA,-30774000,6930000,0,-23197000,-23197000,NA,0,0,23197000,0,-7577000,NA,-30774000,-30774000,NA,income_statement,Diagnostics & Research,"Soleno Therapeutics, Inc.","Soleno Therapeutics, Inc., a clinical-stage biopharmaceutical company, focuses on the development and commercialization of novel therapeutics for the treatment of rare diseases. Its lead candidate is Diazoxide Choline Controlled Release (DCCR), a once-daily oral tablet for the treatment of Prader-Willi Syndrome (PWS), is being evaluated in a Phase III clinical development program. The company was formerly known as Capnia, Inc. and changed its name to Soleno Therapeutics, Inc. in May 2017. Soleno Therapeutics, Inc. was incorporated in 1999 and is headquartered in Redwood City, California."
SLP,2017-08-31,1367645,8240267,NA,5787597,7578184,17830113,8884284,8884284,-38188,2452670,24137913,15253629,6307800,-644017,NA,5787597,5787597,NA,income_statement,Health Information Services,"Simulations Plus, Inc.","Simulations Plus, Inc. develops drug discovery and development software for mechanistic modeling and simulation, and prediction of properties of molecules utilizing artificial-intelligence- and machine-learning-based technology worldwide. The company offers GastroPlus, which simulates the absorption, pharmacokinetics (PK), pharmacodynamics, and drug-drug interactions of compounds administered to humans and animals; DDDPlus that simulates in vitro laboratory experiments; and MembranePlus, which simulates laboratory experiments. It also provides PKPlus, a program that provides the functionality needed by pharmaceutical industry scientists to perform the analyses and generate the outputs needed to satisfy regulatory agency requirements for noncompartmental analysis and compartmental PK modelling; ADMET Predictor, a chemistry-based computer program that takes molecular structures as inputs and predicts their properties; and MedChem Designer, a molecule drawing program or sketcher. In addition, it offers KIWI, a cloud-based web application to organize, process, maintain, and communicate the volume of data and results generated by pharmacologists and scientists over the duration of a drug development program; DILIsym, a quantitative systems pharmacology software; NAFLDsym, a simulation program for analyzing nonalcoholic fatty liver disease; RENAsym for investigating and predicting drug-induced or acute kidney injury; IPFsym, a software tool to treat or cure idiopathic pulmonary fibrosis; and the Monolix Suite, a solution for modeling and simulation. Further, the company provides population modeling and simulation contract research services; and clinical-pharmacology-based consulting services in support of regulatory submissions. It serves pharmaceutical, biotechnology, agrochemical, cosmetics, and food companies, as well as academic and regulatory agencies. The company was founded in 1996 and is headquartered in Lancaster, California."
SLP,2018-08-31,1790656,10138942,NA,8934812,9583852,21672296,10297788,10297788,NA,1204130,29666524,19368736,7994228,-158846,NA,8934812,8934812,NA,income_statement,Health Information Services,"Simulations Plus, Inc.","Simulations Plus, Inc. develops drug discovery and development software for mechanistic modeling and simulation, and prediction of properties of molecules utilizing artificial-intelligence- and machine-learning-based technology worldwide. The company offers GastroPlus, which simulates the absorption, pharmacokinetics (PK), pharmacodynamics, and drug-drug interactions of compounds administered to humans and animals; DDDPlus that simulates in vitro laboratory experiments; and MembranePlus, which simulates laboratory experiments. It also provides PKPlus, a program that provides the functionality needed by pharmaceutical industry scientists to perform the analyses and generate the outputs needed to satisfy regulatory agency requirements for noncompartmental analysis and compartmental PK modelling; ADMET Predictor, a chemistry-based computer program that takes molecular structures as inputs and predicts their properties; and MedChem Designer, a molecule drawing program or sketcher. In addition, it offers KIWI, a cloud-based web application to organize, process, maintain, and communicate the volume of data and results generated by pharmacologists and scientists over the duration of a drug development program; DILIsym, a quantitative systems pharmacology software; NAFLDsym, a simulation program for analyzing nonalcoholic fatty liver disease; RENAsym for investigating and predicting drug-induced or acute kidney injury; IPFsym, a software tool to treat or cure idiopathic pulmonary fibrosis; and the Monolix Suite, a solution for modeling and simulation. Further, the company provides population modeling and simulation contract research services; and clinical-pharmacology-based consulting services in support of regulatory submissions. It serves pharmaceutical, biotechnology, agrochemical, cosmetics, and food companies, as well as academic and regulatory agencies. The company was founded in 1996 and is headquartered in Lancaster, California."
SLP,2019-08-31,2499980,10556476,NA,8583329,11796027,24944736,10648729,10648729,NA,1973147,33970440,23321711,9025704,-92253,NA,8583329,8583329,NA,income_statement,Health Information Services,"Simulations Plus, Inc.","Simulations Plus, Inc. develops drug discovery and development software for mechanistic modeling and simulation, and prediction of properties of molecules utilizing artificial-intelligence- and machine-learning-based technology worldwide. The company offers GastroPlus, which simulates the absorption, pharmacokinetics (PK), pharmacodynamics, and drug-drug interactions of compounds administered to humans and animals; DDDPlus that simulates in vitro laboratory experiments; and MembranePlus, which simulates laboratory experiments. It also provides PKPlus, a program that provides the functionality needed by pharmaceutical industry scientists to perform the analyses and generate the outputs needed to satisfy regulatory agency requirements for noncompartmental analysis and compartmental PK modelling; ADMET Predictor, a chemistry-based computer program that takes molecular structures as inputs and predicts their properties; and MedChem Designer, a molecule drawing program or sketcher. In addition, it offers KIWI, a cloud-based web application to organize, process, maintain, and communicate the volume of data and results generated by pharmacologists and scientists over the duration of a drug development program; DILIsym, a quantitative systems pharmacology software; NAFLDsym, a simulation program for analyzing nonalcoholic fatty liver disease; RENAsym for investigating and predicting drug-induced or acute kidney injury; IPFsym, a software tool to treat or cure idiopathic pulmonary fibrosis; and the Monolix Suite, a solution for modeling and simulation. Further, the company provides population modeling and simulation contract research services; and clinical-pharmacology-based consulting services in support of regulatory submissions. It serves pharmaceutical, biotechnology, agrochemical, cosmetics, and food companies, as well as academic and regulatory agencies. The company was founded in 1996 and is headquartered in Lancaster, California."
SLP,2020-08-31,2974623,11387049,NA,9332060,14944053,30939854,13021178,13021178,NA,2054989,41589084,28567906,10649230,-1634129,NA,9332060,9332060,NA,income_statement,Health Information Services,"Simulations Plus, Inc.","Simulations Plus, Inc. develops drug discovery and development software for mechanistic modeling and simulation, and prediction of properties of molecules utilizing artificial-intelligence- and machine-learning-based technology worldwide. The company offers GastroPlus, which simulates the absorption, pharmacokinetics (PK), pharmacodynamics, and drug-drug interactions of compounds administered to humans and animals; DDDPlus that simulates in vitro laboratory experiments; and MembranePlus, which simulates laboratory experiments. It also provides PKPlus, a program that provides the functionality needed by pharmaceutical industry scientists to perform the analyses and generate the outputs needed to satisfy regulatory agency requirements for noncompartmental analysis and compartmental PK modelling; ADMET Predictor, a chemistry-based computer program that takes molecular structures as inputs and predicts their properties; and MedChem Designer, a molecule drawing program or sketcher. In addition, it offers KIWI, a cloud-based web application to organize, process, maintain, and communicate the volume of data and results generated by pharmacologists and scientists over the duration of a drug development program; DILIsym, a quantitative systems pharmacology software; NAFLDsym, a simulation program for analyzing nonalcoholic fatty liver disease; RENAsym for investigating and predicting drug-induced or acute kidney injury; IPFsym, a software tool to treat or cure idiopathic pulmonary fibrosis; and the Monolix Suite, a solution for modeling and simulation. Further, the company provides population modeling and simulation contract research services; and clinical-pharmacology-based consulting services in support of regulatory submissions. It serves pharmaceutical, biotechnology, agrochemical, cosmetics, and food companies, as well as academic and regulatory agencies. The company was founded in 1996 and is headquartered in Lancaster, California."
SLRC,2016-12-31,NA,106815000,NA,106815000,56167000,151839000,95672000,95672000,-24571000,0,151839000,56167000,0,11143000,NA,106815000,106815000,NA,income_statement,Asset Management,Solar Capital Ltd.,"Solar Capital Ltd. is a business development company specializing in secured debt (first lien unitranche and second lien), subordinated (unsecured) debt, minority equity, and strategic income-oriented control equity investments in leveraged middle market companies. The fund invests in aerospace and defense; air freight & logistics; asset management; automotive; banking; beverage, food and tobacco; building products; buildings and real estate; broadcasting and entertainment; cargo transport; commercial services and supplies; communications equipment; chemicals, plastics and rubber; containers, packaging and glass; construction & engineering; diversified/conglomerate manufacturing; consumer Finance; distributors; diversified/conglomerate services; diversified financial services; diversified real estate sctivities; food products; Footwear; Education Services; diversified telecommunications services; electronics; farming and agriculture; finance; grocery; health care equipment and supplies; health care facilities; education and childcare; home and office furnishing, durable consumer products; hotels, motels, inns and gaming; insurance; restaurants, leisure, amusement, and entertainment; leisure equipment tolls and services, media, multiline retail, multi sector holdings; paper and forest products; personal products; professional services, research and consulting services, software; specialty retail; textiles apparel and luxury goods, thrifts and mortgage finance, trading companies and distributors, utilities, and wireless telecommunication services; industrial conglomerates; internet software and services, IT services, machinery; mining, steel, iron, and non precious metals; oil and gas; personal, food and miscellaneous services; printing and publishing; retail stores; telecommunications; textiles and leather; and utilities. It also invests in life sciences with focus on specialty pharmaceuticals, medical devices, biotech, health Care Providers and services; health Care technology, enabling technologies and tools. The fund primarily invests in United States. The fund's investments generally range between $5 million and $100 million. The fund invests in companies with revenues between $50 million and $1 billion and EBITDA between $15 million and $100 million. It invests in the form of senior secured loans, mezzanine loans, and equity securities. It may also seek investments in thinly traded public companies and also make secondary investments. The fund makes non-control equity investments. It primarily exits within three years of the initial capital commitment."
SLRC,2017-12-31,NA,70430000,NA,70430000,53309000,143338000,90029000,90029000,-21666000,0,143338000,53309000,0,-19599000,NA,70430000,70430000,NA,income_statement,Asset Management,Solar Capital Ltd.,"Solar Capital Ltd. is a business development company specializing in secured debt (first lien unitranche and second lien), subordinated (unsecured) debt, minority equity, and strategic income-oriented control equity investments in leveraged middle market companies. The fund invests in aerospace and defense; air freight & logistics; asset management; automotive; banking; beverage, food and tobacco; building products; buildings and real estate; broadcasting and entertainment; cargo transport; commercial services and supplies; communications equipment; chemicals, plastics and rubber; containers, packaging and glass; construction & engineering; diversified/conglomerate manufacturing; consumer Finance; distributors; diversified/conglomerate services; diversified financial services; diversified real estate sctivities; food products; Footwear; Education Services; diversified telecommunications services; electronics; farming and agriculture; finance; grocery; health care equipment and supplies; health care facilities; education and childcare; home and office furnishing, durable consumer products; hotels, motels, inns and gaming; insurance; restaurants, leisure, amusement, and entertainment; leisure equipment tolls and services, media, multiline retail, multi sector holdings; paper and forest products; personal products; professional services, research and consulting services, software; specialty retail; textiles apparel and luxury goods, thrifts and mortgage finance, trading companies and distributors, utilities, and wireless telecommunication services; industrial conglomerates; internet software and services, IT services, machinery; mining, steel, iron, and non precious metals; oil and gas; personal, food and miscellaneous services; printing and publishing; retail stores; telecommunications; textiles and leather; and utilities. It also invests in life sciences with focus on specialty pharmaceuticals, medical devices, biotech, health Care Providers and services; health Care technology, enabling technologies and tools. The fund primarily invests in United States. The fund's investments generally range between $5 million and $100 million. The fund invests in companies with revenues between $50 million and $1 billion and EBITDA between $15 million and $100 million. It invests in the form of senior secured loans, mezzanine loans, and equity securities. It may also seek investments in thinly traded public companies and also make secondary investments. The fund makes non-control equity investments. It primarily exits within three years of the initial capital commitment."
SLRC,2018-12-31,NA,66874000,NA,66874000,53909000,153526000,99617000,99617000,-24728000,0,153526000,53909000,0,-32743000,NA,66874000,66874000,NA,income_statement,Asset Management,Solar Capital Ltd.,"Solar Capital Ltd. is a business development company specializing in secured debt (first lien unitranche and second lien), subordinated (unsecured) debt, minority equity, and strategic income-oriented control equity investments in leveraged middle market companies. The fund invests in aerospace and defense; air freight & logistics; asset management; automotive; banking; beverage, food and tobacco; building products; buildings and real estate; broadcasting and entertainment; cargo transport; commercial services and supplies; communications equipment; chemicals, plastics and rubber; containers, packaging and glass; construction & engineering; diversified/conglomerate manufacturing; consumer Finance; distributors; diversified/conglomerate services; diversified financial services; diversified real estate sctivities; food products; Footwear; Education Services; diversified telecommunications services; electronics; farming and agriculture; finance; grocery; health care equipment and supplies; health care facilities; education and childcare; home and office furnishing, durable consumer products; hotels, motels, inns and gaming; insurance; restaurants, leisure, amusement, and entertainment; leisure equipment tolls and services, media, multiline retail, multi sector holdings; paper and forest products; personal products; professional services, research and consulting services, software; specialty retail; textiles apparel and luxury goods, thrifts and mortgage finance, trading companies and distributors, utilities, and wireless telecommunication services; industrial conglomerates; internet software and services, IT services, machinery; mining, steel, iron, and non precious metals; oil and gas; personal, food and miscellaneous services; printing and publishing; retail stores; telecommunications; textiles and leather; and utilities. It also invests in life sciences with focus on specialty pharmaceuticals, medical devices, biotech, health Care Providers and services; health Care technology, enabling technologies and tools. The fund primarily invests in United States. The fund's investments generally range between $5 million and $100 million. The fund invests in companies with revenues between $50 million and $1 billion and EBITDA between $15 million and $100 million. It invests in the form of senior secured loans, mezzanine loans, and equity securities. It may also seek investments in thinly traded public companies and also make secondary investments. The fund makes non-control equity investments. It primarily exits within three years of the initial capital commitment."
SLRC,2019-12-31,NA,56016000,NA,56016000,53365000,154711000,101346000,101346000,-28901000,0,154711000,53365000,0,-45330000,NA,56016000,56016000,NA,income_statement,Asset Management,Solar Capital Ltd.,"Solar Capital Ltd. is a business development company specializing in secured debt (first lien unitranche and second lien), subordinated (unsecured) debt, minority equity, and strategic income-oriented control equity investments in leveraged middle market companies. The fund invests in aerospace and defense; air freight & logistics; asset management; automotive; banking; beverage, food and tobacco; building products; buildings and real estate; broadcasting and entertainment; cargo transport; commercial services and supplies; communications equipment; chemicals, plastics and rubber; containers, packaging and glass; construction & engineering; diversified/conglomerate manufacturing; consumer Finance; distributors; diversified/conglomerate services; diversified financial services; diversified real estate sctivities; food products; Footwear; Education Services; diversified telecommunications services; electronics; farming and agriculture; finance; grocery; health care equipment and supplies; health care facilities; education and childcare; home and office furnishing, durable consumer products; hotels, motels, inns and gaming; insurance; restaurants, leisure, amusement, and entertainment; leisure equipment tolls and services, media, multiline retail, multi sector holdings; paper and forest products; personal products; professional services, research and consulting services, software; specialty retail; textiles apparel and luxury goods, thrifts and mortgage finance, trading companies and distributors, utilities, and wireless telecommunication services; industrial conglomerates; internet software and services, IT services, machinery; mining, steel, iron, and non precious metals; oil and gas; personal, food and miscellaneous services; printing and publishing; retail stores; telecommunications; textiles and leather; and utilities. It also invests in life sciences with focus on specialty pharmaceuticals, medical devices, biotech, health Care Providers and services; health Care technology, enabling technologies and tools. The fund primarily invests in United States. The fund's investments generally range between $5 million and $100 million. The fund invests in companies with revenues between $50 million and $1 billion and EBITDA between $15 million and $100 million. It invests in the form of senior secured loans, mezzanine loans, and equity securities. It may also seek investments in thinly traded public companies and also make secondary investments. The fund makes non-control equity investments. It primarily exits within three years of the initial capital commitment."
SLRX,2016-12-31,NA,-1223728,NA,-1223728,817485,-906740,-1724225,-1724225,NA,0,2553084,4277309,3459824,500497,1833,-1223728,-1279399,NA,income_statement,Biotechnology,"Salarius Pharmaceuticals, Inc.","Salarius Pharmaceuticals, Inc. a clinical-stage biotechnology company, develops epigenetic-based cancer treatments. The company's lead candidate is Seclidemstat (SP-2577), which is in Phase I/II clinical trial for the treatment of advanced solid tumors, including prostate, breast, and ovarian cancers, as well as Ewing sarcoma. Salarius Pharmaceuticals, Inc. has a strategic partnership with The University of Utah Research Foundation for the exclusive license with respect to patent rights protecting SP-2577 and related compounds; HLB Life Sciences to develop, produce, manufacture, use, and sell the drug in South Korea; and Cancer Prevention and Research Institute of Texas for product development activities. The company is headquartered in Houston, Texas."
SLRX,2017-12-31,NA,-1747335,NA,-1747335,1471067,-277780,-1748847,-1748847,NA,0,1851892,3600739,2129672,1512,1833,-1747335,-1840109,NA,income_statement,Biotechnology,"Salarius Pharmaceuticals, Inc.","Salarius Pharmaceuticals, Inc. a clinical-stage biotechnology company, develops epigenetic-based cancer treatments. The company's lead candidate is Seclidemstat (SP-2577), which is in Phase I/II clinical trial for the treatment of advanced solid tumors, including prostate, breast, and ovarian cancers, as well as Ewing sarcoma. Salarius Pharmaceuticals, Inc. has a strategic partnership with The University of Utah Research Foundation for the exclusive license with respect to patent rights protecting SP-2577 and related compounds; HLB Life Sciences to develop, produce, manufacture, use, and sell the drug in South Korea; and Cancer Prevention and Research Institute of Texas for product development activities. The company is headquartered in Houston, Texas."
SLRX,2018-12-31,NA,-1669637,NA,-1669637,2348361,663730,-1684631,-1684631,NA,0,1951351,3635982,1287621,14994,1833,-1669637,-1793364,NA,income_statement,Biotechnology,"Salarius Pharmaceuticals, Inc.","Salarius Pharmaceuticals, Inc. a clinical-stage biotechnology company, develops epigenetic-based cancer treatments. The company's lead candidate is Seclidemstat (SP-2577), which is in Phase I/II clinical trial for the treatment of advanced solid tumors, including prostate, breast, and ovarian cancers, as well as Ewing sarcoma. Salarius Pharmaceuticals, Inc. has a strategic partnership with The University of Utah Research Foundation for the exclusive license with respect to patent rights protecting SP-2577 and related compounds; HLB Life Sciences to develop, produce, manufacture, use, and sell the drug in South Korea; and Cancer Prevention and Research Institute of Texas for product development activities. The company is headquartered in Houston, Texas."
SLRX,2019-12-31,NA,-6938096,NA,-6936263,5601181,-553896,-6155077,-6155077,NA,0,3465055,9620132,4018951,-783019,1833,-6938096,-6936263,NA,income_statement,Biotechnology,"Salarius Pharmaceuticals, Inc.","Salarius Pharmaceuticals, Inc. a clinical-stage biotechnology company, develops epigenetic-based cancer treatments. The company's lead candidate is Seclidemstat (SP-2577), which is in Phase I/II clinical trial for the treatment of advanced solid tumors, including prostate, breast, and ovarian cancers, as well as Ewing sarcoma. Salarius Pharmaceuticals, Inc. has a strategic partnership with The University of Utah Research Foundation for the exclusive license with respect to patent rights protecting SP-2577 and related compounds; HLB Life Sciences to develop, produce, manufacture, use, and sell the drug in South Korea; and Cancer Prevention and Research Institute of Texas for product development activities. The company is headquartered in Houston, Texas."
SLS,2016-12-31,11395000,-17680000,NA,-17681000,4593000,0,-15988000,-15988000,-1166000,1000,0,15988000,0,-1692000,NA,-17681000,-17681000,NA,income_statement,Biotechnology,"SELLAS Life Sciences Group, Inc","SELLAS Life Sciences Group, Inc., a clinical-stage biopharmaceutical company, focuses on the development of novel cancer immunotherapies for various cancer indications in the United States. The company's lead product candidate is galinpepimut-S (GPS), a wilms tumor 1 targeting peptide-based cancer immunotherapeutic agent, which is in Phase III clinical trials for the treatment of acute myeloid leukemia; and is in various development phases as a potential treatment for ovarian cancer. It also develops nelipepimut-S that is in Phase 2b clinical trials for the treatment of breast cancer. The company has strategic collaboration with Merck & Co., Inc. to evaluate GPS as it is administered in combination with PD1 blocker pembrolizumab in a Phase 1/2 clinical trial enrolling patients in up to five cancer indications, including hematologic malignancies and solid tumors. SELLAS Life Sciences Group, Inc. was founded in 2012 and is headquartered in New York, New York."
SLS,2017-12-31,6067000,-23501000,NA,-23754000,9389000,0,-15456000,-15456000,-462000,253000,0,15456000,0,-8045000,NA,-23754000,-24429000,NA,income_statement,Biotechnology,"SELLAS Life Sciences Group, Inc","SELLAS Life Sciences Group, Inc., a clinical-stage biopharmaceutical company, focuses on the development of novel cancer immunotherapies for various cancer indications in the United States. The company's lead product candidate is galinpepimut-S (GPS), a wilms tumor 1 targeting peptide-based cancer immunotherapeutic agent, which is in Phase III clinical trials for the treatment of acute myeloid leukemia; and is in various development phases as a potential treatment for ovarian cancer. It also develops nelipepimut-S that is in Phase 2b clinical trials for the treatment of breast cancer. The company has strategic collaboration with Merck & Co., Inc. to evaluate GPS as it is administered in combination with PD1 blocker pembrolizumab in a Phase 1/2 clinical trial enrolling patients in up to five cancer indications, including hematologic malignancies and solid tumors. SELLAS Life Sciences Group, Inc. was founded in 2012 and is headquartered in New York, New York."
SLS,2018-12-31,8767000,-29048000,NA,-27670000,13272000,0,-22039000,-22039000,-266000,-1378000,0,22039000,0,-7009000,NA,-27670000,-41251000,NA,income_statement,Biotechnology,"SELLAS Life Sciences Group, Inc","SELLAS Life Sciences Group, Inc., a clinical-stage biopharmaceutical company, focuses on the development of novel cancer immunotherapies for various cancer indications in the United States. The company's lead product candidate is galinpepimut-S (GPS), a wilms tumor 1 targeting peptide-based cancer immunotherapeutic agent, which is in Phase III clinical trials for the treatment of acute myeloid leukemia; and is in various development phases as a potential treatment for ovarian cancer. It also develops nelipepimut-S that is in Phase 2b clinical trials for the treatment of breast cancer. The company has strategic collaboration with Merck & Co., Inc. to evaluate GPS as it is administered in combination with PD1 blocker pembrolizumab in a Phase 1/2 clinical trial enrolling patients in up to five cancer indications, including hematologic malignancies and solid tumors. SELLAS Life Sciences Group, Inc. was founded in 2012 and is headquartered in New York, New York."
SLS,2019-12-31,7285000,-19373000,NA,-19292000,9923000,0,-17208000,-17208000,NA,-81000,0,17208000,0,-2165000,NA,-19292000,-27951000,NA,income_statement,Biotechnology,"SELLAS Life Sciences Group, Inc","SELLAS Life Sciences Group, Inc., a clinical-stage biopharmaceutical company, focuses on the development of novel cancer immunotherapies for various cancer indications in the United States. The company's lead product candidate is galinpepimut-S (GPS), a wilms tumor 1 targeting peptide-based cancer immunotherapeutic agent, which is in Phase III clinical trials for the treatment of acute myeloid leukemia; and is in various development phases as a potential treatment for ovarian cancer. It also develops nelipepimut-S that is in Phase 2b clinical trials for the treatment of breast cancer. The company has strategic collaboration with Merck & Co., Inc. to evaluate GPS as it is administered in combination with PD1 blocker pembrolizumab in a Phase 1/2 clinical trial enrolling patients in up to five cancer indications, including hematologic malignancies and solid tumors. SELLAS Life Sciences Group, Inc. was founded in 2012 and is headquartered in New York, New York."
SMBC,2017-06-30,NA,21614000,NA,15552000,30720000,59866000,0,23206000,NA,6062000,59866000,36660000,0,-1592000,NA,15552000,15552000,5940000,income_statement,Banks—Regional,"Southern Missouri Bancorp, Inc.","Southern Missouri Bancorp, Inc. operates as the bank holding company for Southern Bank that provides banking and financial services to individuals and corporate customers in the United States. It offers various deposit instruments, including interest-bearing and noninterest-bearing transaction accounts, money market deposit accounts, saving accounts, certificates of deposit, and retirement savings plans. The company also provides loans for the acquisition or refinance of one-to four-family residences and multi-family residential properties; loans secured by commercial real estate, such as farmland, single- and multi-tenant retail properties, restaurants, hotels, land, nursing homes and other healthcare-related facilities, warehouses and distribution centers, convenience stores, automobile dealerships and other automotive-related services, and other businesses; construction loans; and various secured consumer loans comprising home equity, direct and indirect automobile loans, second mortgages, mobile home loans, and loans secured by deposits. In addition, it offers commercial business loans, such as loans to finance accounts receivable, inventory, equipment, and operating lines of credit, which include agricultural production and equipment loans. As of June 30, 2020, the company operated 45 full-service branch offices, and two limited-service branch offices located in Poplar Bluff, Van Buren, Dexter, Kennett, Doniphan, Sikeston, Qulin, Matthews, Springfield, Thayer, West Plains, Alton, Clever, Forsyth, Fremont Hills, Kimberling City, Ozark, Nixa, Rogersville, Marshfield, Cape Girardeau, Jackson, Gideon, Chaffee, Benton, Advance, Bloomfield, Essex, and Rolla Missouri; Jonesboro, Paragould, Batesville, Searcy, Bald Knob, Bradford, and Cabot, Arkansas; and Anna, Cairo, and Tamms, Illinois. Southern Missouri Bancorp, Inc. was founded in 1887 and is headquartered in Poplar Bluff, Missouri."
SMBC,2018-06-30,NA,28732000,NA,20929000,36675000,71705000,0,30892000,NA,7803000,71705000,40813000,0,-2160000,NA,20929000,20929000,4138000,income_statement,Banks—Regional,"Southern Missouri Bancorp, Inc.","Southern Missouri Bancorp, Inc. operates as the bank holding company for Southern Bank that provides banking and financial services to individuals and corporate customers in the United States. It offers various deposit instruments, including interest-bearing and noninterest-bearing transaction accounts, money market deposit accounts, saving accounts, certificates of deposit, and retirement savings plans. The company also provides loans for the acquisition or refinance of one-to four-family residences and multi-family residential properties; loans secured by commercial real estate, such as farmland, single- and multi-tenant retail properties, restaurants, hotels, land, nursing homes and other healthcare-related facilities, warehouses and distribution centers, convenience stores, automobile dealerships and other automotive-related services, and other businesses; construction loans; and various secured consumer loans comprising home equity, direct and indirect automobile loans, second mortgages, mobile home loans, and loans secured by deposits. In addition, it offers commercial business loans, such as loans to finance accounts receivable, inventory, equipment, and operating lines of credit, which include agricultural production and equipment loans. As of June 30, 2020, the company operated 45 full-service branch offices, and two limited-service branch offices located in Poplar Bluff, Van Buren, Dexter, Kennett, Doniphan, Sikeston, Qulin, Matthews, Springfield, Thayer, West Plains, Alton, Clever, Forsyth, Fremont Hills, Kimberling City, Ozark, Nixa, Rogersville, Marshfield, Cape Girardeau, Jackson, Gideon, Chaffee, Benton, Advance, Bloomfield, Essex, and Rolla Missouri; Jonesboro, Paragould, Batesville, Searcy, Bald Knob, Bradford, and Cabot, Arkansas; and Anna, Cairo, and Tamms, Illinois. Southern Missouri Bancorp, Inc. was founded in 1887 and is headquartered in Poplar Bluff, Missouri."
SMBC,2019-06-30,NA,35951000,NA,28904000,40545000,83497000,0,38380000,NA,7047000,83497000,45117000,0,-2429000,NA,28904000,28904000,4572000,income_statement,Banks—Regional,"Southern Missouri Bancorp, Inc.","Southern Missouri Bancorp, Inc. operates as the bank holding company for Southern Bank that provides banking and financial services to individuals and corporate customers in the United States. It offers various deposit instruments, including interest-bearing and noninterest-bearing transaction accounts, money market deposit accounts, saving accounts, certificates of deposit, and retirement savings plans. The company also provides loans for the acquisition or refinance of one-to four-family residences and multi-family residential properties; loans secured by commercial real estate, such as farmland, single- and multi-tenant retail properties, restaurants, hotels, land, nursing homes and other healthcare-related facilities, warehouses and distribution centers, convenience stores, automobile dealerships and other automotive-related services, and other businesses; construction loans; and various secured consumer loans comprising home equity, direct and indirect automobile loans, second mortgages, mobile home loans, and loans secured by deposits. In addition, it offers commercial business loans, such as loans to finance accounts receivable, inventory, equipment, and operating lines of credit, which include agricultural production and equipment loans. As of June 30, 2020, the company operated 45 full-service branch offices, and two limited-service branch offices located in Poplar Bluff, Van Buren, Dexter, Kennett, Doniphan, Sikeston, Qulin, Matthews, Springfield, Thayer, West Plains, Alton, Clever, Forsyth, Fremont Hills, Kimberling City, Ozark, Nixa, Rogersville, Marshfield, Cape Girardeau, Jackson, Gideon, Chaffee, Benton, Advance, Bloomfield, Essex, and Rolla Missouri; Jonesboro, Paragould, Batesville, Searcy, Bald Knob, Bradford, and Cabot, Arkansas; and Anna, Cairo, and Tamms, Illinois. Southern Missouri Bancorp, Inc. was founded in 1887 and is headquartered in Poplar Bluff, Missouri."
SMBC,2020-06-30,NA,34432000,NA,27545000,46060000,88884000,0,37350000,NA,6887000,88884000,51534000,0,-2918000,NA,27545000,27545000,5474000,income_statement,Banks—Regional,"Southern Missouri Bancorp, Inc.","Southern Missouri Bancorp, Inc. operates as the bank holding company for Southern Bank that provides banking and financial services to individuals and corporate customers in the United States. It offers various deposit instruments, including interest-bearing and noninterest-bearing transaction accounts, money market deposit accounts, saving accounts, certificates of deposit, and retirement savings plans. The company also provides loans for the acquisition or refinance of one-to four-family residences and multi-family residential properties; loans secured by commercial real estate, such as farmland, single- and multi-tenant retail properties, restaurants, hotels, land, nursing homes and other healthcare-related facilities, warehouses and distribution centers, convenience stores, automobile dealerships and other automotive-related services, and other businesses; construction loans; and various secured consumer loans comprising home equity, direct and indirect automobile loans, second mortgages, mobile home loans, and loans secured by deposits. In addition, it offers commercial business loans, such as loans to finance accounts receivable, inventory, equipment, and operating lines of credit, which include agricultural production and equipment loans. As of June 30, 2020, the company operated 45 full-service branch offices, and two limited-service branch offices located in Poplar Bluff, Van Buren, Dexter, Kennett, Doniphan, Sikeston, Qulin, Matthews, Springfield, Thayer, West Plains, Alton, Clever, Forsyth, Fremont Hills, Kimberling City, Ozark, Nixa, Rogersville, Marshfield, Cape Girardeau, Jackson, Gideon, Chaffee, Benton, Advance, Bloomfield, Essex, and Rolla Missouri; Jonesboro, Paragould, Batesville, Searcy, Bald Knob, Bradford, and Cabot, Arkansas; and Anna, Cairo, and Tamms, Illinois. Southern Missouri Bancorp, Inc. was founded in 1887 and is headquartered in Poplar Bluff, Missouri."
SMBK,2017-12-31,NA,11443855,NA,5015064,29612239,50573644,0,14804907,NA,6428791,50573644,35768737,0,-3361052,NA,5015064,4820064,6156498,income_statement,Banks—Regional,"SmartFinancial, Inc.","SmartFinancial, Inc. operates as the bank holding company for SmartBank that provides various financial services to individuals and corporate customers in Tennessee, Alabama, Florida, and Georgia. It accepts various deposit products, including interest bearing and non-interest bearing checking accounts, savings accounts, money market accounts, individual retirement accounts, and certificates of deposit. The company also provides commercial and consumer real estate loans, construction and land development, commercial and industrial, and consumer and other loans. In addition, it offers Internet and mobile banking services. As of March 31, 2020, the company operated through 35 full-service branches located in Tennessee, Alabama, and Florida; and 2 loan production offices and 2 service centers. SmartFinancial, Inc. is headquartered in Knoxville, Tennessee."
SMBK,2018-12-31,NA,21335000,NA,18102000,42406000,80292000,0,29791000,NA,3233000,80292000,50501000,0,-8456000,NA,18102000,18102000,8095000,income_statement,Banks—Regional,"SmartFinancial, Inc.","SmartFinancial, Inc. operates as the bank holding company for SmartBank that provides various financial services to individuals and corporate customers in Tennessee, Alabama, Florida, and Georgia. It accepts various deposit products, including interest bearing and non-interest bearing checking accounts, savings accounts, money market accounts, individual retirement accounts, and certificates of deposit. The company also provides commercial and consumer real estate loans, construction and land development, commercial and industrial, and consumer and other loans. In addition, it offers Internet and mobile banking services. As of March 31, 2020, the company operated through 35 full-service branches located in Tennessee, Alabama, and Florida; and 2 loan production offices and 2 service centers. SmartFinancial, Inc. is headquartered in Knoxville, Tennessee."
SMBK,2019-12-31,NA,33445000,NA,26548000,48704000,89476000,0,32372000,NA,6897000,89476000,57104000,0,1073000,NA,26548000,26548000,8400000,income_statement,Banks—Regional,"SmartFinancial, Inc.","SmartFinancial, Inc. operates as the bank holding company for SmartBank that provides various financial services to individuals and corporate customers in Tennessee, Alabama, Florida, and Georgia. It accepts various deposit products, including interest bearing and non-interest bearing checking accounts, savings accounts, money market accounts, individual retirement accounts, and certificates of deposit. The company also provides commercial and consumer real estate loans, construction and land development, commercial and industrial, and consumer and other loans. In addition, it offers Internet and mobile banking services. As of March 31, 2020, the company operated through 35 full-service branches located in Tennessee, Alabama, and Florida; and 2 loan production offices and 2 service centers. SmartFinancial, Inc. is headquartered in Knoxville, Tennessee."
SMBK,2020-12-31,NA,30890000,NA,24332000,57332000,107609000,0,40435000,NA,6558000,107609000,67174000,0,-9545000,NA,24332000,24332000,9842000,income_statement,Banks—Regional,"SmartFinancial, Inc.","SmartFinancial, Inc. operates as the bank holding company for SmartBank that provides various financial services to individuals and corporate customers in Tennessee, Alabama, Florida, and Georgia. It accepts various deposit products, including interest bearing and non-interest bearing checking accounts, savings accounts, money market accounts, individual retirement accounts, and certificates of deposit. The company also provides commercial and consumer real estate loans, construction and land development, commercial and industrial, and consumer and other loans. In addition, it offers Internet and mobile banking services. As of March 31, 2020, the company operated through 35 full-service branches located in Tennessee, Alabama, and Florida; and 2 loan production offices and 2 service centers. SmartFinancial, Inc. is headquartered in Knoxville, Tennessee."
SMCI,2017-06-30,143992000,91288000,170000,66854000,111091000,349958000,94875000,94875000,-2300000,24434000,2484929000,2390054000,2134971000,-3587000,NA,66854000,66854000,NA,income_statement,Computer Hardware,"Super Micro Computer, Inc.","Super Micro Computer, Inc., together with its subsidiaries, develops and manufactures high-performance server and storage solutions based on modular and open architecture. Its solutions range from complete server, storage, modular blade servers, blades, workstations, full racks, networking devices, server management software, and server sub-systems, as well as support and services. The company also provides a range of application-optimized server solutions, including rackmount and blade servers, storage systems, and subsystems and accessories; and server software management solutions, such as Server Management Suite, including Supermicro Server Manager, Supermicro Power Management software, Supermicro Update Manager, and SuperDoctor 5. In addition, it offers server subsystems and accessories comprising server boards, chassis, power supplies, and other accessories. Further, the company provides server and storage system integration, configuration, and software upgrade and update services; and technical documentation services, as well as identifies service requirements, creates and executes project plans, and conducts verification testing and training services. Additionally, it offers help desk and on-site product support services for its server and storage systems; and customer support services, including ongoing maintenance and technical support for its products. The company provides its products to enterprise data centers, cloud computing, artificial intelligence, and 5G and edge computing markets. It sells its products through direct sales force, distributors, value-added resellers, system integrators, and original equipment manufacturers. The company has operations primarily in the United States, Europe, Asia, and internationally. Super Micro Computer, Inc. was founded in 1993 and is headquartered in San Jose, California."
SMCI,2018-06-30,165104000,84608000,157000,46165000,170176000,429994000,94714000,94714000,-5726000,38443000,3360492000,3265778000,2930498000,-10106000,NA,46165000,46165000,NA,income_statement,Computer Hardware,"Super Micro Computer, Inc.","Super Micro Computer, Inc., together with its subsidiaries, develops and manufactures high-performance server and storage solutions based on modular and open architecture. Its solutions range from complete server, storage, modular blade servers, blades, workstations, full racks, networking devices, server management software, and server sub-systems, as well as support and services. The company also provides a range of application-optimized server solutions, including rackmount and blade servers, storage systems, and subsystems and accessories; and server software management solutions, such as Server Management Suite, including Supermicro Server Manager, Supermicro Power Management software, Supermicro Update Manager, and SuperDoctor 5. In addition, it offers server subsystems and accessories comprising server boards, chassis, power supplies, and other accessories. Further, the company provides server and storage system integration, configuration, and software upgrade and update services; and technical documentation services, as well as identifies service requirements, creates and executes project plans, and conducts verification testing and training services. Additionally, it offers help desk and on-site product support services for its server and storage systems; and customer support services, including ongoing maintenance and technical support for its products. The company provides its products to enterprise data centers, cloud computing, artificial intelligence, and 5G and edge computing markets. It sells its products through direct sales force, distributors, value-added resellers, system integrators, and original equipment manufacturers. The company has operations primarily in the United States, Europe, Asia, and internationally. Super Micro Computer, Inc. was founded in 1993 and is headquartered in San Jose, California."
SMCI,2019-06-30,179907000,86802000,161000,71918000,218382000,495522000,97233000,97233000,-6690000,14884000,3500360000,3403127000,3004838000,-10431000,NA,71918000,71918000,NA,income_statement,Computer Hardware,"Super Micro Computer, Inc.","Super Micro Computer, Inc., together with its subsidiaries, develops and manufactures high-performance server and storage solutions based on modular and open architecture. Its solutions range from complete server, storage, modular blade servers, blades, workstations, full racks, networking devices, server management software, and server sub-systems, as well as support and services. The company also provides a range of application-optimized server solutions, including rackmount and blade servers, storage systems, and subsystems and accessories; and server software management solutions, such as Server Management Suite, including Supermicro Server Manager, Supermicro Power Management software, Supermicro Update Manager, and SuperDoctor 5. In addition, it offers server subsystems and accessories comprising server boards, chassis, power supplies, and other accessories. Further, the company provides server and storage system integration, configuration, and software upgrade and update services; and technical documentation services, as well as identifies service requirements, creates and executes project plans, and conducts verification testing and training services. Additionally, it offers help desk and on-site product support services for its server and storage systems; and customer support services, including ongoing maintenance and technical support for its products. The company provides its products to enterprise data centers, cloud computing, artificial intelligence, and 5G and edge computing markets. It sells its products through direct sales force, distributors, value-added resellers, system integrators, and original equipment manufacturers. The company has operations primarily in the United States, Europe, Asia, and internationally. Super Micro Computer, Inc. was founded in 1993 and is headquartered in San Jose, California."
SMCI,2020-06-30,221478000,87230000,167000,84308000,201578000,526210000,103154000,103154000,-2236000,2922000,3339281000,3236127000,2813071000,-15924000,NA,84308000,84308000,NA,income_statement,Computer Hardware,"Super Micro Computer, Inc.","Super Micro Computer, Inc., together with its subsidiaries, develops and manufactures high-performance server and storage solutions based on modular and open architecture. Its solutions range from complete server, storage, modular blade servers, blades, workstations, full racks, networking devices, server management software, and server sub-systems, as well as support and services. The company also provides a range of application-optimized server solutions, including rackmount and blade servers, storage systems, and subsystems and accessories; and server software management solutions, such as Server Management Suite, including Supermicro Server Manager, Supermicro Power Management software, Supermicro Update Manager, and SuperDoctor 5. In addition, it offers server subsystems and accessories comprising server boards, chassis, power supplies, and other accessories. Further, the company provides server and storage system integration, configuration, and software upgrade and update services; and technical documentation services, as well as identifies service requirements, creates and executes project plans, and conducts verification testing and training services. Additionally, it offers help desk and on-site product support services for its server and storage systems; and customer support services, including ongoing maintenance and technical support for its products. The company provides its products to enterprise data centers, cloud computing, artificial intelligence, and 5G and edge computing markets. It sells its products through direct sales force, distributors, value-added resellers, system integrators, and original equipment manufacturers. The company has operations primarily in the United States, Europe, Asia, and internationally. Super Micro Computer, Inc. was founded in 1993 and is headquartered in San Jose, California."
SMED,2017-06-30,NA,-1289000,NA,-1293000,11523000,11837000,-487000,-487000,-115000,4000,38188000,38675000,26351000,-802000,NA,-1293000,-1293000,NA,income_statement,Waste Management,Sharps Compliance Corp.,"Sharps Compliance Corp. provides medical, pharmaceutical, and hazardous waste management services in the United States. It offers Sharps Recovery System for the containment, transportation, treatment, and tracking of medical waste generated outside the hospital and health care facility settings; TakeAway Recovery System to treat used needles, syringes, and other used healthcare products; Route-Based Pickup Service, a medical and hazardous waste pick-up services; and MedSafe, a solution for the safe collection, transportation, and disposal of unwanted and expired ultimate-user medications. The company also provides TakeAway Medication Recovery System that facilitates the proper disposal of unused medications; Black Pail Program for Rx, a solution with minimal segregation for the disposal of various pharmaceuticals; Inhaler Disposal to collect, transport, and destroy used pharmaceutical inhalers; Hazardous Drug Spill Control Kit for the cleanup of chemotherapy and other HD spills; TakeAway Recycle System for the collection and recycling of single-use medical devices from surgical centers and other healthcare facilities; ComplianceTRAC, a Web-based compliance and training program; and Universal Waste Shipback Systems to collect, transport, and recycle light bulbs, batteries, and other mercury containing devices. In addition, it offers other solutions, such as TakeAway Environmental Return System, SharpsTracer, Sharps Secure, Needle Disposal System, Complete Needle Collection and Disposal System, Pitch-It IV Poles, Asset Return System, and Spill Kit Recovery System, as well as Sharps MWMS, a medical waste management system. The company serves customers in home health care, retail clinics and immunizing pharmacies, pharmaceutical manufacturers, professional offices, assisted living and long-term care facilities, and government agencies, as well as distributors. Sharps Compliance Corp. was founded in 1992 and is headquartered in Houston, Texas."
SMED,2018-06-30,NA,-651000,NA,-672000,11168000,11402000,-577000,-577000,-94000,21000,40141000,40718000,28739000,-74000,NA,-672000,-672000,NA,income_statement,Waste Management,Sharps Compliance Corp.,"Sharps Compliance Corp. provides medical, pharmaceutical, and hazardous waste management services in the United States. It offers Sharps Recovery System for the containment, transportation, treatment, and tracking of medical waste generated outside the hospital and health care facility settings; TakeAway Recovery System to treat used needles, syringes, and other used healthcare products; Route-Based Pickup Service, a medical and hazardous waste pick-up services; and MedSafe, a solution for the safe collection, transportation, and disposal of unwanted and expired ultimate-user medications. The company also provides TakeAway Medication Recovery System that facilitates the proper disposal of unused medications; Black Pail Program for Rx, a solution with minimal segregation for the disposal of various pharmaceuticals; Inhaler Disposal to collect, transport, and destroy used pharmaceutical inhalers; Hazardous Drug Spill Control Kit for the cleanup of chemotherapy and other HD spills; TakeAway Recycle System for the collection and recycling of single-use medical devices from surgical centers and other healthcare facilities; ComplianceTRAC, a Web-based compliance and training program; and Universal Waste Shipback Systems to collect, transport, and recycle light bulbs, batteries, and other mercury containing devices. In addition, it offers other solutions, such as TakeAway Environmental Return System, SharpsTracer, Sharps Secure, Needle Disposal System, Complete Needle Collection and Disposal System, Pitch-It IV Poles, Asset Return System, and Spill Kit Recovery System, as well as Sharps MWMS, a medical waste management system. The company serves customers in home health care, retail clinics and immunizing pharmacies, pharmaceutical manufacturers, professional offices, assisted living and long-term care facilities, and government agencies, as well as distributors. Sharps Compliance Corp. was founded in 1992 and is headquartered in Houston, Texas."
SMED,2019-06-30,NA,384000,NA,214000,12003000,13270000,447000,447000,-87000,170000,44312000,43865000,31042000,-63000,NA,214000,214000,NA,income_statement,Waste Management,Sharps Compliance Corp.,"Sharps Compliance Corp. provides medical, pharmaceutical, and hazardous waste management services in the United States. It offers Sharps Recovery System for the containment, transportation, treatment, and tracking of medical waste generated outside the hospital and health care facility settings; TakeAway Recovery System to treat used needles, syringes, and other used healthcare products; Route-Based Pickup Service, a medical and hazardous waste pick-up services; and MedSafe, a solution for the safe collection, transportation, and disposal of unwanted and expired ultimate-user medications. The company also provides TakeAway Medication Recovery System that facilitates the proper disposal of unused medications; Black Pail Program for Rx, a solution with minimal segregation for the disposal of various pharmaceuticals; Inhaler Disposal to collect, transport, and destroy used pharmaceutical inhalers; Hazardous Drug Spill Control Kit for the cleanup of chemotherapy and other HD spills; TakeAway Recycle System for the collection and recycling of single-use medical devices from surgical centers and other healthcare facilities; ComplianceTRAC, a Web-based compliance and training program; and Universal Waste Shipback Systems to collect, transport, and recycle light bulbs, batteries, and other mercury containing devices. In addition, it offers other solutions, such as TakeAway Environmental Return System, SharpsTracer, Sharps Secure, Needle Disposal System, Complete Needle Collection and Disposal System, Pitch-It IV Poles, Asset Return System, and Spill Kit Recovery System, as well as Sharps MWMS, a medical waste management system. The company serves customers in home health care, retail clinics and immunizing pharmacies, pharmaceutical manufacturers, professional offices, assisted living and long-term care facilities, and government agencies, as well as distributors. Sharps Compliance Corp. was founded in 1992 and is headquartered in Houston, Texas."
SMED,2020-06-30,NA,684000,NA,2266000,14046000,15762000,910000,910000,-127000,-1582000,51146000,50236000,35384000,-226000,NA,2266000,2266000,NA,income_statement,Waste Management,Sharps Compliance Corp.,"Sharps Compliance Corp. provides medical, pharmaceutical, and hazardous waste management services in the United States. It offers Sharps Recovery System for the containment, transportation, treatment, and tracking of medical waste generated outside the hospital and health care facility settings; TakeAway Recovery System to treat used needles, syringes, and other used healthcare products; Route-Based Pickup Service, a medical and hazardous waste pick-up services; and MedSafe, a solution for the safe collection, transportation, and disposal of unwanted and expired ultimate-user medications. The company also provides TakeAway Medication Recovery System that facilitates the proper disposal of unused medications; Black Pail Program for Rx, a solution with minimal segregation for the disposal of various pharmaceuticals; Inhaler Disposal to collect, transport, and destroy used pharmaceutical inhalers; Hazardous Drug Spill Control Kit for the cleanup of chemotherapy and other HD spills; TakeAway Recycle System for the collection and recycling of single-use medical devices from surgical centers and other healthcare facilities; ComplianceTRAC, a Web-based compliance and training program; and Universal Waste Shipback Systems to collect, transport, and recycle light bulbs, batteries, and other mercury containing devices. In addition, it offers other solutions, such as TakeAway Environmental Return System, SharpsTracer, Sharps Secure, Needle Disposal System, Complete Needle Collection and Disposal System, Pitch-It IV Poles, Asset Return System, and Spill Kit Recovery System, as well as Sharps MWMS, a medical waste management system. The company serves customers in home health care, retail clinics and immunizing pharmacies, pharmaceutical manufacturers, professional offices, assisted living and long-term care facilities, and government agencies, as well as distributors. Sharps Compliance Corp. was founded in 1992 and is headquartered in Houston, Texas."
SMID,2016-12-31,NA,4297000,NA,2835000,6013000,10349000,4336000,4336000,-162000,1462000,40050000,35714000,29701000,-39000,NA,2835000,2835000,NA,income_statement,Building Materials,Smith-Midland Corporation,"Smith-Midland Corporation, through its subsidiaries, invents, develops, manufactures, markets, leases, licenses, sells, and installs precast concrete products primarily for use in the construction, highway, utilities, and farming industries. It offers SlenderWall, a lightweight construction panels for the exterior walls of building; Sierra Wall that provides sound and sight barrier for use alongside highways around residential, industrial, and commercial properties; J-J Hooks highway safety barriers for use on roadways to separate lanes of traffic in construction work zone or traffic control purposes; and Easi-Set precast building and Easi-Span expandable precast buildings for use in housing communications operations, traffic control systems, and mechanical and electrical stations. The company also provides Easi-Set utility vaults for house equipment, such as cable, telephone, or traffic signal equipment, and for underground storage, as well as custom-built utility vaults for special needs; SoftSound soundwall panels to absorb highway noise; Beach Prisms, an erosion control modules for seawalls and jetties; and H2Out secondary drainage systems for panelized exterior cladding. In addition, it offers licenses its proprietary products and non-proprietary products in the United States, Canada, Belgium, New Zealand, Australia, Mexico, Trinidad, Spain, and Chile. It markets its products through in-house sales force, independent sales representatives, and direct mail to contractors performing public and private construction contracts, such as the public and private roads and highways, and airports; municipal utilities; and federal, state, and local transportation authorities. Smith-Midland Corporation was founded in 1960 and is based in Midland, Virginia."
SMID,2017-12-31,NA,3741000,NA,2684000,7749000,11464000,3715000,3715000,-184000,1057000,41717000,38002000,30253000,26000,NA,2684000,2684000,NA,income_statement,Building Materials,Smith-Midland Corporation,"Smith-Midland Corporation, through its subsidiaries, invents, develops, manufactures, markets, leases, licenses, sells, and installs precast concrete products primarily for use in the construction, highway, utilities, and farming industries. It offers SlenderWall, a lightweight construction panels for the exterior walls of building; Sierra Wall that provides sound and sight barrier for use alongside highways around residential, industrial, and commercial properties; J-J Hooks highway safety barriers for use on roadways to separate lanes of traffic in construction work zone or traffic control purposes; and Easi-Set precast building and Easi-Span expandable precast buildings for use in housing communications operations, traffic control systems, and mechanical and electrical stations. The company also provides Easi-Set utility vaults for house equipment, such as cable, telephone, or traffic signal equipment, and for underground storage, as well as custom-built utility vaults for special needs; SoftSound soundwall panels to absorb highway noise; Beach Prisms, an erosion control modules for seawalls and jetties; and H2Out secondary drainage systems for panelized exterior cladding. In addition, it offers licenses its proprietary products and non-proprietary products in the United States, Canada, Belgium, New Zealand, Australia, Mexico, Trinidad, Spain, and Chile. It markets its products through in-house sales force, independent sales representatives, and direct mail to contractors performing public and private construction contracts, such as the public and private roads and highways, and airports; municipal utilities; and federal, state, and local transportation authorities. Smith-Midland Corporation was founded in 1960 and is based in Midland, Virginia."
SMID,2018-12-31,NA,2259000,NA,1687000,8274000,10490000,2216000,2216000,-176000,572000,40220000,38004000,29730000,43000,NA,1687000,1687000,NA,income_statement,Building Materials,Smith-Midland Corporation,"Smith-Midland Corporation, through its subsidiaries, invents, develops, manufactures, markets, leases, licenses, sells, and installs precast concrete products primarily for use in the construction, highway, utilities, and farming industries. It offers SlenderWall, a lightweight construction panels for the exterior walls of building; Sierra Wall that provides sound and sight barrier for use alongside highways around residential, industrial, and commercial properties; J-J Hooks highway safety barriers for use on roadways to separate lanes of traffic in construction work zone or traffic control purposes; and Easi-Set precast building and Easi-Span expandable precast buildings for use in housing communications operations, traffic control systems, and mechanical and electrical stations. The company also provides Easi-Set utility vaults for house equipment, such as cable, telephone, or traffic signal equipment, and for underground storage, as well as custom-built utility vaults for special needs; SoftSound soundwall panels to absorb highway noise; Beach Prisms, an erosion control modules for seawalls and jetties; and H2Out secondary drainage systems for panelized exterior cladding. In addition, it offers licenses its proprietary products and non-proprietary products in the United States, Canada, Belgium, New Zealand, Australia, Mexico, Trinidad, Spain, and Chile. It markets its products through in-house sales force, independent sales representatives, and direct mail to contractors performing public and private construction contracts, such as the public and private roads and highways, and airports; municipal utilities; and federal, state, and local transportation authorities. Smith-Midland Corporation was founded in 1960 and is based in Midland, Virginia."
SMID,2019-12-31,NA,2508000,NA,1959000,7423000,9969000,2546000,2546000,-179000,549000,46691000,44145000,36722000,-38000,NA,1959000,1959000,NA,income_statement,Building Materials,Smith-Midland Corporation,"Smith-Midland Corporation, through its subsidiaries, invents, develops, manufactures, markets, leases, licenses, sells, and installs precast concrete products primarily for use in the construction, highway, utilities, and farming industries. It offers SlenderWall, a lightweight construction panels for the exterior walls of building; Sierra Wall that provides sound and sight barrier for use alongside highways around residential, industrial, and commercial properties; J-J Hooks highway safety barriers for use on roadways to separate lanes of traffic in construction work zone or traffic control purposes; and Easi-Set precast building and Easi-Span expandable precast buildings for use in housing communications operations, traffic control systems, and mechanical and electrical stations. The company also provides Easi-Set utility vaults for house equipment, such as cable, telephone, or traffic signal equipment, and for underground storage, as well as custom-built utility vaults for special needs; SoftSound soundwall panels to absorb highway noise; Beach Prisms, an erosion control modules for seawalls and jetties; and H2Out secondary drainage systems for panelized exterior cladding. In addition, it offers licenses its proprietary products and non-proprietary products in the United States, Canada, Belgium, New Zealand, Australia, Mexico, Trinidad, Spain, and Chile. It markets its products through in-house sales force, independent sales representatives, and direct mail to contractors performing public and private construction contracts, such as the public and private roads and highways, and airports; municipal utilities; and federal, state, and local transportation authorities. Smith-Midland Corporation was founded in 1960 and is based in Midland, Virginia."
SMIT,2017-05-31,256164,-1045355,NA,-1073364,5618327,4885807,-988684,-988684,-2982,28009,12397643,13386327,7511836,-56671,257442,-1073364,-1073364,NA,income_statement,Scientific & Technical Instruments,"Schmitt Industries, Inc.","Schmitt Industries, Inc., together with its subsidiaries, designs, manufactures, and sells test and measurement products worldwide. The company's Balancer segment offers computer-controlled vibration detection, balancing, and process control systems. Its products comprise SB-5500, an optional acoustic emission monitoring system (AEMS) control card to monitor the AE signals generated on the grinding machine; process control cards to provide enhanced control of the grinding process; SB-2000, a compact manual balancing system; and AE-1000, an AE control platform, which reduces air machine grinding time under the Schmitt Dynamic Balance System brand name. This segment sells its products to end user operators, as well as manufacturers of grinding machines for automotive, industrial, aerospace, and medical industries through independent manufacturers' representatives and distributors. Its Measurement segment provides laser and confocal chromatic white light sensors for distance, measurement, and dimensional sizing products under the Acuity brand name for various application, including manufacturing, lumber production, steel casting, glass and paper production, medical imaging, crane control and micron-level part, and surface inspection; and ultrasonic measurement products that measure the levels of liquid tanks and transmit that data through satellite to a secure Website for display, as well as remote tank monitoring products under the Xact brand name. Schmitt Industries, Inc. was founded in 1984 and is based in Portland, Oregon."
SMIT,2018-05-31,327317,236554,NA,210639,5582625,6065314,155372,155372,-1401,25915,13888063,13732691,7822749,81182,257442,210639,210639,NA,income_statement,Scientific & Technical Instruments,"Schmitt Industries, Inc.","Schmitt Industries, Inc., together with its subsidiaries, designs, manufactures, and sells test and measurement products worldwide. The company's Balancer segment offers computer-controlled vibration detection, balancing, and process control systems. Its products comprise SB-5500, an optional acoustic emission monitoring system (AEMS) control card to monitor the AE signals generated on the grinding machine; process control cards to provide enhanced control of the grinding process; SB-2000, a compact manual balancing system; and AE-1000, an AE control platform, which reduces air machine grinding time under the Schmitt Dynamic Balance System brand name. This segment sells its products to end user operators, as well as manufacturers of grinding machines for automotive, industrial, aerospace, and medical industries through independent manufacturers' representatives and distributors. Its Measurement segment provides laser and confocal chromatic white light sensors for distance, measurement, and dimensional sizing products under the Acuity brand name for various application, including manufacturing, lumber production, steel casting, glass and paper production, medical imaging, crane control and micron-level part, and surface inspection; and ultrasonic measurement products that measure the levels of liquid tanks and transmit that data through satellite to a secure Website for display, as well as remote tank monitoring products under the Xact brand name. Schmitt Industries, Inc. was founded in 1984 and is based in Portland, Oregon."
SMIT,2019-05-31,56833,-1459649,NA,-1210990,3180497,1768762,-1468568,-1468568,-12160,8783,4729442,6198010,2960680,8919,257442,-1468432,-1210990,NA,income_statement,Scientific & Technical Instruments,"Schmitt Industries, Inc.","Schmitt Industries, Inc., together with its subsidiaries, designs, manufactures, and sells test and measurement products worldwide. The company's Balancer segment offers computer-controlled vibration detection, balancing, and process control systems. Its products comprise SB-5500, an optional acoustic emission monitoring system (AEMS) control card to monitor the AE signals generated on the grinding machine; process control cards to provide enhanced control of the grinding process; SB-2000, a compact manual balancing system; and AE-1000, an AE control platform, which reduces air machine grinding time under the Schmitt Dynamic Balance System brand name. This segment sells its products to end user operators, as well as manufacturers of grinding machines for automotive, industrial, aerospace, and medical industries through independent manufacturers' representatives and distributors. Its Measurement segment provides laser and confocal chromatic white light sensors for distance, measurement, and dimensional sizing products under the Acuity brand name for various application, including manufacturing, lumber production, steel casting, glass and paper production, medical imaging, crane control and micron-level part, and surface inspection; and ultrasonic measurement products that measure the levels of liquid tanks and transmit that data through satellite to a secure Website for display, as well as remote tank monitoring products under the Xact brand name. Schmitt Industries, Inc. was founded in 1984 and is based in Portland, Oregon."
SMIT,2020-05-31,68849,-1856942,NA,3880575,4061621,1950548,-2179922,-2179922,-2435,-14638,4189924,6369846,2239376,322980,5722879,-1842304,3880575,NA,income_statement,Scientific & Technical Instruments,"Schmitt Industries, Inc.","Schmitt Industries, Inc., together with its subsidiaries, designs, manufactures, and sells test and measurement products worldwide. The company's Balancer segment offers computer-controlled vibration detection, balancing, and process control systems. Its products comprise SB-5500, an optional acoustic emission monitoring system (AEMS) control card to monitor the AE signals generated on the grinding machine; process control cards to provide enhanced control of the grinding process; SB-2000, a compact manual balancing system; and AE-1000, an AE control platform, which reduces air machine grinding time under the Schmitt Dynamic Balance System brand name. This segment sells its products to end user operators, as well as manufacturers of grinding machines for automotive, industrial, aerospace, and medical industries through independent manufacturers' representatives and distributors. Its Measurement segment provides laser and confocal chromatic white light sensors for distance, measurement, and dimensional sizing products under the Acuity brand name for various application, including manufacturing, lumber production, steel casting, glass and paper production, medical imaging, crane control and micron-level part, and surface inspection; and ultrasonic measurement products that measure the levels of liquid tanks and transmit that data through satellite to a secure Website for display, as well as remote tank monitoring products under the Xact brand name. Schmitt Industries, Inc. was founded in 1984 and is based in Portland, Oregon."
SMMF,2017-12-31,NA,21579000,NA,11915000,33985000,79324000,0,36882000,NA,9664000,79324000,42442000,0,-15303000,NA,11915000,11915000,8457000,income_statement,Banks—Regional,"Summit Financial Group, Inc.","Summit Financial Group, Inc. operates as a financial holding company for Summit Community Bank, Inc. that provides community banking and other financial services to individuals and businesses primarily in the Eastern Panhandle, Southern and North Central regions of West Virginia and the Northern, and Shenandoah Valley and Southwestern regions of Virginia. The company's community banking services include demand, savings, and time deposits; commercial, commercial real estate, construction and land development, residential real estate, and consumer loans; and mortgage warehouse lines of credit, as well as trust and wealth management, and cash management services. As of December 31, 2019, it operated through 32 banking offices. The company was founded in 1987 and is headquartered in Moorefield, West Virginia."
SMMF,2018-12-31,NA,35096000,NA,28072000,37514000,84969000,0,39091000,NA,7024000,84969000,45878000,0,-3995000,NA,28072000,28072000,8364000,income_statement,Banks—Regional,"Summit Financial Group, Inc.","Summit Financial Group, Inc. operates as a financial holding company for Summit Community Bank, Inc. that provides community banking and other financial services to individuals and businesses primarily in the Eastern Panhandle, Southern and North Central regions of West Virginia and the Northern, and Shenandoah Valley and Southwestern regions of Virginia. The company's community banking services include demand, savings, and time deposits; commercial, commercial real estate, construction and land development, residential real estate, and consumer loans; and mortgage warehouse lines of credit, as well as trust and wealth management, and cash management services. As of December 31, 2019, it operated through 32 banking offices. The company was founded in 1987 and is headquartered in Moorefield, West Virginia."
SMMF,2019-12-31,NA,39583000,NA,31866000,39831000,92831000,0,42581000,NA,7717000,92831000,50250000,0,-2998000,NA,31866000,31866000,10419000,income_statement,Banks—Regional,"Summit Financial Group, Inc.","Summit Financial Group, Inc. operates as a financial holding company for Summit Community Bank, Inc. that provides community banking and other financial services to individuals and businesses primarily in the Eastern Panhandle, Southern and North Central regions of West Virginia and the Northern, and Shenandoah Valley and Southwestern regions of Virginia. The company's community banking services include demand, savings, and time deposits; commercial, commercial real estate, construction and land development, residential real estate, and consumer loans; and mortgage warehouse lines of credit, as well as trust and wealth management, and cash management services. As of December 31, 2019, it operated through 32 banking offices. The company was founded in 1987 and is headquartered in Moorefield, West Virginia."
SMMF,2020-12-31,NA,38754000,NA,31326000,44073000,101065000,0,45430000,NA,7428000,101065000,55635000,0,-6676000,NA,31326000,31326000,11562000,income_statement,Banks—Regional,"Summit Financial Group, Inc.","Summit Financial Group, Inc. operates as a financial holding company for Summit Community Bank, Inc. that provides community banking and other financial services to individuals and businesses primarily in the Eastern Panhandle, Southern and North Central regions of West Virginia and the Northern, and Shenandoah Valley and Southwestern regions of Virginia. The company's community banking services include demand, savings, and time deposits; commercial, commercial real estate, construction and land development, residential real estate, and consumer loans; and mortgage warehouse lines of credit, as well as trust and wealth management, and cash management services. As of December 31, 2019, it operated through 32 banking offices. The company was founded in 1987 and is headquartered in Moorefield, West Virginia."
SMMT,2017-01-31,18952000,-25707000,NA,-21371000,8277000,2376000,-24853000,-24853000,-23000,-4336000,2376000,27229000,0,-854000,NA,-21371000,-21371000,-9000,income_statement,Biotechnology,Summit Therapeutics Inc.,"Summit Therapeutics Inc., a biopharmaceutical company, discovers, develops, and commercializes medicines to treat infectious diseases in the United States, Latin America, and Europe. It conducts clinical programs focusing on the Clostridium difficile infection (CDI). The company's lead product candidate is ridinilazole, an orally administered small molecule antibiotic that is in Phase III clinical trials for the treatment of CDI. It also develops DDS-01 series to treat infection caused by the bacteria Neisseria gonorrhoeae through Discuva platform; and DDS-04 series to treat Enterobacteriaceae. Summit Therapeutics Inc. was founded in 2003 and is based in Cambridge, Massachusetts."
SMMT,2018-01-31,28970000,-23952000,NA,-20190000,11999000,14168000,-26792000,-26792000,-23000,-3762000,14168000,40960000,0,2840000,NA,-20190000,-20190000,-9000,income_statement,Biotechnology,Summit Therapeutics Inc.,"Summit Therapeutics Inc., a biopharmaceutical company, discovers, develops, and commercializes medicines to treat infectious diseases in the United States, Latin America, and Europe. It conducts clinical programs focusing on the Clostridium difficile infection (CDI). The company's lead product candidate is ridinilazole, an orally administered small molecule antibiotic that is in Phase III clinical trials for the treatment of CDI. It also develops DDS-01 series to treat infection caused by the bacteria Neisseria gonorrhoeae through Discuva platform; and DDS-04 series to treat Enterobacteriaceae. Summit Therapeutics Inc. was founded in 2003 and is based in Cambridge, Massachusetts."
SMMT,2019-01-31,39174000,5031000,NA,7527000,11588000,57623000,6867000,6867000,-43000,-2496000,57623000,50756000,0,-1836000,NA,7527000,7527000,-6000,income_statement,Biotechnology,Summit Therapeutics Inc.,"Summit Therapeutics Inc., a biopharmaceutical company, discovers, develops, and commercializes medicines to treat infectious diseases in the United States, Latin America, and Europe. It conducts clinical programs focusing on the Clostridium difficile infection (CDI). The company's lead product candidate is ridinilazole, an orally administered small molecule antibiotic that is in Phase III clinical trials for the treatment of CDI. It also develops DDS-01 series to treat infection caused by the bacteria Neisseria gonorrhoeae through Discuva platform; and DDS-04 series to treat Enterobacteriaceae. Summit Therapeutics Inc. was founded in 2003 and is based in Cambridge, Massachusetts."
SMMT,2019-12-31,34037452,-27879270,NA,-24034907,10774908,17177453,-27634907,-27634907,-32727,-3844363,17177453,44812360,0,-244364,NA,-24034907,-24034907,NA,income_statement,Biotechnology,Summit Therapeutics Inc.,"Summit Therapeutics Inc., a biopharmaceutical company, discovers, develops, and commercializes medicines to treat infectious diseases in the United States, Latin America, and Europe. It conducts clinical programs focusing on the Clostridium difficile infection (CDI). The company's lead product candidate is ridinilazole, an orally administered small molecule antibiotic that is in Phase III clinical trials for the treatment of CDI. It also develops DDS-01 series to treat infection caused by the bacteria Neisseria gonorrhoeae through Discuva platform; and DDS-04 series to treat Enterobacteriaceae. Summit Therapeutics Inc. was founded in 2003 and is based in Cambridge, Massachusetts."
SMPL,2017-08-26,NA,2825000,NA,-2035000,95967000,162550000,57189000,57189000,-24386000,4860000,396171000,338982000,233621000,-54364000,NA,-2035000,450000,NA,income_statement,Packaged Foods,The Simply Good Foods Company,"The Simply Good Foods Company operates as a consumer packaged food and beverage company in North America and internationally. The company develops, markets, and sells snacks and meal replacements. It offers primarily nutrition bars, ready-to-drink (RTD) shakes, sweet and salty snacks, protein bars, cookies, pizza, protein chips, recipes, and confectionery products, as well as licensed frozen meals under the Atkins, Atkins Endulge, and Quest brand names. The company distributes its products to various retail channels, such as mass merchandise, grocery and drug channels, club stores, convenience stores, gas stations, and other channels. It also sells its products through e-commerce channels, including atkins.com, questnutrition.com, and amazon.com. The Simply Good Foods Company is headquartered in Denver, Colorado."
SMPL,2018-08-25,NA,53091000,NA,70455000,108727000,180366000,64141000,64141000,-12551000,-17364000,431429000,367288000,251063000,-11050000,NA,70455000,70455000,NA,income_statement,Packaged Foods,The Simply Good Foods Company,"The Simply Good Foods Company operates as a consumer packaged food and beverage company in North America and internationally. The company develops, markets, and sells snacks and meal replacements. It offers primarily nutrition bars, ready-to-drink (RTD) shakes, sweet and salty snacks, protein bars, cookies, pizza, protein chips, recipes, and confectionery products, as well as licensed frozen meals under the Atkins, Atkins Endulge, and Quest brand names. The company distributes its products to various retail channels, such as mass merchandise, grocery and drug channels, club stores, convenience stores, gas stations, and other channels. It also sells its products through e-commerce channels, including atkins.com, questnutrition.com, and amazon.com. The Simply Good Foods Company is headquartered in Denver, Colorado."
SMPL,2019-08-31,NA,64286000,NA,47536000,125960000,217405000,83949000,83949000,-13627000,16750000,523383000,439434000,305978000,-19663000,NA,47536000,47536000,NA,income_statement,Packaged Foods,The Simply Good Foods Company,"The Simply Good Foods Company operates as a consumer packaged food and beverage company in North America and internationally. The company develops, markets, and sells snacks and meal replacements. It offers primarily nutrition bars, ready-to-drink (RTD) shakes, sweet and salty snacks, protein bars, cookies, pizza, protein chips, recipes, and confectionery products, as well as licensed frozen meals under the Atkins, Atkins Endulge, and Quest brand names. The company distributes its products to various retail channels, such as mass merchandise, grocery and drug channels, club stores, convenience stores, gas stations, and other channels. It also sells its products through e-commerce channels, including atkins.com, questnutrition.com, and amazon.com. The Simply Good Foods Company is headquartered in Denver, Colorado."
SMPL,2020-08-29,NA,48026000,NA,34700000,184451000,331850000,132140000,132140000,-32813000,13326000,816641000,684501000,484791000,-84114000,NA,34700000,34700000,NA,income_statement,Packaged Foods,The Simply Good Foods Company,"The Simply Good Foods Company operates as a consumer packaged food and beverage company in North America and internationally. The company develops, markets, and sells snacks and meal replacements. It offers primarily nutrition bars, ready-to-drink (RTD) shakes, sweet and salty snacks, protein bars, cookies, pizza, protein chips, recipes, and confectionery products, as well as licensed frozen meals under the Atkins, Atkins Endulge, and Quest brand names. The company distributes its products to various retail channels, such as mass merchandise, grocery and drug channels, club stores, convenience stores, gas stations, and other channels. It also sells its products through e-commerce channels, including atkins.com, questnutrition.com, and amazon.com. The Simply Good Foods Company is headquartered in Denver, Colorado."
SMSI,2016-12-31,15906000,-15572000,NA,-15343000,19556000,20671000,-14791000,-14791000,-313000,-229000,28235000,43026000,7564000,-781000,NA,-15343000,-15343000,NA,income_statement,Software—Application,"Smith Micro Software, Inc.","Smith Micro Software, Inc. develops and sells software to enhance the mobile experience to wireless and cable service providers worldwide. The company provides SafePath Family, a platform that provides family real time location, protection, and parental control services; and SafePath Internet of Things, a platform that enables mobile service providers to deliver a connected digital life experience through child and elderly wearable locators, pet trackers, car trackers, and connected home security devices. It also offers SafePath Home, a cloud managed platform that extends to connected devices in the home through a router agent that integrates with 5G modems and broadband routers to enable parental controls and remote monitoring; and CommSuite that allows users to manage voice messages, as well as voice-to-text transcription messaging. In addition, the company provides ViewSpot, a retail display management platform that provides on-screen and interactive demos to wireless carriers and retailers, as well as offers analytical capabilities; and technical support and customer services. Smith Micro Software, Inc. was founded in 1982 and is headquartered in Pittsburgh, Pennsylvania."
SMSI,2017-12-31,8952000,-7207000,NA,-6661000,14737000,17892000,-5797000,-5797000,-1120000,-546000,22974000,28771000,5082000,-1410000,NA,-6661000,-6661000,NA,income_statement,Software—Application,"Smith Micro Software, Inc.","Smith Micro Software, Inc. develops and sells software to enhance the mobile experience to wireless and cable service providers worldwide. The company provides SafePath Family, a platform that provides family real time location, protection, and parental control services; and SafePath Internet of Things, a platform that enables mobile service providers to deliver a connected digital life experience through child and elderly wearable locators, pet trackers, car trackers, and connected home security devices. It also offers SafePath Home, a cloud managed platform that extends to connected devices in the home through a router agent that integrates with 5G modems and broadband routers to enable parental controls and remote monitoring; and CommSuite that allows users to manage voice messages, as well as voice-to-text transcription messaging. In addition, the company provides ViewSpot, a retail display management platform that provides on-screen and interactive demos to wireless carriers and retailers, as well as offers analytical capabilities; and technical support and customer services. Smith Micro Software, Inc. was founded in 1982 and is headquartered in Pittsburgh, Pennsylvania."
SMSI,2018-12-31,8602000,-2727000,NA,-2740000,14391000,21952000,-1041000,-1041000,-472000,13000,26285000,27326000,4333000,-1686000,NA,-2740000,-3144000,NA,income_statement,Software—Application,"Smith Micro Software, Inc.","Smith Micro Software, Inc. develops and sells software to enhance the mobile experience to wireless and cable service providers worldwide. The company provides SafePath Family, a platform that provides family real time location, protection, and parental control services; and SafePath Internet of Things, a platform that enables mobile service providers to deliver a connected digital life experience through child and elderly wearable locators, pet trackers, car trackers, and connected home security devices. It also offers SafePath Home, a cloud managed platform that extends to connected devices in the home through a router agent that integrates with 5G modems and broadband routers to enable parental controls and remote monitoring; and CommSuite that allows users to manage voice messages, as well as voice-to-text transcription messaging. In addition, the company provides ViewSpot, a retail display management platform that provides on-screen and interactive demos to wireless carriers and retailers, as well as offers analytical capabilities; and technical support and customer services. Smith Micro Software, Inc. was founded in 1982 and is headquartered in Pittsburgh, Pennsylvania."
SMSI,2019-12-31,11682000,10802000,NA,10722000,17438000,39419000,10299000,10299000,NA,80000,43346000,33047000,3927000,503000,NA,10722000,10603000,NA,income_statement,Software—Application,"Smith Micro Software, Inc.","Smith Micro Software, Inc. develops and sells software to enhance the mobile experience to wireless and cable service providers worldwide. The company provides SafePath Family, a platform that provides family real time location, protection, and parental control services; and SafePath Internet of Things, a platform that enables mobile service providers to deliver a connected digital life experience through child and elderly wearable locators, pet trackers, car trackers, and connected home security devices. It also offers SafePath Home, a cloud managed platform that extends to connected devices in the home through a router agent that integrates with 5G modems and broadband routers to enable parental controls and remote monitoring; and CommSuite that allows users to manage voice messages, as well as voice-to-text transcription messaging. In addition, the company provides ViewSpot, a retail display management platform that provides on-screen and interactive demos to wireless carriers and retailers, as well as offers analytical capabilities; and technical support and customer services. Smith Micro Software, Inc. was founded in 1982 and is headquartered in Pittsburgh, Pennsylvania."
SMTC,2017-01-29,102500000,73060000,246000,54661000,136426000,324862000,60635000,60635000,-9300000,18399000,544272000,483637000,219410000,12425000,NA,54661000,54661000,NA,income_statement,Semiconductors,Semtech Corporation,"Semtech Corporation designs, develops, manufactures, and markets analog and mixed-signal semiconductor products and advanced algorithms. The company provides signal integrity products, including a portfolio of optical data communications and video transport products used in various enterprise computing, communications, and industrial applications; a portfolio of integrated circuits for data centers, enterprise networks, passive optical networks, wireless base station optical transceivers, and high-speed interface applications; and video products for broadcast applications, as well as video-over-IP technology for professional audio video applications. It also offers protection products, such as filter and termination devices that are integrated with the transient voltage suppressor devices, which protect electronic systems from voltage spikes; and wireless and sensing products comprising a portfolio of specialized radio frequency products used in various industrial, medical, and communications applications, as well as specialized sensing products used in industrial and consumer applications. In addition, the company provides power products consisting of switching voltage regulators, combination switching and linear regulators, smart regulators, isolated switches, and wireless charging that control, alter, regulate, and condition the power within electronic systems. It serves original equipment manufacturers and their suppliers in the enterprise computing, communications, and consumer and industrial end-markets. The company sells its products directly, as well as through independent sales representative firms and independent distributors in the United States, Europe, and Asia. Semtech Corporation was founded in 1960 and is headquartered in Camarillo, California."
SMTC,2018-01-28,105070000,57502000,246000,34649000,140245000,351971000,78789000,78789000,-7963000,22853000,587847000,509058000,235876000,-21287000,NA,34649000,34649000,NA,income_statement,Semiconductors,Semtech Corporation,"Semtech Corporation designs, develops, manufactures, and markets analog and mixed-signal semiconductor products and advanced algorithms. The company provides signal integrity products, including a portfolio of optical data communications and video transport products used in various enterprise computing, communications, and industrial applications; a portfolio of integrated circuits for data centers, enterprise networks, passive optical networks, wireless base station optical transceivers, and high-speed interface applications; and video products for broadcast applications, as well as video-over-IP technology for professional audio video applications. It also offers protection products, such as filter and termination devices that are integrated with the transient voltage suppressor devices, which protect electronic systems from voltage spikes; and wireless and sensing products comprising a portfolio of specialized radio frequency products used in various industrial, medical, and communications applications, as well as specialized sensing products used in industrial and consumer applications. In addition, the company provides power products consisting of switching voltage regulators, combination switching and linear regulators, smart regulators, isolated switches, and wireless charging that control, alter, regulate, and condition the power within electronic systems. It serves original equipment manufacturers and their suppliers in the enterprise computing, communications, and consumer and industrial end-markets. The company sells its products directly, as well as through independent sales representative firms and independent distributors in the United States, Europe, and Asia. Semtech Corporation was founded in 1960 and is headquartered in Camarillo, California."
SMTC,2019-01-27,109047000,69994000,246000,69639000,152551000,377022000,88775000,88775000,-9202000,355000,627196000,538421000,250174000,-18781000,NA,69639000,69639000,NA,income_statement,Semiconductors,Semtech Corporation,"Semtech Corporation designs, develops, manufactures, and markets analog and mixed-signal semiconductor products and advanced algorithms. The company provides signal integrity products, including a portfolio of optical data communications and video transport products used in various enterprise computing, communications, and industrial applications; a portfolio of integrated circuits for data centers, enterprise networks, passive optical networks, wireless base station optical transceivers, and high-speed interface applications; and video products for broadcast applications, as well as video-over-IP technology for professional audio video applications. It also offers protection products, such as filter and termination devices that are integrated with the transient voltage suppressor devices, which protect electronic systems from voltage spikes; and wireless and sensing products comprising a portfolio of specialized radio frequency products used in various industrial, medical, and communications applications, as well as specialized sensing products used in industrial and consumer applications. In addition, the company provides power products consisting of switching voltage regulators, combination switching and linear regulators, smart regulators, isolated switches, and wireless charging that control, alter, regulate, and condition the power within electronic systems. It serves original equipment manufacturers and their suppliers in the enterprise computing, communications, and consumer and industrial end-markets. The company sells its products directly, as well as through independent sales representative firms and independent distributors in the United States, Europe, and Asia. Semtech Corporation was founded in 1960 and is headquartered in Camarillo, California."
SMTC,2020-01-26,107368000,44694000,246000,31871000,161940000,336684000,50830000,50830000,-9106000,12828000,547512000,496682000,210828000,-6136000,NA,31866000,31871000,NA,income_statement,Semiconductors,Semtech Corporation,"Semtech Corporation designs, develops, manufactures, and markets analog and mixed-signal semiconductor products and advanced algorithms. The company provides signal integrity products, including a portfolio of optical data communications and video transport products used in various enterprise computing, communications, and industrial applications; a portfolio of integrated circuits for data centers, enterprise networks, passive optical networks, wireless base station optical transceivers, and high-speed interface applications; and video products for broadcast applications, as well as video-over-IP technology for professional audio video applications. It also offers protection products, such as filter and termination devices that are integrated with the transient voltage suppressor devices, which protect electronic systems from voltage spikes; and wireless and sensing products comprising a portfolio of specialized radio frequency products used in various industrial, medical, and communications applications, as well as specialized sensing products used in industrial and consumer applications. In addition, the company provides power products consisting of switching voltage regulators, combination switching and linear regulators, smart regulators, isolated switches, and wireless charging that control, alter, regulate, and condition the power within electronic systems. It serves original equipment manufacturers and their suppliers in the enterprise computing, communications, and consumer and industrial end-markets. The company sells its products directly, as well as through independent sales representative firms and independent distributors in the United States, Europe, and Asia. Semtech Corporation was founded in 1960 and is headquartered in Camarillo, California."
SMTI,2016-12-31,NA,-415747,-221690,-415747,3946124,4564274,546532,546532,-174493,0,5507853,4961321,943579,-962279,NA,-415747,-677463,NA,income_statement,Medical Care Facilities,Sanara MedTech Inc.,"Sanara MedTech Inc. develops, markets, and distributes wound and skin care products to physicians, hospitals, clinics, and post-acute care settings in the United States. The company offers CellerateRX Surgical Activated Collagen Adjuvant powder that helps in the natural wound healing process; BiakoÂ¯s Antimicrobial Skin & Wound Cleanser, a patented wound cleansing spray that disrupts extracellular polymeric substances to eradicate biofilm; and BiakoÂ¯s Antimicrobial Skin & Wound Irrigation Solution that works to irrigate and remove microbes from the wound bed to help eliminate planktonic, immature, and mature biofilms. It also provides BiakoÂ¯s Antimicrobial Wound Gel, a patented gel that synergistically disrupts extracellular polymeric substances to help eliminate biofilm microbes in the gel to help in wound healing; HYCOL Hydrolyzed Collagen, an additive free Type I bovine collagen that offers hydrolyzed collagen fragments to the wound bed that are a fraction of the size of native collagen; and PULSAR II Advanced Wound Irrigation Debridement System, a portable and no touch hydro-mechanical debridement system that removes bacteria and necrotic tissue without disrupting healthy tissue. The company was formerly known as WNDM Medical Inc. and changed its name to Sanara MedTech Inc. in May 2019. Sanara MedTech Inc. was incorporated in 2001 and is based in Fort Worth, Texas."
SMTI,2017-12-31,NA,331309,-221690,331309,5275402,5498703,120446,120446,-126825,0,6304741,6184295,806038,210863,NA,331309,192303,NA,income_statement,Medical Care Facilities,Sanara MedTech Inc.,"Sanara MedTech Inc. develops, markets, and distributes wound and skin care products to physicians, hospitals, clinics, and post-acute care settings in the United States. The company offers CellerateRX Surgical Activated Collagen Adjuvant powder that helps in the natural wound healing process; BiakoÂ¯s Antimicrobial Skin & Wound Cleanser, a patented wound cleansing spray that disrupts extracellular polymeric substances to eradicate biofilm; and BiakoÂ¯s Antimicrobial Skin & Wound Irrigation Solution that works to irrigate and remove microbes from the wound bed to help eliminate planktonic, immature, and mature biofilms. It also provides BiakoÂ¯s Antimicrobial Wound Gel, a patented gel that synergistically disrupts extracellular polymeric substances to help eliminate biofilm microbes in the gel to help in wound healing; HYCOL Hydrolyzed Collagen, an additive free Type I bovine collagen that offers hydrolyzed collagen fragments to the wound bed that are a fraction of the size of native collagen; and PULSAR II Advanced Wound Irrigation Debridement System, a portable and no touch hydro-mechanical debridement system that removes bacteria and necrotic tissue without disrupting healthy tissue. The company was formerly known as WNDM Medical Inc. and changed its name to Sanara MedTech Inc. in May 2019. Sanara MedTech Inc. was incorporated in 2001 and is based in Fort Worth, Texas."
SMTI,2018-12-31,NA,175464,-221690,175464,7646119,7927748,212135,212135,-60608,0,8779872,8567737,852124,-36671,NA,175464,7028,NA,income_statement,Medical Care Facilities,Sanara MedTech Inc.,"Sanara MedTech Inc. develops, markets, and distributes wound and skin care products to physicians, hospitals, clinics, and post-acute care settings in the United States. The company offers CellerateRX Surgical Activated Collagen Adjuvant powder that helps in the natural wound healing process; BiakoÂ¯s Antimicrobial Skin & Wound Cleanser, a patented wound cleansing spray that disrupts extracellular polymeric substances to eradicate biofilm; and BiakoÂ¯s Antimicrobial Skin & Wound Irrigation Solution that works to irrigate and remove microbes from the wound bed to help eliminate planktonic, immature, and mature biofilms. It also provides BiakoÂ¯s Antimicrobial Wound Gel, a patented gel that synergistically disrupts extracellular polymeric substances to help eliminate biofilm microbes in the gel to help in wound healing; HYCOL Hydrolyzed Collagen, an additive free Type I bovine collagen that offers hydrolyzed collagen fragments to the wound bed that are a fraction of the size of native collagen; and PULSAR II Advanced Wound Irrigation Debridement System, a portable and no touch hydro-mechanical debridement system that removes bacteria and necrotic tissue without disrupting healthy tissue. The company was formerly known as WNDM Medical Inc. and changed its name to Sanara MedTech Inc. in May 2019. Sanara MedTech Inc. was incorporated in 2001 and is based in Fort Worth, Texas."
SMTI,2019-12-31,NA,-2835778,-221690,-2814088,13067569,10557463,-2740057,-2740057,-105919,0,11766763,14506820,1209300,-95721,NA,-2835778,-2814088,NA,income_statement,Medical Care Facilities,Sanara MedTech Inc.,"Sanara MedTech Inc. develops, markets, and distributes wound and skin care products to physicians, hospitals, clinics, and post-acute care settings in the United States. The company offers CellerateRX Surgical Activated Collagen Adjuvant powder that helps in the natural wound healing process; BiakoÂ¯s Antimicrobial Skin & Wound Cleanser, a patented wound cleansing spray that disrupts extracellular polymeric substances to eradicate biofilm; and BiakoÂ¯s Antimicrobial Skin & Wound Irrigation Solution that works to irrigate and remove microbes from the wound bed to help eliminate planktonic, immature, and mature biofilms. It also provides BiakoÂ¯s Antimicrobial Wound Gel, a patented gel that synergistically disrupts extracellular polymeric substances to help eliminate biofilm microbes in the gel to help in wound healing; HYCOL Hydrolyzed Collagen, an additive free Type I bovine collagen that offers hydrolyzed collagen fragments to the wound bed that are a fraction of the size of native collagen; and PULSAR II Advanced Wound Irrigation Debridement System, a portable and no touch hydro-mechanical debridement system that removes bacteria and necrotic tissue without disrupting healthy tissue. The company was formerly known as WNDM Medical Inc. and changed its name to Sanara MedTech Inc. in May 2019. Sanara MedTech Inc. was incorporated in 2001 and is based in Fort Worth, Texas."
SMTX,2017-01-01,NA,55000,NA,-232000,14013000,15027000,1014000,1014000,-823000,287000,167868000,166854000,152841000,-959000,NA,-232000,-232000,NA,income_statement,Electronic Components,SMTC Corporation,"SMTC Corporation provides electronics manufacturing services in the United States, Canada, and Mexico. The company offers end-to-end electronics manufacturing services, including product design and engineering; printed circuit board assembly; production, enclosure, cable assembly, and precision metal fabrication; systems integration and testing; and configuration to order, build to order, and direct order fulfillment services. It provides integrated contract manufacturing services to original equipment manufacturer, technology companies, and governmental entities primarily in the test and measurement, retail and payment systems, telecom, networking and communications, medical and safety, industrial, power and clean technology, semiconductor, avionics, defense, and aerospace market sectors. SMTC Corporation was founded in 1985 and is headquartered in Markham, Canada."
SMTX,2017-12-31,NA,-7285000,NA,-7845000,13960000,10851000,-3109000,-3109000,-903000,560000,139231000,142340000,128380000,-4176000,NA,-7845000,-7845000,NA,income_statement,Electronic Components,SMTC Corporation,"SMTC Corporation provides electronics manufacturing services in the United States, Canada, and Mexico. The company offers end-to-end electronics manufacturing services, including product design and engineering; printed circuit board assembly; production, enclosure, cable assembly, and precision metal fabrication; systems integration and testing; and configuration to order, build to order, and direct order fulfillment services. It provides integrated contract manufacturing services to original equipment manufacturer, technology companies, and governmental entities primarily in the test and measurement, retail and payment systems, telecom, networking and communications, medical and safety, industrial, power and clean technology, semiconductor, avionics, defense, and aerospace market sectors. SMTC Corporation was founded in 1985 and is headquartered in Markham, Canada."
SMTX,2018-12-30,NA,229000,NA,-448000,16386000,21661000,5275000,5275000,-3117000,677000,216131000,210856000,194470000,-5046000,NA,-448000,-448000,NA,income_statement,Electronic Components,SMTC Corporation,"SMTC Corporation provides electronics manufacturing services in the United States, Canada, and Mexico. The company offers end-to-end electronics manufacturing services, including product design and engineering; printed circuit board assembly; production, enclosure, cable assembly, and precision metal fabrication; systems integration and testing; and configuration to order, build to order, and direct order fulfillment services. It provides integrated contract manufacturing services to original equipment manufacturer, technology companies, and governmental entities primarily in the test and measurement, retail and payment systems, telecom, networking and communications, medical and safety, industrial, power and clean technology, semiconductor, avionics, defense, and aerospace market sectors. SMTC Corporation was founded in 1985 and is headquartered in Markham, Canada."
SMTX,2019-12-29,NA,-5207000,NA,-5995000,26754000,37021000,10267000,10267000,-10562000,788000,372511000,362244000,335490000,-15474000,NA,-5995000,-5995000,NA,income_statement,Electronic Components,SMTC Corporation,"SMTC Corporation provides electronics manufacturing services in the United States, Canada, and Mexico. The company offers end-to-end electronics manufacturing services, including product design and engineering; printed circuit board assembly; production, enclosure, cable assembly, and precision metal fabrication; systems integration and testing; and configuration to order, build to order, and direct order fulfillment services. It provides integrated contract manufacturing services to original equipment manufacturer, technology companies, and governmental entities primarily in the test and measurement, retail and payment systems, telecom, networking and communications, medical and safety, industrial, power and clean technology, semiconductor, avionics, defense, and aerospace market sectors. SMTC Corporation was founded in 1985 and is headquartered in Markham, Canada."
SNA,2017-12-30,NA,823100000,18400000,557700000,1161900000,2043100000,881200000,881200000,-52100000,250900000,4000300000,3119100000,1957200000,-104000000,NA,572200000,557700000,NA,income_statement,NA,NA,NA
SNA,2018-12-29,NA,910600000,19800000,679900000,1140300000,2099900000,959600000,959600000,-50100000,214400000,4070400000,3110800000,1970500000,-49000000,NA,696200000,679900000,NA,income_statement,NA,NA,NA
SNA,2019-12-28,NA,923000000,21700000,693500000,1128800000,2089600000,960800000,960800000,-48800000,211800000,4067700000,3106900000,1978100000,-37800000,NA,711200000,693500000,NA,income_statement,NA,NA,NA
SNA,2021-01-02,NA,835500000,21700000,627000000,1094900000,2010400000,915500000,915500000,-53800000,189100000,3942200000,3026700000,1931800000,-80000000,NA,646400000,627000000,NA,income_statement,NA,NA,NA
SNBR,2017-12-30,27806000,91038000,NA,65077000,777626000,897347000,91915000,91915000,-975000,25961000,1444497000,1352582000,547150000,-779000,NA,65077000,65077000,NA,income_statement,"Furnishings, Fixtures & Appliances",Sleep Number Corporation,"Sleep Number Corporation, together with its subsidiaries, provides sleep solutions and services in the United States. The company designs, manufactures, markets, retails, and services beds, pillows, sheets, and other bedding product under the Sleep Number name. It also offers adjustable bases under the FlextFit name; temperature-balancing products, including DualTemp layer; SleepIQ Kids k2 beds for kids; and smart beds under the Sleep Number 360 brand name. The company sells its products directly to consumers through retail, online, and phone, as well as through wholesale. As of February 19, 2020, it operated approximately 610 stores in 50 states. The company was formerly known as Select Comfort Corporation and changed its name to Sleep Number Corporation in November 2017. Sleep Number Corporation was founded in 1987 and is headquartered in Minneapolis, Minnesota."
SNBR,2018-12-29,28775000,86521000,NA,69539000,806758000,927961000,92428000,92428000,-5911000,16982000,1531575000,1439147000,603614000,-5907000,NA,69539000,69539000,NA,income_statement,"Furnishings, Fixtures & Appliances",Sleep Number Corporation,"Sleep Number Corporation, together with its subsidiaries, provides sleep solutions and services in the United States. The company designs, manufactures, markets, retails, and services beds, pillows, sheets, and other bedding product under the Sleep Number name. It also offers adjustable bases under the FlextFit name; temperature-balancing products, including DualTemp layer; SleepIQ Kids k2 beds for kids; and smart beds under the Sleep Number 360 brand name. The company sells its products directly to consumers through retail, online, and phone, as well as through wholesale. As of February 19, 2020, it operated approximately 610 stores in 50 states. The company was formerly known as Select Comfort Corporation and changed its name to Sleep Number Corporation in November 2017. Sleep Number Corporation was founded in 1987 and is headquartered in Minneapolis, Minnesota."
SNBR,2019-12-28,34950000,100508000,NA,81845000,904878000,1051923000,112095000,112095000,-11591000,18663000,1698352000,1586257000,646429000,-11587000,NA,81845000,81845000,NA,income_statement,"Furnishings, Fixtures & Appliances",Sleep Number Corporation,"Sleep Number Corporation, together with its subsidiaries, provides sleep solutions and services in the United States. The company designs, manufactures, markets, retails, and services beds, pillows, sheets, and other bedding product under the Sleep Number name. It also offers adjustable bases under the FlextFit name; temperature-balancing products, including DualTemp layer; SleepIQ Kids k2 beds for kids; and smart beds under the Sleep Number 360 brand name. The company sells its products directly to consumers through retail, online, and phone, as well as through wholesale. As of February 19, 2020, it operated approximately 610 stores in 50 states. The company was formerly known as Select Comfort Corporation and changed its name to Sleep Number Corporation in November 2017. Sleep Number Corporation was founded in 1987 and is headquartered in Minneapolis, Minnesota."
SNBR,2021-01-02,40910000,175972000,NA,139189000,930194000,1156000000,184896000,184896000,-9021000,36783000,1856555000,1671659000,700555000,-8924000,NA,139189000,139189000,NA,income_statement,"Furnishings, Fixtures & Appliances",Sleep Number Corporation,"Sleep Number Corporation, together with its subsidiaries, provides sleep solutions and services in the United States. The company designs, manufactures, markets, retails, and services beds, pillows, sheets, and other bedding product under the Sleep Number name. It also offers adjustable bases under the FlextFit name; temperature-balancing products, including DualTemp layer; SleepIQ Kids k2 beds for kids; and smart beds under the Sleep Number 360 brand name. The company sells its products directly to consumers through retail, online, and phone, as well as through wholesale. As of February 19, 2020, it operated approximately 610 stores in 50 states. The company was formerly known as Select Comfort Corporation and changed its name to Sleep Number Corporation in November 2017. Sleep Number Corporation was founded in 1987 and is headquartered in Minneapolis, Minnesota."
SNCA,2016-12-31,13155887,-21074611,NA,-21074611,7497202,16246,-20636843,-20636843,-1141297,0,16246,20653089,0,-437768,NA,-21074611,-21074611,NA,income_statement,Biotechnology,"Seneca Biopharma, Inc.","Seneca Biopharma, Inc., a clinical stage biopharmaceutical company, focuses on the research and development of nervous system therapies based on its proprietary human neuronal stem cells and small molecule compounds. The company's stem cell based technology enables the isolation and expansion of human neural stem cells from various areas of the developing human brain and spinal cord enabling the generation of physiologically relevant human neurons of various types. Its lead product candidates include NSI-189, a chemical entity, which has been completed Phase II clinical trials for the treatment of major depressive disorder; and NSI-566, which has completed Phase II clinical trial for treating amyotrophic lateral sclerosis disease, as well as in Phase II clinical trial for the treatment of chronic ischemic stroke and in Phase I clinical trial for the treatment of chronic spinal cord injury. The company was formerly known as Neuralstem, Inc. and changed its name to Seneca Biopharma, Inc. in October 2019. Seneca Biopharma, Inc. was founded in 1996 and is headquartered in Germantown, Maryland."
SNCA,2017-12-31,8096095,-15665983,NA,-15665983,5471010,260000,-13307105,-13307105,-159066,0,260000,13567105,0,-2358878,NA,-15665983,-15665983,NA,income_statement,Biotechnology,"Seneca Biopharma, Inc.","Seneca Biopharma, Inc., a clinical stage biopharmaceutical company, focuses on the research and development of nervous system therapies based on its proprietary human neuronal stem cells and small molecule compounds. The company's stem cell based technology enables the isolation and expansion of human neural stem cells from various areas of the developing human brain and spinal cord enabling the generation of physiologically relevant human neurons of various types. Its lead product candidates include NSI-189, a chemical entity, which has been completed Phase II clinical trials for the treatment of major depressive disorder; and NSI-566, which has completed Phase II clinical trial for treating amyotrophic lateral sclerosis disease, as well as in Phase II clinical trial for the treatment of chronic ischemic stroke and in Phase I clinical trial for the treatment of chronic spinal cord injury. The company was formerly known as Neuralstem, Inc. and changed its name to Seneca Biopharma, Inc. in October 2019. Seneca Biopharma, Inc. was founded in 1996 and is headquartered in Germantown, Maryland."
SNCA,2018-12-31,3960191,-4924617,NA,-4924617,4559265,260000,-8259456,-8259456,-7698,0,260000,8519456,0,3334839,NA,-4924617,-4924617,NA,income_statement,Biotechnology,"Seneca Biopharma, Inc.","Seneca Biopharma, Inc., a clinical stage biopharmaceutical company, focuses on the research and development of nervous system therapies based on its proprietary human neuronal stem cells and small molecule compounds. The company's stem cell based technology enables the isolation and expansion of human neural stem cells from various areas of the developing human brain and spinal cord enabling the generation of physiologically relevant human neurons of various types. Its lead product candidates include NSI-189, a chemical entity, which has been completed Phase II clinical trials for the treatment of major depressive disorder; and NSI-566, which has completed Phase II clinical trial for treating amyotrophic lateral sclerosis disease, as well as in Phase II clinical trial for the treatment of chronic ischemic stroke and in Phase I clinical trial for the treatment of chronic spinal cord injury. The company was formerly known as Neuralstem, Inc. and changed its name to Seneca Biopharma, Inc. in October 2019. Seneca Biopharma, Inc. was founded in 1996 and is headquartered in Germantown, Maryland."
SNCA,2019-12-31,3959450,-8351651,NA,-8351651,4585638,15394,-8529694,-8529694,-8920,0,15394,8545088,0,178043,NA,-8351651,-8351651,NA,income_statement,Biotechnology,"Seneca Biopharma, Inc.","Seneca Biopharma, Inc., a clinical stage biopharmaceutical company, focuses on the research and development of nervous system therapies based on its proprietary human neuronal stem cells and small molecule compounds. The company's stem cell based technology enables the isolation and expansion of human neural stem cells from various areas of the developing human brain and spinal cord enabling the generation of physiologically relevant human neurons of various types. Its lead product candidates include NSI-189, a chemical entity, which has been completed Phase II clinical trials for the treatment of major depressive disorder; and NSI-566, which has completed Phase II clinical trial for treating amyotrophic lateral sclerosis disease, as well as in Phase II clinical trial for the treatment of chronic ischemic stroke and in Phase I clinical trial for the treatment of chronic spinal cord injury. The company was formerly known as Neuralstem, Inc. and changed its name to Seneca Biopharma, Inc. in October 2019. Seneca Biopharma, Inc. was founded in 1996 and is headquartered in Germantown, Maryland."
SND,2016-12-31,NA,19773000,NA,10379000,11887000,32662000,20391000,20391000,-14001000,9394000,59231000,38840000,26569000,-618000,NA,10379000,10379000,NA,income_statement,Oil & Gas Equipment & Services,"Smart Sand, Inc.","Smart Sand, Inc., integrated frac sand supply and services company, engages in the excavation, processing, and sale of sands or proppant for use in hydraulic fracturing operations in the oil and gas industry in the United States. It also operates SmartSystems, a wellsite proppant storage solution; and offers logistics services. The company sells its products primarily to oil and natural gas exploration and production companies, and oilfield service companies. As of February 26, 2020, it had approximately 316 million tons of proven recoverable sand reserves. The company was incorporated in 2011 and is headquartered in The Woodlands, Texas."
SND,2017-12-31,NA,18717000,NA,21526000,17678000,36908000,18705000,18705000,-700000,-2809000,137212000,118507000,100304000,12000,NA,21526000,21526000,NA,income_statement,Oil & Gas Equipment & Services,"Smart Sand, Inc.","Smart Sand, Inc., integrated frac sand supply and services company, engages in the excavation, processing, and sale of sands or proppant for use in hydraulic fracturing operations in the oil and gas industry in the United States. It also operates SmartSystems, a wellsite proppant storage solution; and offers logistics services. The company sells its products primarily to oil and natural gas exploration and production companies, and oilfield service companies. As of February 26, 2020, it had approximately 316 million tons of proven recoverable sand reserves. The company was incorporated in 2011 and is headquartered in The Woodlands, Texas."
SND,2018-12-31,NA,23810000,NA,18688000,22709000,67567000,43015000,43015000,-2320000,5122000,212470000,169455000,144903000,-19205000,NA,18688000,18688000,NA,income_statement,Oil & Gas Equipment & Services,"Smart Sand, Inc.","Smart Sand, Inc., integrated frac sand supply and services company, engages in the excavation, processing, and sale of sands or proppant for use in hydraulic fracturing operations in the oil and gas industry in the United States. It also operates SmartSystems, a wellsite proppant storage solution; and offers logistics services. The company sells its products primarily to oil and natural gas exploration and production companies, and oilfield service companies. As of February 26, 2020, it had approximately 316 million tons of proven recoverable sand reserves. The company was incorporated in 2011 and is headquartered in The Woodlands, Texas."
SND,2019-12-31,NA,39432000,NA,31623000,22888000,81052000,55753000,55753000,-3626000,7809000,233073000,177320000,152021000,-16321000,NA,31623000,31623000,NA,income_statement,Oil & Gas Equipment & Services,"Smart Sand, Inc.","Smart Sand, Inc., integrated frac sand supply and services company, engages in the excavation, processing, and sale of sands or proppant for use in hydraulic fracturing operations in the oil and gas industry in the United States. It also operates SmartSystems, a wellsite proppant storage solution; and offers logistics services. The company sells its products primarily to oil and natural gas exploration and production companies, and oilfield service companies. As of February 26, 2020, it had approximately 316 million tons of proven recoverable sand reserves. The company was incorporated in 2011 and is headquartered in The Woodlands, Texas."
SNDE,2016-12-31,NA,-43989000,NA,-45694000,12710000,49472000,-35431000,-35431000,-12219000,1705000,62409000,97840000,12937000,-8558000,NA,-45694000,-45694000,12761000,income_statement,Oil & Gas E&P,Sundance Energy Inc.,"Sundance Energy Inc. operates as an onshore independent oil and natural gas company in North America. The company explores for, develops, and produces oil and natural gas. It focuses on operations on its 41,000 net acres in the Eagle Ford, Live Oak, Atascosa, La Salle, and McMullen counties, South Texas. Sundance Energy, Inc. is headquartered in Denver, Colorado."
SNDE,2017-12-31,NA,-24308000,NA,-22435000,17045000,75370000,-3098000,-3098000,-13491000,-1873000,97786000,100884000,22416000,-21210000,NA,-22435000,-22435000,2894000,income_statement,Oil & Gas E&P,Sundance Energy Inc.,"Sundance Energy Inc. operates as an onshore independent oil and natural gas company in North America. The company explores for, develops, and produces oil and natural gas. It focuses on operations on its 41,000 net acres in the Eagle Ford, Live Oak, Atascosa, La Salle, and McMullen counties, South Texas. Sundance Energy, Inc. is headquartered in Denver, Colorado."
SNDE,2018-12-31,NA,-8976000,NA,-22933000,18143000,113073000,25313000,25313000,-28631000,13957000,155663000,130350000,42590000,-34289000,NA,-22933000,-22933000,-40364000,income_statement,Oil & Gas E&P,Sundance Energy Inc.,"Sundance Energy Inc. operates as an onshore independent oil and natural gas company in North America. The company explores for, develops, and produces oil and natural gas. It focuses on operations on its 41,000 net acres in the Eagle Ford, Live Oak, Atascosa, La Salle, and McMullen counties, South Texas. Sundance Energy, Inc. is headquartered in Denver, Colorado."
SNDE,2019-12-31,NA,-44108000,NA,-39590000,19599000,141329000,-1673000,-1673000,-38058000,-4518000,192096000,193769000,50767000,-42435000,NA,-39590000,-39590000,20742000,income_statement,Oil & Gas E&P,Sundance Energy Inc.,"Sundance Energy Inc. operates as an onshore independent oil and natural gas company in North America. The company explores for, develops, and produces oil and natural gas. It focuses on operations on its 41,000 net acres in the Eagle Ford, Live Oak, Atascosa, La Salle, and McMullen counties, South Texas. Sundance Energy, Inc. is headquartered in Denver, Colorado."
SNDL,2017-02-28,413000,-1545280,4714000,-1545280,1411132,0,-1491340,-1491340,-37309,0,0,1491340,0,-53940,NA,-1545280,-1545280,NA,income_statement,Drug Manufacturers—Specialty & Generic,Sundial Growers Inc.,"Sundial Growers Inc. engages in the production, distribution, and sale of cannabis products for the adult-use market It is also involved in the production, distribution, and sale of ornamental plants and herbs in the United Kingdom. The company offers its products under the Top Leaf, Sundial Cannabis, Palmetto, and Grasslands brands. Sundial Growers Inc. was incorporated in 2006 and is headquartered in Calgary, Canada."
SNDL,2018-02-28,413000,-12995000,4714000,-12995000,4418000,-883000,-10701000,-10701000,-1496400,0,0,10701000,883000,-2294000,NA,-12995000,-12995000,NA,income_statement,Drug Manufacturers—Specialty & Generic,Sundial Growers Inc.,"Sundial Growers Inc. engages in the production, distribution, and sale of cannabis products for the adult-use market It is also involved in the production, distribution, and sale of ornamental plants and herbs in the United Kingdom. The company offers its products under the Top Leaf, Sundial Cannabis, Palmetto, and Grasslands brands. Sundial Growers Inc. was incorporated in 2006 and is headquartered in Calgary, Canada."
SNDL,2018-12-31,330000,-67831200,4714000,-67831200,12826800,-9284400,-32437200,-32437200,-1496400,0,0,32437200,9284400,-35394000,NA,-67831200,-67831200,NA,income_statement,Drug Manufacturers—Specialty & Generic,Sundial Growers Inc.,"Sundial Growers Inc. engages in the production, distribution, and sale of cannabis products for the adult-use market It is also involved in the production, distribution, and sale of ornamental plants and herbs in the United Kingdom. The company offers its products under the Top Leaf, Sundial Cannabis, Palmetto, and Grasslands brands. Sundial Growers Inc. was incorporated in 2006 and is headquartered in Calgary, Canada."
SNDL,2019-12-31,2410000,-276255000,4714000,-271464000,53337000,39754000,-59594000,-59594000,-22927000,-4626000,75860000,135454000,36106000,-216661000,NA,-271629000,-271464000,NA,income_statement,Drug Manufacturers—Specialty & Generic,Sundial Growers Inc.,"Sundial Growers Inc. engages in the production, distribution, and sale of cannabis products for the adult-use market It is also involved in the production, distribution, and sale of ornamental plants and herbs in the United Kingdom. The company offers its products under the Top Leaf, Sundial Cannabis, Palmetto, and Grasslands brands. Sundial Growers Inc. was incorporated in 2006 and is headquartered in Calgary, Canada."
SNDX,2016-12-31,31665000,-44472000,NA,-44472000,13321000,1220000,-43766000,-43766000,NA,0,1220000,44986000,0,-706000,NA,-44472000,-47070000,NA,income_statement,Biotechnology,"Syndax Pharmaceuticals, Inc.","Syndax Pharmaceuticals, Inc., a clinical-stage biopharmaceutical company, develops therapies for the treatment of cancer. The company's lead product candidates are entinostat that is in Phase III clinical trials for the treatment of advanced hormone receptor positive (HR+), human epidermal growth factor receptor 2 negative (HER2-) breast cancer; and SNDX-5613 in Phase I/II clinical trial inhibitor that targets the binding interaction of Menin with mixed lineage leukemia-rearranged and acute myeloid leukemia with a mutated nucleophosmin 1. It also develops entinostat with Keytruda (pembrolizumab) in a Phase Ib/II clinical trials for the treatment of non-small cell lung cancer and melanoma or microsatellite stable colorectal carcinoma; and with Tecentriq (atezolizumab) in Phase Ib/II clinical trials to treat patients with HR+ and HER2- metastatic breast cancer. In addition, the company develops SNDX-6352, a monoclonal antibody that blocks the colony stimulating factor 1 that is in Phase I/II clinical trial in patients with chronic graft versus host disease; and as a monotherapy and in combination with Imfinzi (durvalumab), which is completed Phase Ib dose trials for the treatment of solid tumors. Syndax Pharmaceuticals, Inc. has clinical collaborations with MSD International GmbH; Genentech, Inc.; and Merck KGaA and Pfizer. It also has collaborative research and development agreement with National Cancer Institute; clinical trial agreement with Eastern Cooperative Oncology Group; and license agreement with Kyowa Hakko Kirin Co., Ltd. The company was founded in 2005 and is headquartered in Waltham, Massachusetts."
SNDX,2017-12-31,48201000,-60802000,NA,-60802000,15861000,2108000,-61954000,-61954000,NA,0,2108000,64062000,0,1152000,NA,-60802000,-60802000,NA,income_statement,Biotechnology,"Syndax Pharmaceuticals, Inc.","Syndax Pharmaceuticals, Inc., a clinical-stage biopharmaceutical company, develops therapies for the treatment of cancer. The company's lead product candidates are entinostat that is in Phase III clinical trials for the treatment of advanced hormone receptor positive (HR+), human epidermal growth factor receptor 2 negative (HER2-) breast cancer; and SNDX-5613 in Phase I/II clinical trial inhibitor that targets the binding interaction of Menin with mixed lineage leukemia-rearranged and acute myeloid leukemia with a mutated nucleophosmin 1. It also develops entinostat with Keytruda (pembrolizumab) in a Phase Ib/II clinical trials for the treatment of non-small cell lung cancer and melanoma or microsatellite stable colorectal carcinoma; and with Tecentriq (atezolizumab) in Phase Ib/II clinical trials to treat patients with HR+ and HER2- metastatic breast cancer. In addition, the company develops SNDX-6352, a monoclonal antibody that blocks the colony stimulating factor 1 that is in Phase I/II clinical trial in patients with chronic graft versus host disease; and as a monotherapy and in combination with Imfinzi (durvalumab), which is completed Phase Ib dose trials for the treatment of solid tumors. Syndax Pharmaceuticals, Inc. has clinical collaborations with MSD International GmbH; Genentech, Inc.; and Merck KGaA and Pfizer. It also has collaborative research and development agreement with National Cancer Institute; clinical trial agreement with Eastern Cooperative Oncology Group; and license agreement with Kyowa Hakko Kirin Co., Ltd. The company was founded in 2005 and is headquartered in Waltham, Massachusetts."
SNDX,2018-12-31,60106000,-73961000,NA,-73961000,17287000,1517000,-75876000,-75876000,NA,0,1517000,77393000,0,1915000,NA,-73961000,-73961000,NA,income_statement,Biotechnology,"Syndax Pharmaceuticals, Inc.","Syndax Pharmaceuticals, Inc., a clinical-stage biopharmaceutical company, develops therapies for the treatment of cancer. The company's lead product candidates are entinostat that is in Phase III clinical trials for the treatment of advanced hormone receptor positive (HR+), human epidermal growth factor receptor 2 negative (HER2-) breast cancer; and SNDX-5613 in Phase I/II clinical trial inhibitor that targets the binding interaction of Menin with mixed lineage leukemia-rearranged and acute myeloid leukemia with a mutated nucleophosmin 1. It also develops entinostat with Keytruda (pembrolizumab) in a Phase Ib/II clinical trials for the treatment of non-small cell lung cancer and melanoma or microsatellite stable colorectal carcinoma; and with Tecentriq (atezolizumab) in Phase Ib/II clinical trials to treat patients with HR+ and HER2- metastatic breast cancer. In addition, the company develops SNDX-6352, a monoclonal antibody that blocks the colony stimulating factor 1 that is in Phase I/II clinical trial in patients with chronic graft versus host disease; and as a monotherapy and in combination with Imfinzi (durvalumab), which is completed Phase Ib dose trials for the treatment of solid tumors. Syndax Pharmaceuticals, Inc. has clinical collaborations with MSD International GmbH; Genentech, Inc.; and Merck KGaA and Pfizer. It also has collaborative research and development agreement with National Cancer Institute; clinical trial agreement with Eastern Cooperative Oncology Group; and license agreement with Kyowa Hakko Kirin Co., Ltd. The company was founded in 2005 and is headquartered in Waltham, Massachusetts."
SNDX,2019-12-31,42994000,-56047000,NA,-56047000,16062000,1517000,-57539000,-57539000,NA,0,1517000,59056000,0,1492000,NA,-56047000,-56047000,NA,income_statement,Biotechnology,"Syndax Pharmaceuticals, Inc.","Syndax Pharmaceuticals, Inc., a clinical-stage biopharmaceutical company, develops therapies for the treatment of cancer. The company's lead product candidates are entinostat that is in Phase III clinical trials for the treatment of advanced hormone receptor positive (HR+), human epidermal growth factor receptor 2 negative (HER2-) breast cancer; and SNDX-5613 in Phase I/II clinical trial inhibitor that targets the binding interaction of Menin with mixed lineage leukemia-rearranged and acute myeloid leukemia with a mutated nucleophosmin 1. It also develops entinostat with Keytruda (pembrolizumab) in a Phase Ib/II clinical trials for the treatment of non-small cell lung cancer and melanoma or microsatellite stable colorectal carcinoma; and with Tecentriq (atezolizumab) in Phase Ib/II clinical trials to treat patients with HR+ and HER2- metastatic breast cancer. In addition, the company develops SNDX-6352, a monoclonal antibody that blocks the colony stimulating factor 1 that is in Phase I/II clinical trial in patients with chronic graft versus host disease; and as a monotherapy and in combination with Imfinzi (durvalumab), which is completed Phase Ib dose trials for the treatment of solid tumors. Syndax Pharmaceuticals, Inc. has clinical collaborations with MSD International GmbH; Genentech, Inc.; and Merck KGaA and Pfizer. It also has collaborative research and development agreement with National Cancer Institute; clinical trial agreement with Eastern Cooperative Oncology Group; and license agreement with Kyowa Hakko Kirin Co., Ltd. The company was founded in 2005 and is headquartered in Waltham, Massachusetts."
SNES,2016-12-31,2487000,-10795000,NA,-10795000,7347000,318000,-9516000,-9516000,-87000,0,318000,9834000,0,-1279000,NA,-10795000,-10954000,NA,income_statement,Specialty Chemicals,"SenesTech, Inc.","SenesTech, Inc. develops a technology for managing animal pest populations through fertility control. The company offers ContraPest, a liquid bait that targets reproduction, and limiting fertility in male and female rats for controlling rat populations. It is also developing a pipeline of fertility control and animal health products, including feral animal fertility control, non-surgical spay and neutering, boar taint, and animal cancer treatment. The company was founded in 2004 and is headquartered in Phoenix, Arizona."
SNES,2017-12-31,2898000,-12286000,NA,-12286000,9425000,7000,-12316000,-12316000,-86000,0,52000,12368000,45000,30000,NA,-12286000,-12286000,NA,income_statement,Specialty Chemicals,"SenesTech, Inc.","SenesTech, Inc. develops a technology for managing animal pest populations through fertility control. The company offers ContraPest, a liquid bait that targets reproduction, and limiting fertility in male and female rats for controlling rat populations. It is also developing a pipeline of fertility control and animal health products, including feral animal fertility control, non-surgical spay and neutering, boar taint, and animal cancer treatment. The company was founded in 2004 and is headquartered in Phoenix, Arizona."
SNES,2018-12-31,2170000,-11908000,NA,-11908000,9766000,56000,-11880000,-11880000,-74000,0,297000,12177000,241000,-28000,NA,-11908000,-12241000,NA,income_statement,Specialty Chemicals,"SenesTech, Inc.","SenesTech, Inc. develops a technology for managing animal pest populations through fertility control. The company offers ContraPest, a liquid bait that targets reproduction, and limiting fertility in male and female rats for controlling rat populations. It is also developing a pipeline of fertility control and animal health products, including feral animal fertility control, non-surgical spay and neutering, boar taint, and animal cancer treatment. The company was founded in 2004 and is headquartered in Phoenix, Arizona."
SNES,2019-12-31,1647000,-10018000,NA,-10018000,8682000,42000,-10287000,-10287000,-42000,0,143000,10430000,101000,269000,NA,-10018000,-10029000,NA,income_statement,Specialty Chemicals,"SenesTech, Inc.","SenesTech, Inc. develops a technology for managing animal pest populations through fertility control. The company offers ContraPest, a liquid bait that targets reproduction, and limiting fertility in male and female rats for controlling rat populations. It is also developing a pipeline of fertility control and animal health products, including feral animal fertility control, non-surgical spay and neutering, boar taint, and animal cancer treatment. The company was founded in 2004 and is headquartered in Phoenix, Arizona."
SNEX,2017-09-30,NA,15200000,NA,6400000,337700000,439900000,0,15300000,NA,8800000,29381500000,29366200000,28941600000,-100000,NA,6400000,6300000,25800000,income_statement,Capital Markets,StoneX Group Inc.,"StoneX Group Inc. operates as a global financial services network that connects companies, organizations, traders, and investors to market ecosystem worldwide. Its Commercial segment provides risk management and hedging, exchange-traded and OTC products execution and clearing, voice brokerage, market intelligence, physical trading, and commodity financing and logistics services. The company's Institutional segment provides equity trading services to institutional clients; and originates, structures, and places debt instruments in capital markets worldwide. Its services cover foreign securities, including unlisted American Depositary Receipts, Global Depository Receipts, and foreign ordinary shares. This segment also operates as an institutional dealer in fixed income securities to serve asset managers, commercial bank trust and investment departments, broker-dealers, and insurance companies; engages in asset management business; and offers clearing and execution services in futures exchanges, brokerage foreign exchange services for the financial institutions and professional traders, and OTC products. The company's Retail segment provides trading services and solutions in the global financial markets, including spot foreign exchange, precious metals trading, and contracts for differences; and wealth management and investment services, as well as offers physical gold and other precious metals in various forms and denominations through coininvest.com and silver-to-go.com. Its Global Payments segment provides foreign exchange and treasury services to banks and commercial businesses, charities, and non-governmental and government organizations; and payments services. The company was formerly known as INTL FCStone Inc. and changed its name to StoneX Group Inc. in July 2020. StoneX Group Inc. was founded in 1924 and is headquartered in New York, New York."
SNEX,2018-09-30,NA,101500000,NA,55500000,392400000,527700000,0,100500000,NA,46000000,27542000000,27441500000,27014300000,1000000,NA,55500000,54600000,20100000,income_statement,Capital Markets,StoneX Group Inc.,"StoneX Group Inc. operates as a global financial services network that connects companies, organizations, traders, and investors to market ecosystem worldwide. Its Commercial segment provides risk management and hedging, exchange-traded and OTC products execution and clearing, voice brokerage, market intelligence, physical trading, and commodity financing and logistics services. The company's Institutional segment provides equity trading services to institutional clients; and originates, structures, and places debt instruments in capital markets worldwide. Its services cover foreign securities, including unlisted American Depositary Receipts, Global Depository Receipts, and foreign ordinary shares. This segment also operates as an institutional dealer in fixed income securities to serve asset managers, commercial bank trust and investment departments, broker-dealers, and insurance companies; engages in asset management business; and offers clearing and execution services in futures exchanges, brokerage foreign exchange services for the financial institutions and professional traders, and OTC products. The company's Retail segment provides trading services and solutions in the global financial markets, including spot foreign exchange, precious metals trading, and contracts for differences; and wealth management and investment services, as well as offers physical gold and other precious metals in various forms and denominations through coininvest.com and silver-to-go.com. Its Global Payments segment provides foreign exchange and treasury services to banks and commercial businesses, charities, and non-governmental and government organizations; and payments services. The company was formerly known as INTL FCStone Inc. and changed its name to StoneX Group Inc. in July 2020. StoneX Group Inc. was founded in 1924 and is headquartered in New York, New York."
SNEX,2019-09-30,NA,111000000,NA,85100000,458800000,591600000,0,95500000,NA,25900000,32742300000,32646800000,32150700000,15500000,NA,85100000,83600000,23200000,income_statement,Capital Markets,StoneX Group Inc.,"StoneX Group Inc. operates as a global financial services network that connects companies, organizations, traders, and investors to market ecosystem worldwide. Its Commercial segment provides risk management and hedging, exchange-traded and OTC products execution and clearing, voice brokerage, market intelligence, physical trading, and commodity financing and logistics services. The company's Institutional segment provides equity trading services to institutional clients; and originates, structures, and places debt instruments in capital markets worldwide. Its services cover foreign securities, including unlisted American Depositary Receipts, Global Depository Receipts, and foreign ordinary shares. This segment also operates as an institutional dealer in fixed income securities to serve asset managers, commercial bank trust and investment departments, broker-dealers, and insurance companies; engages in asset management business; and offers clearing and execution services in futures exchanges, brokerage foreign exchange services for the financial institutions and professional traders, and OTC products. The company's Retail segment provides trading services and solutions in the global financial markets, including spot foreign exchange, precious metals trading, and contracts for differences; and wealth management and investment services, as well as offers physical gold and other precious metals in various forms and denominations through coininvest.com and silver-to-go.com. Its Global Payments segment provides foreign exchange and treasury services to banks and commercial businesses, charities, and non-governmental and government organizations; and payments services. The company was formerly known as INTL FCStone Inc. and changed its name to StoneX Group Inc. in July 2020. StoneX Group Inc. was founded in 1924 and is headquartered in New York, New York."
SNEX,2020-09-30,NA,206700000,NA,169600000,607800000,805800000,0,136200000,NA,37100000,54035600000,53899400000,53229800000,70500000,NA,169600000,165600000,29100000,income_statement,Capital Markets,StoneX Group Inc.,"StoneX Group Inc. operates as a global financial services network that connects companies, organizations, traders, and investors to market ecosystem worldwide. Its Commercial segment provides risk management and hedging, exchange-traded and OTC products execution and clearing, voice brokerage, market intelligence, physical trading, and commodity financing and logistics services. The company's Institutional segment provides equity trading services to institutional clients; and originates, structures, and places debt instruments in capital markets worldwide. Its services cover foreign securities, including unlisted American Depositary Receipts, Global Depository Receipts, and foreign ordinary shares. This segment also operates as an institutional dealer in fixed income securities to serve asset managers, commercial bank trust and investment departments, broker-dealers, and insurance companies; engages in asset management business; and offers clearing and execution services in futures exchanges, brokerage foreign exchange services for the financial institutions and professional traders, and OTC products. The company's Retail segment provides trading services and solutions in the global financial markets, including spot foreign exchange, precious metals trading, and contracts for differences; and wealth management and investment services, as well as offers physical gold and other precious metals in various forms and denominations through coininvest.com and silver-to-go.com. Its Global Payments segment provides foreign exchange and treasury services to banks and commercial businesses, charities, and non-governmental and government organizations; and payments services. The company was formerly known as INTL FCStone Inc. and changed its name to StoneX Group Inc. in July 2020. StoneX Group Inc. was founded in 1924 and is headquartered in New York, New York."
SNFCA,2016-12-31,NA,19703231,NA,12188627,113311303,140309126,24815099,24815099,-5111868,7514604,304334901,279519802,164025775,-5111868,NA,12188627,12188627,NA,income_statement,Credit Services,Security National Financial Cor,"Security National Financial Corporation engages in life insurance, cemetery and mortuary, and mortgage businesses. The company's Life Insurance segment is involved in selling and servicing lines of life insurance, annuity products, and accident and health insurance. It offers various life insurance products, including funeral plans and interest-sensitive life insurance, as well as other traditional life, accident, and health insurance products; annuity products comprising single and flexible premium deferred annuities, and immediate annuities; and diver's accident policies. This segment also cedes and assumes various risks with various authorized unaffiliated reinsurers pursuant to reinsurance treaties. Its Cemetery and Mortuary segment operates eight mortuaries and five cemeteries in Utah; and one cemetery in California. This segment also markets plots, interment vaults, mausoleum crypts, markers, caskets, flowers, and other death care related products; and provides professional services of funeral directors, opening and closing of graves, use of chapels and viewing rooms, and use of automobiles and clothing. The company's Mortgage segment originates and underwrites residential and commercial loans for new construction, existing homes, and real estate projects primarily in Florida, Nevada, Texas, and Utah. It offers residential mortgage lending services to real estate brokers and independent mortgage loan originators. Security National Financial Corporation was founded in 1965 and is headquartered in Draper, Utah."
SNFCA,2017-12-31,NA,7532112,NA,14112934,114225863,130016000,13569444,13569444,-6037332,-6580822,276926090,263356646,146910090,-6037332,NA,14112934,14112934,NA,income_statement,Credit Services,Security National Financial Cor,"Security National Financial Corporation engages in life insurance, cemetery and mortuary, and mortgage businesses. The company's Life Insurance segment is involved in selling and servicing lines of life insurance, annuity products, and accident and health insurance. It offers various life insurance products, including funeral plans and interest-sensitive life insurance, as well as other traditional life, accident, and health insurance products; annuity products comprising single and flexible premium deferred annuities, and immediate annuities; and diver's accident policies. This segment also cedes and assumes various risks with various authorized unaffiliated reinsurers pursuant to reinsurance treaties. Its Cemetery and Mortuary segment operates eight mortuaries and five cemeteries in Utah; and one cemetery in California. This segment also markets plots, interment vaults, mausoleum crypts, markers, caskets, flowers, and other death care related products; and provides professional services of funeral directors, opening and closing of graves, use of chapels and viewing rooms, and use of automobiles and clothing. The company's Mortgage segment originates and underwrites residential and commercial loans for new construction, existing homes, and real estate projects primarily in Florida, Nevada, Texas, and Utah. It offers residential mortgage lending services to real estate brokers and independent mortgage loan originators. Security National Financial Corporation was founded in 1965 and is headquartered in Draper, Utah."
SNFCA,2018-12-31,NA,26180390,NA,21686079,110591917,145596015,33137097,33137097,-6956707,4494311,279618727,246481630,134022712,-6956707,NA,21686079,21686079,NA,income_statement,Credit Services,Security National Financial Cor,"Security National Financial Corporation engages in life insurance, cemetery and mortuary, and mortgage businesses. The company's Life Insurance segment is involved in selling and servicing lines of life insurance, annuity products, and accident and health insurance. It offers various life insurance products, including funeral plans and interest-sensitive life insurance, as well as other traditional life, accident, and health insurance products; annuity products comprising single and flexible premium deferred annuities, and immediate annuities; and diver's accident policies. This segment also cedes and assumes various risks with various authorized unaffiliated reinsurers pursuant to reinsurance treaties. Its Cemetery and Mortuary segment operates eight mortuaries and five cemeteries in Utah; and one cemetery in California. This segment also markets plots, interment vaults, mausoleum crypts, markers, caskets, flowers, and other death care related products; and provides professional services of funeral directors, opening and closing of graves, use of chapels and viewing rooms, and use of automobiles and clothing. The company's Mortgage segment originates and underwrites residential and commercial loans for new construction, existing homes, and real estate projects primarily in Florida, Nevada, Texas, and Utah. It offers residential mortgage lending services to real estate brokers and independent mortgage loan originators. Security National Financial Corporation was founded in 1965 and is headquartered in Draper, Utah."
SNFCA,2019-12-31,NA,13943935,NA,10893519,110984045,134026037,21330623,21330623,-7386688,3050416,283060930,261730307,149034893,-7386688,NA,10893519,10893519,NA,income_statement,Credit Services,Security National Financial Cor,"Security National Financial Corporation engages in life insurance, cemetery and mortuary, and mortgage businesses. The company's Life Insurance segment is involved in selling and servicing lines of life insurance, annuity products, and accident and health insurance. It offers various life insurance products, including funeral plans and interest-sensitive life insurance, as well as other traditional life, accident, and health insurance products; annuity products comprising single and flexible premium deferred annuities, and immediate annuities; and diver's accident policies. This segment also cedes and assumes various risks with various authorized unaffiliated reinsurers pursuant to reinsurance treaties. Its Cemetery and Mortuary segment operates eight mortuaries and five cemeteries in Utah; and one cemetery in California. This segment also markets plots, interment vaults, mausoleum crypts, markers, caskets, flowers, and other death care related products; and provides professional services of funeral directors, opening and closing of graves, use of chapels and viewing rooms, and use of automobiles and clothing. The company's Mortgage segment originates and underwrites residential and commercial loans for new construction, existing homes, and real estate projects primarily in Florida, Nevada, Texas, and Utah. It offers residential mortgage lending services to real estate brokers and independent mortgage loan originators. Security National Financial Corporation was founded in 1965 and is headquartered in Draper, Utah."
SNGX,2016-12-31,4295867,-3775526,NA,-3245383,3428838,2015123,-5709582,-5709582,-7281,-530143,10448794,16158376,8433671,1934056,NA,-3245383,-3245383,NA,income_statement,Biotechnology,"Soligenix, Inc.","Soligenix, Inc., a late-stage biopharmaceutical company, focuses on developing and commercializing products to treat rare diseases in the United States. It operates in two segments, Specialized BioTherapeutics and Public Health Solutions. The Specialized BioTherapeutics segment develops SGX301, a novel photodynamic therapy, which has completed Phase 3 clinical trial to treat cutaneous T-cell lymphoma; and SGX942, an innate defense regulator technology that is in Phase 3 clinical trial to treat oral mucositis in head and neck cancer. This segment also offers proprietary formulations of oral beclomethasone 17,21-dipropionate, which is in Phase 1/2 clinical trial for the prevention/treatment of gastrointestinal disorders characterized by severe inflammation, including pediatric Crohn's disease and acute radiation enteritis. The Public Health Solutions segment is involved in the development of RiVax, a ricin toxin vaccine candidate, which has completed Phase 1a and 1b clinical trials; SGX943, a melioidosis therapeutic candidate that is in pre-clinical stage for the treatment of antibiotic resistant and emerging infectious diseases; and ThermoVax, a technology in pre-clinical development for thermostabilizing vaccines. The company was formerly known as DOR BioPharma, Inc. and changed its name to Soligenix, Inc. in 2009. Soligenix, Inc. was incorporated in 1987 and is headquartered in Princeton, New Jersey."
SNGX,2017-12-31,5507033,-7563893,NA,-7147083,3209155,1122389,-7593799,-7593799,NA,-416810,5432472,13026271,4310083,29906,NA,-7147083,-7147083,NA,income_statement,Biotechnology,"Soligenix, Inc.","Soligenix, Inc., a late-stage biopharmaceutical company, focuses on developing and commercializing products to treat rare diseases in the United States. It operates in two segments, Specialized BioTherapeutics and Public Health Solutions. The Specialized BioTherapeutics segment develops SGX301, a novel photodynamic therapy, which has completed Phase 3 clinical trial to treat cutaneous T-cell lymphoma; and SGX942, an innate defense regulator technology that is in Phase 3 clinical trial to treat oral mucositis in head and neck cancer. This segment also offers proprietary formulations of oral beclomethasone 17,21-dipropionate, which is in Phase 1/2 clinical trial for the prevention/treatment of gastrointestinal disorders characterized by severe inflammation, including pediatric Crohn's disease and acute radiation enteritis. The Public Health Solutions segment is involved in the development of RiVax, a ricin toxin vaccine candidate, which has completed Phase 1a and 1b clinical trials; SGX943, a melioidosis therapeutic candidate that is in pre-clinical stage for the treatment of antibiotic resistant and emerging infectious diseases; and ThermoVax, a technology in pre-clinical development for thermostabilizing vaccines. The company was formerly known as DOR BioPharma, Inc. and changed its name to Soligenix, Inc. in 2009. Soligenix, Inc. was incorporated in 1987 and is headquartered in Princeton, New Jersey."
SNGX,2018-12-31,6750954,-8899975,NA,-8899975,2951760,643733,-9058981,-9058981,NA,0,5241448,14300429,4597715,159006,NA,-8899975,-8899975,NA,income_statement,Biotechnology,"Soligenix, Inc.","Soligenix, Inc., a late-stage biopharmaceutical company, focuses on developing and commercializing products to treat rare diseases in the United States. It operates in two segments, Specialized BioTherapeutics and Public Health Solutions. The Specialized BioTherapeutics segment develops SGX301, a novel photodynamic therapy, which has completed Phase 3 clinical trial to treat cutaneous T-cell lymphoma; and SGX942, an innate defense regulator technology that is in Phase 3 clinical trial to treat oral mucositis in head and neck cancer. This segment also offers proprietary formulations of oral beclomethasone 17,21-dipropionate, which is in Phase 1/2 clinical trial for the prevention/treatment of gastrointestinal disorders characterized by severe inflammation, including pediatric Crohn's disease and acute radiation enteritis. The Public Health Solutions segment is involved in the development of RiVax, a ricin toxin vaccine candidate, which has completed Phase 1a and 1b clinical trials; SGX943, a melioidosis therapeutic candidate that is in pre-clinical stage for the treatment of antibiotic resistant and emerging infectious diseases; and ThermoVax, a technology in pre-clinical development for thermostabilizing vaccines. The company was formerly known as DOR BioPharma, Inc. and changed its name to Soligenix, Inc. in 2009. Soligenix, Inc. was incorporated in 1987 and is headquartered in Princeton, New Jersey."
SNGX,2019-12-31,8122610,-9966268,NA,-9355592,3480912,1062501,-10541021,-10541021,NA,-610676,4629916,15170937,3567415,574753,NA,-9355592,-9355592,NA,income_statement,Biotechnology,"Soligenix, Inc.","Soligenix, Inc., a late-stage biopharmaceutical company, focuses on developing and commercializing products to treat rare diseases in the United States. It operates in two segments, Specialized BioTherapeutics and Public Health Solutions. The Specialized BioTherapeutics segment develops SGX301, a novel photodynamic therapy, which has completed Phase 3 clinical trial to treat cutaneous T-cell lymphoma; and SGX942, an innate defense regulator technology that is in Phase 3 clinical trial to treat oral mucositis in head and neck cancer. This segment also offers proprietary formulations of oral beclomethasone 17,21-dipropionate, which is in Phase 1/2 clinical trial for the prevention/treatment of gastrointestinal disorders characterized by severe inflammation, including pediatric Crohn's disease and acute radiation enteritis. The Public Health Solutions segment is involved in the development of RiVax, a ricin toxin vaccine candidate, which has completed Phase 1a and 1b clinical trials; SGX943, a melioidosis therapeutic candidate that is in pre-clinical stage for the treatment of antibiotic resistant and emerging infectious diseases; and ThermoVax, a technology in pre-clinical development for thermostabilizing vaccines. The company was formerly known as DOR BioPharma, Inc. and changed its name to Soligenix, Inc. in 2009. Soligenix, Inc. was incorporated in 1987 and is headquartered in Princeton, New Jersey."
SNOA,2017-03-31,1576000,-12937000,NA,9274000,17066000,5668000,-12974000,-12974000,-3000,-4268000,12825000,25799000,7157000,37000,17943000,-8669000,9274000,NA,income_statement,Drug Manufacturers—Specialty & Generic,"Sonoma Pharmaceuticals, Inc.","Sonoma Pharmaceuticals, Inc., develops and produces stabilized hypochlorous acid (HOCl) products for various applications, including wound care, animal health care, eye care, oral care, and dermatological conditions in the United States and internationally. The company offers Epicyn, an antimicrobial facial cleanser; Levicyn, a hypochlorous acid (HOCl) based prescription product to manage and relieve burning, itching, and pain experienced with various types of dermatoses; Celacyn gel, a product indicated to promote healing through the management of new and old scars resulting from surgical procedures and trauma wounds or burns; SebuDerm, a product indicated to manage and relieve the burning, itching, pain, and distraction associated with seborrhea and seborrheic dermatitis; and Ceramax, a Lipogrid based skin barrier cream for management of dry itchy skin, minor skin irritations, rashes, and inflammation caused by various skin conditions, as well as Loyon for the management of skin scaling. It also provides Acuicyn, a HOCl-based product indicated to relieve itch and inflammation while helping to keep areas around the eye clean; and Microcyn, a line of products designed to stimulate expedited healing by targeting various pathogens, as well as antibiotic-resistant strains that slow natural healing of wounds. In addition, the company offers MicrocynAH and MicrocynVS, which are HOCl-based solutions designed to relieve common symptoms of hot spots, scratches, skin rashes post-surgical sites, and irritated animal skin for healing; Pediacyn, Epicyn, Gramaderm, and Microdacyn for dermatoses, scar management, and acne; and Sinudox for nasal irrigation, including moistening of cuts, abrasions, and lacerations located in the nasal cavity. The company was formerly known as Oculus Innovative Sciences, Inc. and changed its name to Sonoma Pharmaceuticals, Inc. in December 2016. Sonoma Pharmaceuticals, Inc. was incorporated in 1999 and is based in Woodstock, Georgia."
SNOA,2018-03-31,1575000,-14278000,NA,-14328000,19924000,7310000,-14189000,-14189000,-40000,50000,16658000,30847000,9348000,-89000,NA,-14328000,-14328000,NA,income_statement,Drug Manufacturers—Specialty & Generic,"Sonoma Pharmaceuticals, Inc.","Sonoma Pharmaceuticals, Inc., develops and produces stabilized hypochlorous acid (HOCl) products for various applications, including wound care, animal health care, eye care, oral care, and dermatological conditions in the United States and internationally. The company offers Epicyn, an antimicrobial facial cleanser; Levicyn, a hypochlorous acid (HOCl) based prescription product to manage and relieve burning, itching, and pain experienced with various types of dermatoses; Celacyn gel, a product indicated to promote healing through the management of new and old scars resulting from surgical procedures and trauma wounds or burns; SebuDerm, a product indicated to manage and relieve the burning, itching, pain, and distraction associated with seborrhea and seborrheic dermatitis; and Ceramax, a Lipogrid based skin barrier cream for management of dry itchy skin, minor skin irritations, rashes, and inflammation caused by various skin conditions, as well as Loyon for the management of skin scaling. It also provides Acuicyn, a HOCl-based product indicated to relieve itch and inflammation while helping to keep areas around the eye clean; and Microcyn, a line of products designed to stimulate expedited healing by targeting various pathogens, as well as antibiotic-resistant strains that slow natural healing of wounds. In addition, the company offers MicrocynAH and MicrocynVS, which are HOCl-based solutions designed to relieve common symptoms of hot spots, scratches, skin rashes post-surgical sites, and irritated animal skin for healing; Pediacyn, Epicyn, Gramaderm, and Microdacyn for dermatoses, scar management, and acne; and Sinudox for nasal irrigation, including moistening of cuts, abrasions, and lacerations located in the nasal cavity. The company was formerly known as Oculus Innovative Sciences, Inc. and changed its name to Sonoma Pharmaceuticals, Inc. in December 2016. Sonoma Pharmaceuticals, Inc. was incorporated in 1999 and is based in Woodstock, Georgia."
SNOA,2019-03-31,1518000,-11340000,NA,-11798000,18620000,8880000,-11258000,-11258000,-33000,458000,18970000,30228000,10090000,-82000,NA,-11798000,-11798000,NA,income_statement,Drug Manufacturers—Specialty & Generic,"Sonoma Pharmaceuticals, Inc.","Sonoma Pharmaceuticals, Inc., develops and produces stabilized hypochlorous acid (HOCl) products for various applications, including wound care, animal health care, eye care, oral care, and dermatological conditions in the United States and internationally. The company offers Epicyn, an antimicrobial facial cleanser; Levicyn, a hypochlorous acid (HOCl) based prescription product to manage and relieve burning, itching, and pain experienced with various types of dermatoses; Celacyn gel, a product indicated to promote healing through the management of new and old scars resulting from surgical procedures and trauma wounds or burns; SebuDerm, a product indicated to manage and relieve the burning, itching, pain, and distraction associated with seborrhea and seborrheic dermatitis; and Ceramax, a Lipogrid based skin barrier cream for management of dry itchy skin, minor skin irritations, rashes, and inflammation caused by various skin conditions, as well as Loyon for the management of skin scaling. It also provides Acuicyn, a HOCl-based product indicated to relieve itch and inflammation while helping to keep areas around the eye clean; and Microcyn, a line of products designed to stimulate expedited healing by targeting various pathogens, as well as antibiotic-resistant strains that slow natural healing of wounds. In addition, the company offers MicrocynAH and MicrocynVS, which are HOCl-based solutions designed to relieve common symptoms of hot spots, scratches, skin rashes post-surgical sites, and irritated animal skin for healing; Pediacyn, Epicyn, Gramaderm, and Microdacyn for dermatoses, scar management, and acne; and Sinudox for nasal irrigation, including moistening of cuts, abrasions, and lacerations located in the nasal cavity. The company was formerly known as Oculus Innovative Sciences, Inc. and changed its name to Sonoma Pharmaceuticals, Inc. in December 2016. Sonoma Pharmaceuticals, Inc. was incorporated in 1999 and is based in Woodstock, Georgia."
SNOA,2020-03-31,1339000,-2825000,NA,-2946000,13665000,8333000,-6671000,-6671000,-16000,121000,18936000,25607000,10603000,3846000,NA,-2946000,-2946000,NA,income_statement,Drug Manufacturers—Specialty & Generic,"Sonoma Pharmaceuticals, Inc.","Sonoma Pharmaceuticals, Inc., develops and produces stabilized hypochlorous acid (HOCl) products for various applications, including wound care, animal health care, eye care, oral care, and dermatological conditions in the United States and internationally. The company offers Epicyn, an antimicrobial facial cleanser; Levicyn, a hypochlorous acid (HOCl) based prescription product to manage and relieve burning, itching, and pain experienced with various types of dermatoses; Celacyn gel, a product indicated to promote healing through the management of new and old scars resulting from surgical procedures and trauma wounds or burns; SebuDerm, a product indicated to manage and relieve the burning, itching, pain, and distraction associated with seborrhea and seborrheic dermatitis; and Ceramax, a Lipogrid based skin barrier cream for management of dry itchy skin, minor skin irritations, rashes, and inflammation caused by various skin conditions, as well as Loyon for the management of skin scaling. It also provides Acuicyn, a HOCl-based product indicated to relieve itch and inflammation while helping to keep areas around the eye clean; and Microcyn, a line of products designed to stimulate expedited healing by targeting various pathogens, as well as antibiotic-resistant strains that slow natural healing of wounds. In addition, the company offers MicrocynAH and MicrocynVS, which are HOCl-based solutions designed to relieve common symptoms of hot spots, scratches, skin rashes post-surgical sites, and irritated animal skin for healing; Pediacyn, Epicyn, Gramaderm, and Microdacyn for dermatoses, scar management, and acne; and Sinudox for nasal irrigation, including moistening of cuts, abrasions, and lacerations located in the nasal cavity. The company was formerly known as Oculus Innovative Sciences, Inc. and changed its name to Sonoma Pharmaceuticals, Inc. in December 2016. Sonoma Pharmaceuticals, Inc. was incorporated in 1999 and is based in Woodstock, Georgia."
SNPS,2017-10-31,908841000,383098000,4104000,136563000,738492000,2146805000,391749000,391749000,-7303000,246535000,2724880000,2333131000,578075000,-8651000,NA,136563000,136563000,NA,income_statement,NA,NA,NA
SNPS,2018-10-31,1084822000,363543000,5863000,432518000,859538000,2469194000,399170000,399170000,-15607000,-68975000,3121058000,2721888000,651864000,-35627000,NA,432518000,432518000,NA,income_statement,NA,NA,NA
SNPS,2019-10-31,1136932000,545506000,5863000,532367000,880408000,2667371000,549117000,549117000,-11659000,13139000,3360694000,2811577000,693323000,-3611000,NA,532367000,532367000,NA,income_statement,NA,NA,NA
SNPS,2020-10-31,1279022000,638159000,4963000,664347000,916540000,2943043000,656200000,656200000,-5140000,-25288000,3685281000,3029081000,742238000,-18041000,NA,663447000,664347000,NA,income_statement,NA,NA,NA
SNSE,2018-12-31,8227000,-13039000,NA,-13039000,4513000,0,-12740000,-12740000,-327000,0,0,12740000,0,-299000,NA,-13039000,-16843000,NA,income_statement,Biotechnology,"Sensei Biotherapeutics, Inc.","Sensei Biotherapeutics, Inc., a clinical-stage immunotherapy company, engages in the discovery and development of therapies with an initial focus on treatments for cancer. The company develops proprietary ImmunoPhage platform, an immunotherapy approach that is designed to utilize bacteriophage to induce a focused and coordinated innate and adaptive immune response. It is engineering ImmunoPhage product candidates to directly target antigen presenting cells and modulate the tumor microenvironment through the targeted use of nanobodies which further enhances therapeutic activity. Sensei Biotherapeutics, Inc. was formerly known as Panacea Pharmaceuticals, Inc. The company was founded in 1999 and is headquartered in Rockville, Maryland."
SNSE,2019-12-31,8350000,-16740000,NA,-16740000,4085000,0,-12435000,-12435000,-2256000,0,0,12435000,0,-4305000,NA,-16740000,-20544000,NA,income_statement,Biotechnology,"Sensei Biotherapeutics, Inc.","Sensei Biotherapeutics, Inc., a clinical-stage immunotherapy company, engages in the discovery and development of therapies with an initial focus on treatments for cancer. The company develops proprietary ImmunoPhage platform, an immunotherapy approach that is designed to utilize bacteriophage to induce a focused and coordinated innate and adaptive immune response. It is engineering ImmunoPhage product candidates to directly target antigen presenting cells and modulate the tumor microenvironment through the targeted use of nanobodies which further enhances therapeutic activity. Sensei Biotherapeutics, Inc. was formerly known as Panacea Pharmaceuticals, Inc. The company was founded in 1999 and is headquartered in Rockville, Maryland."
SNSS,2016-12-31,22881000,-38023000,NA,-38023000,16115000,2536000,-36460000,-36460000,-1721000,0,2536000,38996000,0,-1563000,NA,-38023000,-38023000,NA,income_statement,Biotechnology,"Sunesis Pharmaceuticals, Inc.","Sunesis Pharmaceuticals, Inc., a biopharmaceutical company, focuses on the development and commercialization of targeted inhibitors for the treatment of hematologic and solid cancers. Its lead product candidate is vecabrutinib, a non-covalent inhibitor of Bruton's tyrosine kinase (BTK), which is in Phase 1b/2 clinical trial for the treatment of chronic lymphocytic leukemia, mantle cell lymphoma, and other B-cell malignancies. The company is also developing SNS-510, which is in preclinical pharmacology studies for the treatment of solid tumor and hematologic malignancies; various other partnered programs, such as TAK-580, a pan-Raf inhibitor program that is in Phase 1 clinical trial for the treatment of pediatric low-grade glioma; and vosaroxin, an anti-cancer quinolone derivative that intercalates DNA and inhibits topoisomerase II. It has a collaboration agreement with Biogen Idec MA, Inc. to discover, develop, and commercialize small molecule BTK inhibitors; and license agreement with Takeda Pharmaceutical Company Limited to develop and commercialize preclinical inhibitors of PDK1. Sunesis Pharmaceuticals, Inc. was founded in 1998 and is headquartered in South San Francisco, California."
SNSS,2017-12-31,21540000,-35458000,NA,-35458000,13548000,669000,-34419000,-34419000,-1396000,0,669000,35088000,0,-1039000,NA,-35458000,-35458000,NA,income_statement,Biotechnology,"Sunesis Pharmaceuticals, Inc.","Sunesis Pharmaceuticals, Inc., a biopharmaceutical company, focuses on the development and commercialization of targeted inhibitors for the treatment of hematologic and solid cancers. Its lead product candidate is vecabrutinib, a non-covalent inhibitor of Bruton's tyrosine kinase (BTK), which is in Phase 1b/2 clinical trial for the treatment of chronic lymphocytic leukemia, mantle cell lymphoma, and other B-cell malignancies. The company is also developing SNS-510, which is in preclinical pharmacology studies for the treatment of solid tumor and hematologic malignancies; various other partnered programs, such as TAK-580, a pan-Raf inhibitor program that is in Phase 1 clinical trial for the treatment of pediatric low-grade glioma; and vosaroxin, an anti-cancer quinolone derivative that intercalates DNA and inhibits topoisomerase II. It has a collaboration agreement with Biogen Idec MA, Inc. to discover, develop, and commercialize small molecule BTK inhibitors; and license agreement with Takeda Pharmaceutical Company Limited to develop and commercialize preclinical inhibitors of PDK1. Sunesis Pharmaceuticals, Inc. was founded in 1998 and is headquartered in South San Francisco, California."
SNSS,2018-12-31,14615000,-26615000,NA,-26615000,11332000,237000,-25710000,-25710000,-1154000,0,237000,25947000,0,-905000,NA,-26615000,-26615000,NA,income_statement,Biotechnology,"Sunesis Pharmaceuticals, Inc.","Sunesis Pharmaceuticals, Inc., a biopharmaceutical company, focuses on the development and commercialization of targeted inhibitors for the treatment of hematologic and solid cancers. Its lead product candidate is vecabrutinib, a non-covalent inhibitor of Bruton's tyrosine kinase (BTK), which is in Phase 1b/2 clinical trial for the treatment of chronic lymphocytic leukemia, mantle cell lymphoma, and other B-cell malignancies. The company is also developing SNS-510, which is in preclinical pharmacology studies for the treatment of solid tumor and hematologic malignancies; various other partnered programs, such as TAK-580, a pan-Raf inhibitor program that is in Phase 1 clinical trial for the treatment of pediatric low-grade glioma; and vosaroxin, an anti-cancer quinolone derivative that intercalates DNA and inhibits topoisomerase II. It has a collaboration agreement with Biogen Idec MA, Inc. to discover, develop, and commercialize small molecule BTK inhibitors; and license agreement with Takeda Pharmaceutical Company Limited to develop and commercialize preclinical inhibitors of PDK1. Sunesis Pharmaceuticals, Inc. was founded in 1998 and is headquartered in South San Francisco, California."
SNSS,2019-12-31,15412000,-23330000,NA,-23330000,9949000,2073000,-23288000,-23288000,-514000,0,2073000,25361000,0,-42000,NA,-23330000,-23330000,NA,income_statement,Biotechnology,"Sunesis Pharmaceuticals, Inc.","Sunesis Pharmaceuticals, Inc., a biopharmaceutical company, focuses on the development and commercialization of targeted inhibitors for the treatment of hematologic and solid cancers. Its lead product candidate is vecabrutinib, a non-covalent inhibitor of Bruton's tyrosine kinase (BTK), which is in Phase 1b/2 clinical trial for the treatment of chronic lymphocytic leukemia, mantle cell lymphoma, and other B-cell malignancies. The company is also developing SNS-510, which is in preclinical pharmacology studies for the treatment of solid tumor and hematologic malignancies; various other partnered programs, such as TAK-580, a pan-Raf inhibitor program that is in Phase 1 clinical trial for the treatment of pediatric low-grade glioma; and vosaroxin, an anti-cancer quinolone derivative that intercalates DNA and inhibits topoisomerase II. It has a collaboration agreement with Biogen Idec MA, Inc. to discover, develop, and commercialize small molecule BTK inhibitors; and license agreement with Takeda Pharmaceutical Company Limited to develop and commercialize preclinical inhibitors of PDK1. Sunesis Pharmaceuticals, Inc. was founded in 1998 and is headquartered in South San Francisco, California."
SNY,2017-12-31,5472000000,5616000000,169000000,8416000000,10164000000,24774000000,7273000000,7273000000,-346000000,1722000000,36221000000,28948000000,11447000000,-1657000000,4643000000,3894000000,8416000000,-1000000,income_statement,Drug Manufacturers—General,Sanofi,"Sanofi provides therapeutic solutions worldwide. It offers Cerezyme and Cerdelga for Gaucher, Myozyme and Lumizyme for Pompe, Fabrazyme for Fabry, and Aldurazyme for mucopolysaccharidosis Type 1; and Aubagio and Lemtrada for multiple sclerosis. It also provides Dupixent for atopic dermatitis; Kevzara for rheumatoid arthritis; Eloctate and Alprolix to treat hemophilia; and Cablivi to treat acquired thrombotic thrombocytopenic purpura. In addition, it offers Libtayo for metastatic cutaneous squamous cell carcinoma; Jevtana and Taxotere taxane for cancers; Eloxatin for colon cancer; Thymoglobulin, an immunosuppressive and immunomodulating agent; Mozobil for hematologic malignancies; and Zaltrap for metastatic colorectal cancer. Further, it provides Lantus, Toujeo, Apidra, and Insuman insulins; Amaryl sulfonylurea; Adlyxin/Lyxumia, a GLP-1 receptor agonist; Soliqua 100/33/Suliqua, an insulin glargine and lixisenatide combination to treat diabetes; Admelog/Insulin lispro insulin; Praluent, a cholesterol-lowering drug; and Multaq, an anti-arrhythmic drug. Additionally, it offers Plavix for atherothrombotic conditions; Lovenox for the prophylaxis, venous thromboembolism, and acute coronary syndrome; Aprovel and CoAprovel anti-hypertensives; Renagel and Renvela for patients undergoing dialysis; Synvisc and Synvisc-One viscosupplements for osteoarthritis; Stilnox for insomnia; Allegra for seasonal allergic rhinitis and uncomplicated hives; and Depakine for epilepsy. It also provides generic products; and products for allergy, cough, cold, pain, nutrition, digestion, pediatrics, influenza, meningitis, travel, and endemic vaccines; and adult and adolescent boosters. Sanofi has collaborations with Verily Life Sciences LLC; Happify Health; GlaxoSmithKline Plc; Kymera Therapeutics; Parkinson's Foundation, Inc.; and Nurix Therapeutics, Inc. The company was formerly known as Sanofi-Aventis. Sanofi was incorporated in 1994 and is headquartered in Paris, France."
SNY,2018-12-31,5894000000,4904000000,159000000,4306000000,9934000000,24356000000,6024000000,6024000000,-471000000,481000000,35677000000,29653000000,11321000000,-1120000000,-13000000,4423000000,4306000000,334000000,income_statement,Drug Manufacturers—General,Sanofi,"Sanofi provides therapeutic solutions worldwide. It offers Cerezyme and Cerdelga for Gaucher, Myozyme and Lumizyme for Pompe, Fabrazyme for Fabry, and Aldurazyme for mucopolysaccharidosis Type 1; and Aubagio and Lemtrada for multiple sclerosis. It also provides Dupixent for atopic dermatitis; Kevzara for rheumatoid arthritis; Eloctate and Alprolix to treat hemophilia; and Cablivi to treat acquired thrombotic thrombocytopenic purpura. In addition, it offers Libtayo for metastatic cutaneous squamous cell carcinoma; Jevtana and Taxotere taxane for cancers; Eloxatin for colon cancer; Thymoglobulin, an immunosuppressive and immunomodulating agent; Mozobil for hematologic malignancies; and Zaltrap for metastatic colorectal cancer. Further, it provides Lantus, Toujeo, Apidra, and Insuman insulins; Amaryl sulfonylurea; Adlyxin/Lyxumia, a GLP-1 receptor agonist; Soliqua 100/33/Suliqua, an insulin glargine and lixisenatide combination to treat diabetes; Admelog/Insulin lispro insulin; Praluent, a cholesterol-lowering drug; and Multaq, an anti-arrhythmic drug. Additionally, it offers Plavix for atherothrombotic conditions; Lovenox for the prophylaxis, venous thromboembolism, and acute coronary syndrome; Aprovel and CoAprovel anti-hypertensives; Renagel and Renvela for patients undergoing dialysis; Synvisc and Synvisc-One viscosupplements for osteoarthritis; Stilnox for insomnia; Allegra for seasonal allergic rhinitis and uncomplicated hives; and Depakine for epilepsy. It also provides generic products; and products for allergy, cough, cold, pain, nutrition, digestion, pediatrics, influenza, meningitis, travel, and endemic vaccines; and adult and adolescent boosters. Sanofi has collaborations with Verily Life Sciences LLC; Happify Health; GlaxoSmithKline Plc; Kymera Therapeutics; Parkinson's Foundation, Inc.; and Nurix Therapeutics, Inc. The company was formerly known as Sanofi-Aventis. Sanofi was incorporated in 1994 and is headquartered in Paris, France."
SNY,2019-12-31,6018000000,3077000000,174000000,2806000000,9970000000,25658000000,6846000000,6846000000,-544000000,139000000,37631000000,30785000000,11973000000,-3769000000,-101000000,2938000000,2806000000,678000000,income_statement,Drug Manufacturers—General,Sanofi,"Sanofi provides therapeutic solutions worldwide. It offers Cerezyme and Cerdelga for Gaucher, Myozyme and Lumizyme for Pompe, Fabrazyme for Fabry, and Aldurazyme for mucopolysaccharidosis Type 1; and Aubagio and Lemtrada for multiple sclerosis. It also provides Dupixent for atopic dermatitis; Kevzara for rheumatoid arthritis; Eloctate and Alprolix to treat hemophilia; and Cablivi to treat acquired thrombotic thrombocytopenic purpura. In addition, it offers Libtayo for metastatic cutaneous squamous cell carcinoma; Jevtana and Taxotere taxane for cancers; Eloxatin for colon cancer; Thymoglobulin, an immunosuppressive and immunomodulating agent; Mozobil for hematologic malignancies; and Zaltrap for metastatic colorectal cancer. Further, it provides Lantus, Toujeo, Apidra, and Insuman insulins; Amaryl sulfonylurea; Adlyxin/Lyxumia, a GLP-1 receptor agonist; Soliqua 100/33/Suliqua, an insulin glargine and lixisenatide combination to treat diabetes; Admelog/Insulin lispro insulin; Praluent, a cholesterol-lowering drug; and Multaq, an anti-arrhythmic drug. Additionally, it offers Plavix for atherothrombotic conditions; Lovenox for the prophylaxis, venous thromboembolism, and acute coronary syndrome; Aprovel and CoAprovel anti-hypertensives; Renagel and Renvela for patients undergoing dialysis; Synvisc and Synvisc-One viscosupplements for osteoarthritis; Stilnox for insomnia; Allegra for seasonal allergic rhinitis and uncomplicated hives; and Depakine for epilepsy. It also provides generic products; and products for allergy, cough, cold, pain, nutrition, digestion, pediatrics, influenza, meningitis, travel, and endemic vaccines; and adult and adolescent boosters. Sanofi has collaborations with Verily Life Sciences LLC; Happify Health; GlaxoSmithKline Plc; Kymera Therapeutics; Parkinson's Foundation, Inc.; and Nurix Therapeutics, Inc. The company was formerly known as Sanofi-Aventis. Sanofi was incorporated in 1994 and is headquartered in Paris, France."
SNY,2020-12-31,5529000000,14163000000,146000000,12314000000,9390000000,25212000000,7893000000,7893000000,-390000000,1813000000,37369000000,29476000000,12157000000,6270000000,NA,12350000000,12314000000,719000000,income_statement,Drug Manufacturers—General,Sanofi,"Sanofi provides therapeutic solutions worldwide. It offers Cerezyme and Cerdelga for Gaucher, Myozyme and Lumizyme for Pompe, Fabrazyme for Fabry, and Aldurazyme for mucopolysaccharidosis Type 1; and Aubagio and Lemtrada for multiple sclerosis. It also provides Dupixent for atopic dermatitis; Kevzara for rheumatoid arthritis; Eloctate and Alprolix to treat hemophilia; and Cablivi to treat acquired thrombotic thrombocytopenic purpura. In addition, it offers Libtayo for metastatic cutaneous squamous cell carcinoma; Jevtana and Taxotere taxane for cancers; Eloxatin for colon cancer; Thymoglobulin, an immunosuppressive and immunomodulating agent; Mozobil for hematologic malignancies; and Zaltrap for metastatic colorectal cancer. Further, it provides Lantus, Toujeo, Apidra, and Insuman insulins; Amaryl sulfonylurea; Adlyxin/Lyxumia, a GLP-1 receptor agonist; Soliqua 100/33/Suliqua, an insulin glargine and lixisenatide combination to treat diabetes; Admelog/Insulin lispro insulin; Praluent, a cholesterol-lowering drug; and Multaq, an anti-arrhythmic drug. Additionally, it offers Plavix for atherothrombotic conditions; Lovenox for the prophylaxis, venous thromboembolism, and acute coronary syndrome; Aprovel and CoAprovel anti-hypertensives; Renagel and Renvela for patients undergoing dialysis; Synvisc and Synvisc-One viscosupplements for osteoarthritis; Stilnox for insomnia; Allegra for seasonal allergic rhinitis and uncomplicated hives; and Depakine for epilepsy. It also provides generic products; and products for allergy, cough, cold, pain, nutrition, digestion, pediatrics, influenza, meningitis, travel, and endemic vaccines; and adult and adolescent boosters. Sanofi has collaborations with Verily Life Sciences LLC; Happify Health; GlaxoSmithKline Plc; Kymera Therapeutics; Parkinson's Foundation, Inc.; and Nurix Therapeutics, Inc. The company was formerly known as Sanofi-Aventis. Sanofi was incorporated in 1994 and is headquartered in Paris, France."
SO,2016-12-31,NA,3435000000,2136000000,2448000000,-235000000,8530000000,4487000000,4487000000,-1362000000,951000000,19896000000,15409000000,11366000000,-1052000000,NA,2484000000,2448000000,1541000000,income_statement,NA,NA,NA
SO,2017-12-31,NA,1030000000,1685000000,842000000,-235000000,9915000000,2528000000,2528000000,-1732000000,142000000,23031000000,20503000000,13116000000,-1498000000,NA,888000000,842000000,4612000000,income_statement,NA,NA,NA
SO,2018-12-31,NA,2733000000,4607000000,2226000000,-235000000,9664000000,4356000000,4356000000,-1858000000,449000000,23495000000,19139000000,13831000000,-1623000000,NA,2284000000,2226000000,2412000000,income_statement,NA,NA,NA
SO,2019-12-31,NA,6527000000,4545000000,4739000000,-267000000,9627000000,5602000000,5602000000,-1751000000,1798000000,21419000000,15817000000,11792000000,925000000,NA,4729000000,4739000000,1254000000,income_statement,NA,NA,NA
SOHO,2016-12-31,NA,-467485,2329175,926716,6021065,40012581,18972445,18972445,-17735107,-1367634,152845752,133873307,112833171,-19439930,NA,900149,-218173,NA,income_statement,REIT—Hotel & Motel,Sotherly Hotels Inc.,"Sotherly Hotels Inc. is a self-managed and self-administered lodging REIT focused on the acquisition, renovation, upbranding and repositioning of upscale to upper-upscale full-service hotels in the Southern United States. Currently, the Company's portfolio consists of investments in twelve hotel properties, comprising 3,156 rooms, as well as interests in two condominium hotels and their associated rental programs. The Company owns hotels that operate under the Hilton Worldwide, Hyatt Hotels Corporation, and Marriott International, Inc. brands, as well as independent hotels. Sotherly Hotels Inc. was organized in 2004 and is headquartered in Williamsburg, Virginia."
SOHO,2017-12-31,NA,1767293,1154775,442503,6335926,40389325,17053780,17053780,-15727628,1737804,153666693,136612913,113277368,-15286487,NA,29489,-3339136,NA,income_statement,REIT—Hotel & Motel,Sotherly Hotels Inc.,"Sotherly Hotels Inc. is a self-managed and self-administered lodging REIT focused on the acquisition, renovation, upbranding and repositioning of upscale to upper-upscale full-service hotels in the Southern United States. Currently, the Company's portfolio consists of investments in twelve hotel properties, comprising 3,156 rooms, as well as interests in two condominium hotels and their associated rental programs. The Company owns hotels that operate under the Hilton Worldwide, Hyatt Hotels Corporation, and Marriott International, Inc. brands, as well as independent hotels. Sotherly Hotels Inc. was organized in 2004 and is headquartered in Williamsburg, Virginia."
SOHO,2018-12-31,NA,-138808,441706,109936,6180962,46883665,19818060,19818060,-19953746,469349,177373121,157555061,130489456,-19956868,NA,-608157,-5719978,NA,income_statement,REIT—Hotel & Motel,Sotherly Hotels Inc.,"Sotherly Hotels Inc. is a self-managed and self-administered lodging REIT focused on the acquisition, renovation, upbranding and repositioning of upscale to upper-upscale full-service hotels in the Southern United States. Currently, the Company's portfolio consists of investments in twelve hotel properties, comprising 3,156 rooms, as well as interests in two condominium hotels and their associated rental programs. The Company owns hotels that operate under the Hilton Worldwide, Hyatt Hotels Corporation, and Marriott International, Inc. brands, as well as independent hotels. Sotherly Hotels Inc. was organized in 2004 and is headquartered in Williamsburg, Virginia."
SOHO,2019-12-31,NA,926088,-1198732,1909444,6830354,46937924,18470254,18470254,-19768193,-249480,185788133,167317879,138850209,-17544166,NA,1175568,-5911251,NA,income_statement,REIT—Hotel & Motel,Sotherly Hotels Inc.,"Sotherly Hotels Inc. is a self-managed and self-administered lodging REIT focused on the acquisition, renovation, upbranding and repositioning of upscale to upper-upscale full-service hotels in the Southern United States. Currently, the Company's portfolio consists of investments in twelve hotel properties, comprising 3,156 rooms, as well as interests in two condominium hotels and their associated rental programs. The Company owns hotels that operate under the Hilton Worldwide, Hyatt Hotels Corporation, and Marriott International, Inc. brands, as well as independent hotels. Sotherly Hotels Inc. was organized in 2004 and is headquartered in Williamsburg, Virginia."
SOHOB,2016-12-31,NA,-467485,2329175,926716,6021065,40012581,18972445,18972445,-17735107,-1367634,152845752,133873307,112833171,-19439930,NA,900149,-218173,NA,income_statement,REIT—Hotel & Motel,Sotherly Hotels Inc. - 8.0% Ser,"Sotherly Hotels Inc. is a self-managed and self-administered lodging REIT focused on the acquisition, renovation, upbranding and repositioning of upscale to upper-upscale full-service hotels in the Southern United States. Currently, the Company's portfolio consists of investments in twelve hotel properties, comprising 3,156 rooms, as well as interests in two condominium hotels and their associated rental programs. The Company owns hotels that operate under the Hilton Worldwide, Hyatt Hotels Corporation, and Marriott International, Inc. brands, as well as independent hotels. Sotherly Hotels Inc. was organized in 2004 and is headquartered in Williamsburg, Virginia."
SOHOB,2017-12-31,NA,1767293,1154775,442503,6335926,40389325,17053780,17053780,-15727628,1737804,153666693,136612913,113277368,-15286487,NA,29489,-3339136,NA,income_statement,REIT—Hotel & Motel,Sotherly Hotels Inc. - 8.0% Ser,"Sotherly Hotels Inc. is a self-managed and self-administered lodging REIT focused on the acquisition, renovation, upbranding and repositioning of upscale to upper-upscale full-service hotels in the Southern United States. Currently, the Company's portfolio consists of investments in twelve hotel properties, comprising 3,156 rooms, as well as interests in two condominium hotels and their associated rental programs. The Company owns hotels that operate under the Hilton Worldwide, Hyatt Hotels Corporation, and Marriott International, Inc. brands, as well as independent hotels. Sotherly Hotels Inc. was organized in 2004 and is headquartered in Williamsburg, Virginia."
SOHOB,2018-12-31,NA,-138808,441706,109936,6180962,46883665,19818060,19818060,-19953746,469349,177373121,157555061,130489456,-19956868,NA,-608157,-5719978,NA,income_statement,REIT—Hotel & Motel,Sotherly Hotels Inc. - 8.0% Ser,"Sotherly Hotels Inc. is a self-managed and self-administered lodging REIT focused on the acquisition, renovation, upbranding and repositioning of upscale to upper-upscale full-service hotels in the Southern United States. Currently, the Company's portfolio consists of investments in twelve hotel properties, comprising 3,156 rooms, as well as interests in two condominium hotels and their associated rental programs. The Company owns hotels that operate under the Hilton Worldwide, Hyatt Hotels Corporation, and Marriott International, Inc. brands, as well as independent hotels. Sotherly Hotels Inc. was organized in 2004 and is headquartered in Williamsburg, Virginia."
SOHOB,2019-12-31,NA,926088,-1198732,1909444,6830354,46937924,18470254,18470254,-19768193,-249480,185788133,167317879,138850209,-17544166,NA,1175568,-5911251,NA,income_statement,REIT—Hotel & Motel,Sotherly Hotels Inc. - 8.0% Ser,"Sotherly Hotels Inc. is a self-managed and self-administered lodging REIT focused on the acquisition, renovation, upbranding and repositioning of upscale to upper-upscale full-service hotels in the Southern United States. Currently, the Company's portfolio consists of investments in twelve hotel properties, comprising 3,156 rooms, as well as interests in two condominium hotels and their associated rental programs. The Company owns hotels that operate under the Hilton Worldwide, Hyatt Hotels Corporation, and Marriott International, Inc. brands, as well as independent hotels. Sotherly Hotels Inc. was organized in 2004 and is headquartered in Williamsburg, Virginia."
SOHON,2016-12-31,NA,-467485,2329175,926716,6021065,40012581,18972445,18972445,-17735107,-1367634,152845752,133873307,112833171,-19439930,NA,900149,-218173,NA,income_statement,REIT—Hotel & Motel,Sotherly Hotels Inc. - 8.25% Se,"Sotherly Hotels Inc. is a self-managed and self-administered lodging REIT focused on the acquisition, renovation, upbranding and repositioning of upscale to upper-upscale full-service hotels in the Southern United States. Currently, the Company's portfolio consists of investments in twelve hotel properties, comprising 3,156 rooms, as well as interests in two condominium hotels and their associated rental programs. The Company owns hotels that operate under the Hilton Worldwide, Hyatt Hotels Corporation, and Marriott International, Inc. brands, as well as independent hotels. Sotherly Hotels Inc. was organized in 2004 and is headquartered in Williamsburg, Virginia."
SOHON,2017-12-31,NA,1767293,1154775,442503,6335926,40389325,17053780,17053780,-15727628,1737804,153666693,136612913,113277368,-15286487,NA,29489,-3339136,NA,income_statement,REIT—Hotel & Motel,Sotherly Hotels Inc. - 8.25% Se,"Sotherly Hotels Inc. is a self-managed and self-administered lodging REIT focused on the acquisition, renovation, upbranding and repositioning of upscale to upper-upscale full-service hotels in the Southern United States. Currently, the Company's portfolio consists of investments in twelve hotel properties, comprising 3,156 rooms, as well as interests in two condominium hotels and their associated rental programs. The Company owns hotels that operate under the Hilton Worldwide, Hyatt Hotels Corporation, and Marriott International, Inc. brands, as well as independent hotels. Sotherly Hotels Inc. was organized in 2004 and is headquartered in Williamsburg, Virginia."
SOHON,2018-12-31,NA,-138808,441706,109936,6180962,46883665,19818060,19818060,-19953746,469349,177373121,157555061,130489456,-19956868,NA,-608157,-5719978,NA,income_statement,REIT—Hotel & Motel,Sotherly Hotels Inc. - 8.25% Se,"Sotherly Hotels Inc. is a self-managed and self-administered lodging REIT focused on the acquisition, renovation, upbranding and repositioning of upscale to upper-upscale full-service hotels in the Southern United States. Currently, the Company's portfolio consists of investments in twelve hotel properties, comprising 3,156 rooms, as well as interests in two condominium hotels and their associated rental programs. The Company owns hotels that operate under the Hilton Worldwide, Hyatt Hotels Corporation, and Marriott International, Inc. brands, as well as independent hotels. Sotherly Hotels Inc. was organized in 2004 and is headquartered in Williamsburg, Virginia."
SOHON,2019-12-31,NA,926088,-1198732,1909444,6830354,46937924,18470254,18470254,-19768193,-249480,185788133,167317879,138850209,-17544166,NA,1175568,-5911251,NA,income_statement,REIT—Hotel & Motel,Sotherly Hotels Inc. - 8.25% Se,"Sotherly Hotels Inc. is a self-managed and self-administered lodging REIT focused on the acquisition, renovation, upbranding and repositioning of upscale to upper-upscale full-service hotels in the Southern United States. Currently, the Company's portfolio consists of investments in twelve hotel properties, comprising 3,156 rooms, as well as interests in two condominium hotels and their associated rental programs. The Company owns hotels that operate under the Hilton Worldwide, Hyatt Hotels Corporation, and Marriott International, Inc. brands, as well as independent hotels. Sotherly Hotels Inc. was organized in 2004 and is headquartered in Williamsburg, Virginia."
SOHOO,2016-12-31,NA,-467485,2329175,926716,6021065,40012581,18972445,18972445,-17735107,-1367634,152845752,133873307,112833171,-19439930,NA,900149,-218173,NA,income_statement,REIT—Hotel & Motel,Sotherly Hotels Inc. - 7.875% S,"Sotherly Hotels Inc. is a self-managed and self-administered lodging REIT focused on the acquisition, renovation, upbranding and repositioning of upscale to upper-upscale full-service hotels in the Southern United States. Currently, the Company's portfolio consists of investments in twelve hotel properties, comprising 3,156 rooms, as well as interests in two condominium hotels and their associated rental programs. The Company owns hotels that operate under the Hilton Worldwide, Hyatt Hotels Corporation, and Marriott International, Inc. brands, as well as independent hotels. Sotherly Hotels Inc. was organized in 2004 and is headquartered in Williamsburg, Virginia."
SOHOO,2017-12-31,NA,1767293,1154775,442503,6335926,40389325,17053780,17053780,-15727628,1737804,153666693,136612913,113277368,-15286487,NA,29489,-3339136,NA,income_statement,REIT—Hotel & Motel,Sotherly Hotels Inc. - 7.875% S,"Sotherly Hotels Inc. is a self-managed and self-administered lodging REIT focused on the acquisition, renovation, upbranding and repositioning of upscale to upper-upscale full-service hotels in the Southern United States. Currently, the Company's portfolio consists of investments in twelve hotel properties, comprising 3,156 rooms, as well as interests in two condominium hotels and their associated rental programs. The Company owns hotels that operate under the Hilton Worldwide, Hyatt Hotels Corporation, and Marriott International, Inc. brands, as well as independent hotels. Sotherly Hotels Inc. was organized in 2004 and is headquartered in Williamsburg, Virginia."
SOHOO,2018-12-31,NA,-138808,441706,109936,6180962,46883665,19818060,19818060,-19953746,469349,177373121,157555061,130489456,-19956868,NA,-608157,-5719978,NA,income_statement,REIT—Hotel & Motel,Sotherly Hotels Inc. - 7.875% S,"Sotherly Hotels Inc. is a self-managed and self-administered lodging REIT focused on the acquisition, renovation, upbranding and repositioning of upscale to upper-upscale full-service hotels in the Southern United States. Currently, the Company's portfolio consists of investments in twelve hotel properties, comprising 3,156 rooms, as well as interests in two condominium hotels and their associated rental programs. The Company owns hotels that operate under the Hilton Worldwide, Hyatt Hotels Corporation, and Marriott International, Inc. brands, as well as independent hotels. Sotherly Hotels Inc. was organized in 2004 and is headquartered in Williamsburg, Virginia."
SOHOO,2019-12-31,NA,926088,-1198732,1909444,6830354,46937924,18470254,18470254,-19768193,-249480,185788133,167317879,138850209,-17544166,NA,1175568,-5911251,NA,income_statement,REIT—Hotel & Motel,Sotherly Hotels Inc. - 7.875% S,"Sotherly Hotels Inc. is a self-managed and self-administered lodging REIT focused on the acquisition, renovation, upbranding and repositioning of upscale to upper-upscale full-service hotels in the Southern United States. Currently, the Company's portfolio consists of investments in twelve hotel properties, comprising 3,156 rooms, as well as interests in two condominium hotels and their associated rental programs. The Company owns hotels that operate under the Hilton Worldwide, Hyatt Hotels Corporation, and Marriott International, Inc. brands, as well as independent hotels. Sotherly Hotels Inc. was organized in 2004 and is headquartered in Williamsburg, Virginia."
SOHU,2017-12-31,412173000,-176836000,1066603000,-554526000,509464000,889921000,-31716000,-31716000,-4088000,272636000,1769589000,1801305000,879668000,-145120000,-13978000,-449472000,-554526000,NA,income_statement,Internet Content & Information,Sohu.com Limited,"Sohu.com Limited provides online media, search, and game services on personal computers (PCs) and mobile devices in the People's Republic of China. The company provides online news and information through a mobile phone application, Sohu News APP; sohu.com for PCs; and m.sohu.com mobile portal, as well as online video content and service through tv.sohu.com for PCs, as well as Sohu Video APP mobile phone application. It also operates focus.cn, which provides online real estate information and services; and offers paid subscription services, interactive broadcasting services, and content through various platforms. In addition, the company operates Sogou Search, which makes information accessible for Chinese Internet users; Sogou Input Method, a cloud-based Chinese language input software; Sogou Browser for Web navigation; Sogou Web Directory, a content aggregation and distribution platform; and Sogou Translation to deliver language translation, as well as offers auction-based pay-for-click services for advertisers. Further, it offers Internet value-added services, including the operation of Web and mobile games developed by third parties; online reading services and smart hardware products; online games; and cinema advertising services. Additionally, the company operates 17173.com Website, a game information portal; and RaidCall, which provides online music and entertainment services. Sohu.com Inc. was founded in 1996 and is headquartered in Beijing, the People's Republic of China."
SOHU,2018-12-31,441161000,-35957000,964111000,-160082000,489054000,840741000,-89474000,-89474000,-17538000,-13433000,1812827000,1902301000,972086000,53517000,-30240000,-22524000,-160082000,NA,income_statement,Internet Content & Information,Sohu.com Limited,"Sohu.com Limited provides online media, search, and game services on personal computers (PCs) and mobile devices in the People's Republic of China. The company provides online news and information through a mobile phone application, Sohu News APP; sohu.com for PCs; and m.sohu.com mobile portal, as well as online video content and service through tv.sohu.com for PCs, as well as Sohu Video APP mobile phone application. It also operates focus.cn, which provides online real estate information and services; and offers paid subscription services, interactive broadcasting services, and content through various platforms. In addition, the company operates Sogou Search, which makes information accessible for Chinese Internet users; Sogou Input Method, a cloud-based Chinese language input software; Sogou Browser for Web navigation; Sogou Web Directory, a content aggregation and distribution platform; and Sogou Translation to deliver language translation, as well as offers auction-based pay-for-click services for advertisers. Further, it offers Internet value-added services, including the operation of Web and mobile games developed by third parties; online reading services and smart hardware products; online games; and cinema advertising services. Additionally, the company operates 17173.com Website, a game information portal; and RaidCall, which provides online music and entertainment services. Sohu.com Inc. was founded in 1996 and is headquartered in Beijing, the People's Republic of China."
SOHU,2019-12-31,419114000,21783000,878463000,-149336000,436613000,867352000,11625000,11625000,-14370000,31176000,1845447000,1833822000,978095000,10158000,-22766000,-9393000,-149336000,NA,income_statement,Internet Content & Information,Sohu.com Limited,"Sohu.com Limited provides online media, search, and game services on personal computers (PCs) and mobile devices in the People's Republic of China. The company provides online news and information through a mobile phone application, Sohu News APP; sohu.com for PCs; and m.sohu.com mobile portal, as well as online video content and service through tv.sohu.com for PCs, as well as Sohu Video APP mobile phone application. It also operates focus.cn, which provides online real estate information and services; and offers paid subscription services, interactive broadcasting services, and content through various platforms. In addition, the company operates Sogou Search, which makes information accessible for Chinese Internet users; Sogou Input Method, a cloud-based Chinese language input software; Sogou Browser for Web navigation; Sogou Web Directory, a content aggregation and distribution platform; and Sogou Translation to deliver language translation, as well as offers auction-based pay-for-click services for advertisers. Further, it offers Internet value-added services, including the operation of Web and mobile games developed by third parties; online reading services and smart hardware products; online games; and cinema advertising services. Additionally, the company operates 17173.com Website, a game information portal; and RaidCall, which provides online music and entertainment services. Sohu.com Inc. was founded in 1996 and is headquartered in Beijing, the People's Republic of China."
SOHU,2020-12-31,241941000,96699000,684612000,-86112000,217141000,532453000,73371000,73371000,-6234000,133226000,749890000,676519000,217437000,23328000,-31137000,-36527000,-86112000,NA,income_statement,Internet Content & Information,Sohu.com Limited,"Sohu.com Limited provides online media, search, and game services on personal computers (PCs) and mobile devices in the People's Republic of China. The company provides online news and information through a mobile phone application, Sohu News APP; sohu.com for PCs; and m.sohu.com mobile portal, as well as online video content and service through tv.sohu.com for PCs, as well as Sohu Video APP mobile phone application. It also operates focus.cn, which provides online real estate information and services; and offers paid subscription services, interactive broadcasting services, and content through various platforms. In addition, the company operates Sogou Search, which makes information accessible for Chinese Internet users; Sogou Input Method, a cloud-based Chinese language input software; Sogou Browser for Web navigation; Sogou Web Directory, a content aggregation and distribution platform; and Sogou Translation to deliver language translation, as well as offers auction-based pay-for-click services for advertisers. Further, it offers Internet value-added services, including the operation of Web and mobile games developed by third parties; online reading services and smart hardware products; online games; and cinema advertising services. Additionally, the company operates 17173.com Website, a game information portal; and RaidCall, which provides online music and entertainment services. Sohu.com Inc. was founded in 1996 and is headquartered in Beijing, the People's Republic of China."
SOLO,2016-12-31,2778295,-8973347,NA,-8973347,1415290,0,-8942022,-8942022,-25908,0,0,8942022,0,-31325,NA,-8973347,-8973347,NA,income_statement,Auto Manufacturers,Electrameccanica Vehicles Corp.,"Electrameccanica Vehicles Corp., a development-stage company, develops, manufactures, and sells electric vehicles in Canada. The company operates in two segments, Electric Vehicles and Custom Build Vehicles. Its flagship product is the SOLO, a single seat vehicle. The company is also developing Super SOLO, a sports car model; and Tofino, an all-electric two-seater roadster. It also develops and manufactures custom built vehicles. The company sells its vehicles online through electrameccanica.com Website, as well as through 10 retail locations. Electrameccanica Vehicles Corp. was founded in 2015 and is headquartered in Vancouver, Canada."
SOLO,2017-12-31,4430386,-11366372,NA,-11366372,3004632,45223,-9489156,-9489156,-69562,0,109173,9598329,63950,-1877216,NA,-11366372,-11366372,NA,income_statement,Auto Manufacturers,Electrameccanica Vehicles Corp.,"Electrameccanica Vehicles Corp., a development-stage company, develops, manufactures, and sells electric vehicles in Canada. The company operates in two segments, Electric Vehicles and Custom Build Vehicles. Its flagship product is the SOLO, a single seat vehicle. The company is also developing Super SOLO, a sports car model; and Tofino, an all-electric two-seater roadster. It also develops and manufactures custom built vehicles. The company sells its vehicles online through electrameccanica.com Website, as well as through 10 retail locations. Electrameccanica Vehicles Corp. was founded in 2015 and is headquartered in Vancouver, Canada."
SOLO,2018-12-31,5566036,-10039812,NA,-10038145,6877839,202130,-16858405,-16858405,NA,-1667,777302,17635707,575172,6818593,NA,-10038145,-10038145,NA,income_statement,Auto Manufacturers,Electrameccanica Vehicles Corp.,"Electrameccanica Vehicles Corp., a development-stage company, develops, manufactures, and sells electric vehicles in Canada. The company operates in two segments, Electric Vehicles and Custom Build Vehicles. Its flagship product is the SOLO, a single seat vehicle. The company is also developing Super SOLO, a sports car model; and Tofino, an all-electric two-seater roadster. It also develops and manufactures custom built vehicles. The company sells its vehicles online through electrameccanica.com Website, as well as through 10 retail locations. Electrameccanica Vehicles Corp. was founded in 2015 and is headquartered in Vancouver, Canada."
SOLO,2019-12-31,9514520,-30847110,NA,-30742311,9832384,129380,-27314471,-27314471,NA,-104799,775821,28090292,646441,-3532639,NA,-30742311,-30742311,NA,income_statement,Auto Manufacturers,Electrameccanica Vehicles Corp.,"Electrameccanica Vehicles Corp., a development-stage company, develops, manufactures, and sells electric vehicles in Canada. The company operates in two segments, Electric Vehicles and Custom Build Vehicles. Its flagship product is the SOLO, a single seat vehicle. The company is also developing Super SOLO, a sports car model; and Tofino, an all-electric two-seater roadster. It also develops and manufactures custom built vehicles. The company sells its vehicles online through electrameccanica.com Website, as well as through 10 retail locations. Electrameccanica Vehicles Corp. was founded in 2015 and is headquartered in Vancouver, Canada."
SOLY,2016-12-31,4146777,-7301259,NA,-7303571,3088691,0,-7317991,-7317991,-295830,2312,0,7317991,0,16732,NA,-7303571,-7303571,NA,income_statement,Medical Devices,"Soliton, Inc.","Soliton, Inc., a medical device company, develops and commercializes products using a proprietary rapid acoustic pulse technology platform. The company offers product for the removal of tattoos. It also develops product for cellulite reduction, fibrotic scar treatment, and other indications. The company was founded in 2012 and is based in Houston, Texas."
SOLY,2017-12-31,3965276,-7480624,NA,-7480624,3093257,0,-7188608,-7188608,-295830,0,0,7188608,0,-292016,NA,-7480624,-8760624,NA,income_statement,Medical Devices,"Soliton, Inc.","Soliton, Inc., a medical device company, develops and commercializes products using a proprietary rapid acoustic pulse technology platform. The company offers product for the removal of tattoos. It also develops product for cellulite reduction, fibrotic scar treatment, and other indications. The company was founded in 2012 and is based in Houston, Texas."
SOLY,2018-12-31,4669747,-9314936,NA,-9314936,3412414,0,-8202649,-8202649,-1115501,0,0,8202649,0,-1112287,NA,-9314936,-10594936,NA,income_statement,Medical Devices,"Soliton, Inc.","Soliton, Inc., a medical device company, develops and commercializes products using a proprietary rapid acoustic pulse technology platform. The company offers product for the removal of tattoos. It also develops product for cellulite reduction, fibrotic scar treatment, and other indications. The company was founded in 2012 and is based in Houston, Texas."
SOLY,2019-12-31,5108407,-13751877,NA,-13751877,7618244,0,-12943388,-12943388,-822858,0,0,12943388,0,-808489,NA,-13751877,-13912096,NA,income_statement,Medical Devices,"Soliton, Inc.","Soliton, Inc., a medical device company, develops and commercializes products using a proprietary rapid acoustic pulse technology platform. The company offers product for the removal of tattoos. It also develops product for cellulite reduction, fibrotic scar treatment, and other indications. The company was founded in 2012 and is based in Houston, Texas."
SONA,2017-12-31,NA,15572000,NA,2425000,31682000,64721000,0,26363000,NA,13147000,64721000,38358000,0,-10791000,NA,2425000,2425000,6676000,income_statement,Banks—Regional,Southern National Bancorp of Vi,"Southern National Bancorp of Virginia, Inc. operates as the bank holding company for Sonabank that provides commercial banking services to individuals and small and medium sized businesses in the United States. Its deposit products include noninterest-bearing and interest-bearing checking, commercial checking, money market, and savings accounts, as well as certificates of deposit. The company's loan portfolio comprises commercial mortgage and non-mortgage loans, including commercial real estate loans, construction and permanent loans, development and builder loans, accounts receivable financing, lines of credit, equipment and vehicle loans, leasing, and commercial overdraft protection; construction loans for commercial, multifamily, and other non-residential properties; commercial business loans, such as lines of credit, revolving credit facilities, demand loans, term loans, equipment loans, small business administration loans, stand-by letters of credit, and unsecured loans; residential mortgage lending; and secured and unsecured consumer loans. It also offers cash management services comprising investment/sweep, zero balance, and controlled disbursement accounts; and wire transfer, employer/payroll processing, night depository, lockbox, depository transfer, merchant, ACH origination, check 21 processing, and asset based lending, as well as mobile banking application services for personal and business accounts. In addition, the company provides other consumer/retail products and services that include debit and credit cards, ATM services, travelers' checks, notary services, and online banking services. As of December 31, 2019, it operated forty-five full-service branches, which included thirty-eight in Virginia and seven in Maryland. Southern National Bancorp of Virginia, Inc. was founded in 2004 and is based in McLean, Virginia."
SONA,2018-12-31,NA,43305000,NA,33691000,42693000,96715000,0,44760000,NA,9614000,96715000,51955000,0,-1455000,NA,33691000,33691000,9262000,income_statement,Banks—Regional,Southern National Bancorp of Vi,"Southern National Bancorp of Virginia, Inc. operates as the bank holding company for Sonabank that provides commercial banking services to individuals and small and medium sized businesses in the United States. Its deposit products include noninterest-bearing and interest-bearing checking, commercial checking, money market, and savings accounts, as well as certificates of deposit. The company's loan portfolio comprises commercial mortgage and non-mortgage loans, including commercial real estate loans, construction and permanent loans, development and builder loans, accounts receivable financing, lines of credit, equipment and vehicle loans, leasing, and commercial overdraft protection; construction loans for commercial, multifamily, and other non-residential properties; commercial business loans, such as lines of credit, revolving credit facilities, demand loans, term loans, equipment loans, small business administration loans, stand-by letters of credit, and unsecured loans; residential mortgage lending; and secured and unsecured consumer loans. It also offers cash management services comprising investment/sweep, zero balance, and controlled disbursement accounts; and wire transfer, employer/payroll processing, night depository, lockbox, depository transfer, merchant, ACH origination, check 21 processing, and asset based lending, as well as mobile banking application services for personal and business accounts. In addition, the company provides other consumer/retail products and services that include debit and credit cards, ATM services, travelers' checks, notary services, and online banking services. As of December 31, 2019, it operated forty-five full-service branches, which included thirty-eight in Virginia and seven in Maryland. Southern National Bancorp of Virginia, Inc. was founded in 2004 and is based in McLean, Virginia."
SONA,2019-12-31,NA,39244000,NA,33167000,42792000,95836000,0,37926000,NA,6077000,95836000,57910000,0,1318000,NA,33167000,33167000,15118000,income_statement,Banks—Regional,Southern National Bancorp of Vi,"Southern National Bancorp of Virginia, Inc. operates as the bank holding company for Sonabank that provides commercial banking services to individuals and small and medium sized businesses in the United States. Its deposit products include noninterest-bearing and interest-bearing checking, commercial checking, money market, and savings accounts, as well as certificates of deposit. The company's loan portfolio comprises commercial mortgage and non-mortgage loans, including commercial real estate loans, construction and permanent loans, development and builder loans, accounts receivable financing, lines of credit, equipment and vehicle loans, leasing, and commercial overdraft protection; construction loans for commercial, multifamily, and other non-residential properties; commercial business loans, such as lines of credit, revolving credit facilities, demand loans, term loans, equipment loans, small business administration loans, stand-by letters of credit, and unsecured loans; residential mortgage lending; and secured and unsecured consumer loans. It also offers cash management services comprising investment/sweep, zero balance, and controlled disbursement accounts; and wire transfer, employer/payroll processing, night depository, lockbox, depository transfer, merchant, ACH origination, check 21 processing, and asset based lending, as well as mobile banking application services for personal and business accounts. In addition, the company provides other consumer/retail products and services that include debit and credit cards, ATM services, travelers' checks, notary services, and online banking services. As of December 31, 2019, it operated forty-five full-service branches, which included thirty-eight in Virginia and seven in Maryland. Southern National Bancorp of Virginia, Inc. was founded in 2004 and is based in McLean, Virginia."
SONA,2020-12-31,NA,29901000,NA,23287000,54943000,97641000,0,32225000,NA,6614000,97641000,65416000,0,-2324000,NA,23287000,23287000,10473000,income_statement,Banks—Regional,Southern National Bancorp of Vi,"Southern National Bancorp of Virginia, Inc. operates as the bank holding company for Sonabank that provides commercial banking services to individuals and small and medium sized businesses in the United States. Its deposit products include noninterest-bearing and interest-bearing checking, commercial checking, money market, and savings accounts, as well as certificates of deposit. The company's loan portfolio comprises commercial mortgage and non-mortgage loans, including commercial real estate loans, construction and permanent loans, development and builder loans, accounts receivable financing, lines of credit, equipment and vehicle loans, leasing, and commercial overdraft protection; construction loans for commercial, multifamily, and other non-residential properties; commercial business loans, such as lines of credit, revolving credit facilities, demand loans, term loans, equipment loans, small business administration loans, stand-by letters of credit, and unsecured loans; residential mortgage lending; and secured and unsecured consumer loans. It also offers cash management services comprising investment/sweep, zero balance, and controlled disbursement accounts; and wire transfer, employer/payroll processing, night depository, lockbox, depository transfer, merchant, ACH origination, check 21 processing, and asset based lending, as well as mobile banking application services for personal and business accounts. In addition, the company provides other consumer/retail products and services that include debit and credit cards, ATM services, travelers' checks, notary services, and online banking services. As of December 31, 2019, it operated forty-five full-service branches, which included thirty-eight in Virginia and seven in Maryland. Southern National Bancorp of Virginia, Inc. was founded in 2004 and is based in McLean, Virginia."
SONM,2017-12-31,13008000,-8385000,NA,-8519000,14073000,20311000,-6770000,-6770000,-820000,134000,59031000,65801000,38720000,-1615000,NA,-8519000,-15355000,NA,income_statement,Communication Equipment,"Sonim Technologies, Inc.","Sonim Technologies, Inc. provides ruggedized mobile phones and accessories for task workers. It offers ruggedized mobile phones, such as Sonim XP8, Sonim XP5s, and Sonim XP3 based on the Android platform that are capable of attaching to public and private wireless networks; industrial-grade accessories, including remote speaker microphones, multi-bay charging accessories, and in-vehicle hands-free voice communications solutions; cloud-based software and application services; and Rapid Deployment Kit, a portable communications system. Sonim Technologies, Inc. sells its mobile phones and accessories primarily to wireless carriers in the United States and Canada. The company serves transportation and logistics, construction, manufacturing, facilities management, energy and utility, and public sectors. The company was formerly known as NaviSpin.com, Inc. and changed its name to Sonim Technologies, Inc. in December 2001. Sonim Technologies, Inc. was incorporated in 1999 and is headquartered in Austin, Texas."
SONM,2018-12-31,23247000,2031000,NA,1277000,19448000,48089000,5394000,5394000,-1828000,754000,135665000,130271000,87576000,-3363000,NA,1277000,-8875000,NA,income_statement,Communication Equipment,"Sonim Technologies, Inc.","Sonim Technologies, Inc. provides ruggedized mobile phones and accessories for task workers. It offers ruggedized mobile phones, such as Sonim XP8, Sonim XP5s, and Sonim XP3 based on the Android platform that are capable of attaching to public and private wireless networks; industrial-grade accessories, including remote speaker microphones, multi-bay charging accessories, and in-vehicle hands-free voice communications solutions; cloud-based software and application services; and Rapid Deployment Kit, a portable communications system. Sonim Technologies, Inc. sells its mobile phones and accessories primarily to wireless carriers in the United States and Canada. The company serves transportation and logistics, construction, manufacturing, facilities management, energy and utility, and public sectors. The company was formerly known as NaviSpin.com, Inc. and changed its name to Sonim Technologies, Inc. in December 2001. Sonim Technologies, Inc. was incorporated in 1999 and is headquartered in Austin, Texas."
SONM,2019-12-31,26064000,-24446000,NA,-25834000,30090000,37618000,-18536000,-18536000,-1522000,1388000,116251000,134787000,78633000,-5910000,NA,-25834000,-25834000,NA,income_statement,Communication Equipment,"Sonim Technologies, Inc.","Sonim Technologies, Inc. provides ruggedized mobile phones and accessories for task workers. It offers ruggedized mobile phones, such as Sonim XP8, Sonim XP5s, and Sonim XP3 based on the Android platform that are capable of attaching to public and private wireless networks; industrial-grade accessories, including remote speaker microphones, multi-bay charging accessories, and in-vehicle hands-free voice communications solutions; cloud-based software and application services; and Rapid Deployment Kit, a portable communications system. Sonim Technologies, Inc. sells its mobile phones and accessories primarily to wireless carriers in the United States and Canada. The company serves transportation and logistics, construction, manufacturing, facilities management, energy and utility, and public sectors. The company was formerly known as NaviSpin.com, Inc. and changed its name to Sonim Technologies, Inc. in December 2001. Sonim Technologies, Inc. was incorporated in 1999 and is headquartered in Austin, Texas."
SONN,2018-09-30,154717,-900270,NA,-900270,363877,0,-518594,-518594,-381676,0,0,518594,0,-381676,NA,-900270,-900270,NA,income_statement,Biotechnology,Sonnet BioTherapeutics Holdings,"Sonnet BioTherapeutics Holdings, Inc., an oncology-focused biotechnology company, develops platform for biologic medicines of single or bispecific action. The company develops fully human albumin binding (FHAB) technology, which utilizes human single chain antibodies fragment that binds to and hitch-hikes on human serum albumin for transport to target tissues. Its lead candidate includes SON-080, a human version of low dose Interleukin-6 (IL-6), which has completed Phase I trials for the treatment of patients with chemotherapy-induced peripheral neuropathy. The company is also developing SON-081, a low dose IL-6 for the treatment of patients with diabetic peripheral neuropathy and is under phase I trials; SON-1010, a FHAB derived compound, which utilizes a human version of Interleukin-12 (IL-12) is under pre-clinical trial, as well as SON-1210, a bi-specific construct that combines FHAB with IL-12 and human Interleukin-15 for the treatment of solid tumor is under pre-clinical trial. In addition, it develops SON-2014, a bi-specific combination of granulocyte-macrophage colony stimulating factor and Interleukin-18 for the treatment of cancer; and SON-3015, a bi-specific combination of anti-IL6 and anti-tumor growth factor beta for tumor and bone metastases. Sonnet BioTherapeutics Holdings, Inc. is based in Princeton, New Jersey."
SONN,2019-09-30,2199297,-4871211,NA,-4871211,2509041,0,-4708338,-4708338,-162873,0,0,4708338,0,-162873,NA,-4871211,-4871211,NA,income_statement,Biotechnology,Sonnet BioTherapeutics Holdings,"Sonnet BioTherapeutics Holdings, Inc., an oncology-focused biotechnology company, develops platform for biologic medicines of single or bispecific action. The company develops fully human albumin binding (FHAB) technology, which utilizes human single chain antibodies fragment that binds to and hitch-hikes on human serum albumin for transport to target tissues. Its lead candidate includes SON-080, a human version of low dose Interleukin-6 (IL-6), which has completed Phase I trials for the treatment of patients with chemotherapy-induced peripheral neuropathy. The company is also developing SON-081, a low dose IL-6 for the treatment of patients with diabetic peripheral neuropathy and is under phase I trials; SON-1010, a FHAB derived compound, which utilizes a human version of Interleukin-12 (IL-12) is under pre-clinical trial, as well as SON-1210, a bi-specific construct that combines FHAB with IL-12 and human Interleukin-15 for the treatment of solid tumor is under pre-clinical trial. In addition, it develops SON-2014, a bi-specific combination of granulocyte-macrophage colony stimulating factor and Interleukin-18 for the treatment of cancer; and SON-3015, a bi-specific combination of anti-IL6 and anti-tumor growth factor beta for tumor and bone metastases. Sonnet BioTherapeutics Holdings, Inc. is based in Princeton, New Jersey."
SONN,2020-09-30,9877555,-24265115,NA,-24265115,7533722,0,-17411277,-17411277,NA,0,0,17411277,0,-6853838,NA,-24265115,-65604049,NA,income_statement,Biotechnology,Sonnet BioTherapeutics Holdings,"Sonnet BioTherapeutics Holdings, Inc., an oncology-focused biotechnology company, develops platform for biologic medicines of single or bispecific action. The company develops fully human albumin binding (FHAB) technology, which utilizes human single chain antibodies fragment that binds to and hitch-hikes on human serum albumin for transport to target tissues. Its lead candidate includes SON-080, a human version of low dose Interleukin-6 (IL-6), which has completed Phase I trials for the treatment of patients with chemotherapy-induced peripheral neuropathy. The company is also developing SON-081, a low dose IL-6 for the treatment of patients with diabetic peripheral neuropathy and is under phase I trials; SON-1010, a FHAB derived compound, which utilizes a human version of Interleukin-12 (IL-12) is under pre-clinical trial, as well as SON-1210, a bi-specific construct that combines FHAB with IL-12 and human Interleukin-15 for the treatment of solid tumor is under pre-clinical trial. In addition, it develops SON-2014, a bi-specific combination of granulocyte-macrophage colony stimulating factor and Interleukin-18 for the treatment of cancer; and SON-3015, a bi-specific combination of anti-IL6 and anti-tumor growth factor beta for tumor and bone metastases. Sonnet BioTherapeutics Holdings, Inc. is based in Princeton, New Jersey."
SONO,2017-09-30,124394000,-16508000,NA,-14217000,347280000,456065000,-15609000,-15609000,-4380000,-2291000,992526000,1008135000,536461000,-899000,NA,-14217000,-14217000,NA,income_statement,Consumer Electronics,"Sonos, Inc.","Sonos, Inc., together with its subsidiaries, designs, develops, manufactures, and sells multi-room audio products in the Americas, Europe, the Middle East, Africa, and the Asia Pacific. The company provides wireless speakers, home theater speakers, components, and accessories. It offers its products through approximately 10,000 third-party retail stores, including custom installers of home audio systems; and e-commerce retailers, as well as through its Website sonos.com. The company was formerly known as Rincon Audio, Inc. and changed its name to Sonos, Inc. in May 2004. Sonos, Inc. was founded in 2002 and is headquartered in Santa Barbara, California."
SONO,2018-09-29,142109000,-14548000,NA,-15604000,356074000,489308000,-8875000,-8875000,-5242000,1056000,1137008000,1145883000,647700000,-5673000,NA,-15604000,-15604000,NA,income_statement,Consumer Electronics,"Sonos, Inc.","Sonos, Inc., together with its subsidiaries, designs, develops, manufactures, and sells multi-room audio products in the Americas, Europe, the Middle East, Africa, and the Asia Pacific. The company provides wireless speakers, home theater speakers, components, and accessories. It offers its products through approximately 10,000 third-party retail stores, including custom installers of home audio systems; and e-commerce retailers, as well as through its Website sonos.com. The company was formerly known as Rincon Audio, Inc. and changed its name to Sonos, Inc. in May 2004. Sonos, Inc. was founded in 2002 and is headquartered in Santa Barbara, California."
SONO,2019-09-28,171174000,-1076000,NA,-4766000,350470000,527343000,5699000,5699000,-2499000,3690000,1260823000,1255124000,733480000,-6775000,NA,-4766000,-4766000,NA,income_statement,Consumer Electronics,"Sonos, Inc.","Sonos, Inc., together with its subsidiaries, designs, develops, manufactures, and sells multi-room audio products in the Americas, Europe, the Middle East, Africa, and the Asia Pacific. The company provides wireless speakers, home theater speakers, components, and accessories. It offers its products through approximately 10,000 third-party retail stores, including custom installers of home audio systems; and e-commerce retailers, as well as through its Website sonos.com. The company was formerly known as Rincon Audio, Inc. and changed its name to Sonos, Inc. in May 2004. Sonos, Inc. was founded in 2002 and is headquartered in Santa Barbara, California."
SONO,2020-10-03,209598000,-20083000,NA,-20115000,361906000,571956000,452000,452000,-1487000,32000,1326328000,1325876000,754372000,-20535000,NA,-20115000,-20115000,NA,income_statement,Consumer Electronics,"Sonos, Inc.","Sonos, Inc., together with its subsidiaries, designs, develops, manufactures, and sells multi-room audio products in the Americas, Europe, the Middle East, Africa, and the Asia Pacific. The company provides wireless speakers, home theater speakers, components, and accessories. It offers its products through approximately 10,000 third-party retail stores, including custom installers of home audio systems; and e-commerce retailers, as well as through its Website sonos.com. The company was formerly known as Rincon Audio, Inc. and changed its name to Sonos, Inc. in May 2004. Sonos, Inc. was founded in 2002 and is headquartered in Santa Barbara, California."
SP,2017-12-31,NA,72200000,200000,41200000,81700000,185300000,82600000,82600000,-9200000,27700000,911300000,828700000,726000000,-10400000,NA,44500000,41200000,NA,income_statement,Specialty Business Services,SP Plus Corporation,"SP Plus Corporation provides parking management, ground transportation, baggage, and other ancillary services in North America. It provides on-site parking management, valet parking, ground transportation, facility maintenance, event logistics, baggage handling, remote airline check-in, security, municipal meter revenue collection and enforcement, and consulting services. The company also offers shuttle bus vehicles and the drivers; ground transportation services, such as taxi and livery dispatch, concierge-type ground transportation information, and support services for arriving passengers; remote airline check-in services; wheelchair assist services; baggage repair and replacement services; on-street parking meter collection and other forms of parking enforcement services; valet services; and remote parking management services. In addition, it provides facility maintenance services, including power sweeping and washing, painting and general repairs, and cleaning and seasonal services; security services comprising training and hiring of security officers and patrol, as well as customized services and technology; and multi-platform marketing services. The company offers its services primarily under the SP+ and Bags brands. SP Plus Corporation serves private and public owners, municipalities and governments, managers and developers of office buildings, residential properties, commercial properties, shopping centers and other retail properties, healthcare facilities and medical centers, sports and special event complexes, hotels and resorts, and airlines and cruise lines. The company was formerly known as Standard Parking Corporation and changed its name to SP Plus Corporation in December 2013. SP Plus Corporation was founded in 1929 and is based in Chicago, Illinois."
SP,2018-12-31,NA,76000000,100000,53200000,84600000,184000000,81500000,81500000,-9600000,19600000,775400000,693900000,591400000,-5500000,NA,56400000,53200000,NA,income_statement,Specialty Business Services,SP Plus Corporation,"SP Plus Corporation provides parking management, ground transportation, baggage, and other ancillary services in North America. It provides on-site parking management, valet parking, ground transportation, facility maintenance, event logistics, baggage handling, remote airline check-in, security, municipal meter revenue collection and enforcement, and consulting services. The company also offers shuttle bus vehicles and the drivers; ground transportation services, such as taxi and livery dispatch, concierge-type ground transportation information, and support services for arriving passengers; remote airline check-in services; wheelchair assist services; baggage repair and replacement services; on-street parking meter collection and other forms of parking enforcement services; valet services; and remote parking management services. In addition, it provides facility maintenance services, including power sweeping and washing, painting and general repairs, and cleaning and seasonal services; security services comprising training and hiring of security officers and patrol, as well as customized services and technology; and multi-platform marketing services. The company offers its services primarily under the SP+ and Bags brands. SP Plus Corporation serves private and public owners, municipalities and governments, managers and developers of office buildings, residential properties, commercial properties, shopping centers and other retail properties, healthcare facilities and medical centers, sports and special event complexes, hotels and resorts, and airlines and cruise lines. The company was formerly known as Standard Parking Corporation and changed its name to SP Plus Corporation in December 2013. SP Plus Corporation was founded in 1929 and is based in Chicago, Illinois."
SP,2019-12-31,NA,71100000,-200000,48800000,107700000,228100000,91000000,91000000,-18900000,19400000,934900000,843900000,706800000,-19900000,NA,51700000,48800000,NA,income_statement,Specialty Business Services,SP Plus Corporation,"SP Plus Corporation provides parking management, ground transportation, baggage, and other ancillary services in North America. It provides on-site parking management, valet parking, ground transportation, facility maintenance, event logistics, baggage handling, remote airline check-in, security, municipal meter revenue collection and enforcement, and consulting services. The company also offers shuttle bus vehicles and the drivers; ground transportation services, such as taxi and livery dispatch, concierge-type ground transportation information, and support services for arriving passengers; remote airline check-in services; wheelchair assist services; baggage repair and replacement services; on-street parking meter collection and other forms of parking enforcement services; valet services; and remote parking management services. In addition, it provides facility maintenance services, including power sweeping and washing, painting and general repairs, and cleaning and seasonal services; security services comprising training and hiring of security officers and patrol, as well as customized services and technology; and multi-platform marketing services. The company offers its services primarily under the SP+ and Bags brands. SP Plus Corporation serves private and public owners, municipalities and governments, managers and developers of office buildings, residential properties, commercial properties, shopping centers and other retail properties, healthcare facilities and medical centers, sports and special event complexes, hotels and resorts, and airlines and cruise lines. The company was formerly known as Standard Parking Corporation and changed its name to SP Plus Corporation in December 2013. SP Plus Corporation was founded in 1929 and is based in Chicago, Illinois."
SP,2020-12-31,NA,-240400000,-1700000,-172800000,77300000,128600000,22000000,22000000,-21500000,-67500000,549000000,527000000,420400000,-262400000,NA,-172900000,-172800000,NA,income_statement,Specialty Business Services,SP Plus Corporation,"SP Plus Corporation provides parking management, ground transportation, baggage, and other ancillary services in North America. It provides on-site parking management, valet parking, ground transportation, facility maintenance, event logistics, baggage handling, remote airline check-in, security, municipal meter revenue collection and enforcement, and consulting services. The company also offers shuttle bus vehicles and the drivers; ground transportation services, such as taxi and livery dispatch, concierge-type ground transportation information, and support services for arriving passengers; remote airline check-in services; wheelchair assist services; baggage repair and replacement services; on-street parking meter collection and other forms of parking enforcement services; valet services; and remote parking management services. In addition, it provides facility maintenance services, including power sweeping and washing, painting and general repairs, and cleaning and seasonal services; security services comprising training and hiring of security officers and patrol, as well as customized services and technology; and multi-platform marketing services. The company offers its services primarily under the SP+ and Bags brands. SP Plus Corporation serves private and public owners, municipalities and governments, managers and developers of office buildings, residential properties, commercial properties, shopping centers and other retail properties, healthcare facilities and medical centers, sports and special event complexes, hotels and resorts, and airlines and cruise lines. The company was formerly known as Standard Parking Corporation and changed its name to SP Plus Corporation in December 2013. SP Plus Corporation was founded in 1929 and is based in Chicago, Illinois."
SPCB,2016-12-31,6718000,-11902000,NA,-13993000,17247000,2564000,-22114000,-22114000,-219000,2091000,20025000,42139000,17461000,10212000,NA,-13993000,-13993000,713000,income_statement,Security & Protection Services,"SuperCom, Ltd.","SuperCom Ltd. provides digital identity, Internet of Things and connectivity, and cyber security products and solutions to governments, and private and public organizations worldwide. The company offers MAGNA, a common platform for ID registries, e-passports, biometric visas, automated fingerprint identification systems, digitized driver's licenses, and electronic voter registration and election management. Its PureRF suite is a solution based on RFID tag technology to identify, locate, track, monitor, count, and protect people and objects. The company's PureRF suite comprises PureRF tags, hands-free long-range RFID asset and vehicle tags, PureRF readers, PureRF activators, and PureRF initializers. It also provides house arrest monitoring systems, PureTag RF bracelets, PureCom RF base stations, GPS offender tracking systems, PureTrack smartphone device, PureBeacon, PureMonitor offender electronic monitoring software, inmate monitoring systems, DoorGuard tracking station, and personnel tags. In addition, the company offers domestic violence victim protection systems. Further, it provides connectivity products and solutions comprising AVIDITY WBSac, BOLSTER WBSn, BreezeULTRA P6000, Arena controller, and BreezeNET B. Additionally, the company offers Safend's Encryption Suite that protects the organization's sensitive data; and designs solutions for carrier Wi-Fi, enterprise connectivity, smart city, smart hospitality, connected campuses, and connected events. SuperCom Ltd. sells its systems and products through local representatives, subsidiaries, and distribution channels, as well as independent representatives and resellers. The company was formerly known as Vuance Ltd. and changed its name to SuperCom Ltd. in January 2013. SuperCom Ltd. was founded in 1988 and is based in Tel Aviv-Yafo, Israel."
SPCB,2017-12-31,7238000,-7054000,NA,-6661000,14212000,12913000,-7109000,-7109000,-211000,-393000,33264000,40373000,20351000,55000,NA,-6661000,-6661000,-1428000,income_statement,Security & Protection Services,"SuperCom, Ltd.","SuperCom Ltd. provides digital identity, Internet of Things and connectivity, and cyber security products and solutions to governments, and private and public organizations worldwide. The company offers MAGNA, a common platform for ID registries, e-passports, biometric visas, automated fingerprint identification systems, digitized driver's licenses, and electronic voter registration and election management. Its PureRF suite is a solution based on RFID tag technology to identify, locate, track, monitor, count, and protect people and objects. The company's PureRF suite comprises PureRF tags, hands-free long-range RFID asset and vehicle tags, PureRF readers, PureRF activators, and PureRF initializers. It also provides house arrest monitoring systems, PureTag RF bracelets, PureCom RF base stations, GPS offender tracking systems, PureTrack smartphone device, PureBeacon, PureMonitor offender electronic monitoring software, inmate monitoring systems, DoorGuard tracking station, and personnel tags. In addition, the company offers domestic violence victim protection systems. Further, it provides connectivity products and solutions comprising AVIDITY WBSac, BOLSTER WBSn, BreezeULTRA P6000, Arena controller, and BreezeNET B. Additionally, the company offers Safend's Encryption Suite that protects the organization's sensitive data; and designs solutions for carrier Wi-Fi, enterprise connectivity, smart city, smart hospitality, connected campuses, and connected events. SuperCom Ltd. sells its systems and products through local representatives, subsidiaries, and distribution channels, as well as independent representatives and resellers. The company was formerly known as Vuance Ltd. and changed its name to SuperCom Ltd. in January 2013. SuperCom Ltd. was founded in 1988 and is based in Tel Aviv-Yafo, Israel."
SPCB,2018-12-31,4790000,-10010000,NA,-15740000,10753000,8139000,-9922000,-9922000,-844000,5730000,21882000,31804000,13743000,-88000,NA,-15740000,-15740000,2518000,income_statement,Security & Protection Services,"SuperCom, Ltd.","SuperCom Ltd. provides digital identity, Internet of Things and connectivity, and cyber security products and solutions to governments, and private and public organizations worldwide. The company offers MAGNA, a common platform for ID registries, e-passports, biometric visas, automated fingerprint identification systems, digitized driver's licenses, and electronic voter registration and election management. Its PureRF suite is a solution based on RFID tag technology to identify, locate, track, monitor, count, and protect people and objects. The company's PureRF suite comprises PureRF tags, hands-free long-range RFID asset and vehicle tags, PureRF readers, PureRF activators, and PureRF initializers. It also provides house arrest monitoring systems, PureTag RF bracelets, PureCom RF base stations, GPS offender tracking systems, PureTrack smartphone device, PureBeacon, PureMonitor offender electronic monitoring software, inmate monitoring systems, DoorGuard tracking station, and personnel tags. In addition, the company offers domestic violence victim protection systems. Further, it provides connectivity products and solutions comprising AVIDITY WBSac, BOLSTER WBSn, BreezeULTRA P6000, Arena controller, and BreezeNET B. Additionally, the company offers Safend's Encryption Suite that protects the organization's sensitive data; and designs solutions for carrier Wi-Fi, enterprise connectivity, smart city, smart hospitality, connected campuses, and connected events. SuperCom Ltd. sells its systems and products through local representatives, subsidiaries, and distribution channels, as well as independent representatives and resellers. The company was formerly known as Vuance Ltd. and changed its name to SuperCom Ltd. in January 2013. SuperCom Ltd. was founded in 1988 and is based in Tel Aviv-Yafo, Israel."
SPCB,2019-12-31,3971000,-11462000,NA,-11505000,8915000,6348000,-8375000,-8375000,-1946000,43000,16475000,24850000,10127000,-3087000,NA,-11505000,-11505000,1837000,income_statement,Security & Protection Services,"SuperCom, Ltd.","SuperCom Ltd. provides digital identity, Internet of Things and connectivity, and cyber security products and solutions to governments, and private and public organizations worldwide. The company offers MAGNA, a common platform for ID registries, e-passports, biometric visas, automated fingerprint identification systems, digitized driver's licenses, and electronic voter registration and election management. Its PureRF suite is a solution based on RFID tag technology to identify, locate, track, monitor, count, and protect people and objects. The company's PureRF suite comprises PureRF tags, hands-free long-range RFID asset and vehicle tags, PureRF readers, PureRF activators, and PureRF initializers. It also provides house arrest monitoring systems, PureTag RF bracelets, PureCom RF base stations, GPS offender tracking systems, PureTrack smartphone device, PureBeacon, PureMonitor offender electronic monitoring software, inmate monitoring systems, DoorGuard tracking station, and personnel tags. In addition, the company offers domestic violence victim protection systems. Further, it provides connectivity products and solutions comprising AVIDITY WBSac, BOLSTER WBSn, BreezeULTRA P6000, Arena controller, and BreezeNET B. Additionally, the company offers Safend's Encryption Suite that protects the organization's sensitive data; and designs solutions for carrier Wi-Fi, enterprise connectivity, smart city, smart hospitality, connected campuses, and connected events. SuperCom Ltd. sells its systems and products through local representatives, subsidiaries, and distribution channels, as well as independent representatives and resellers. The company was formerly known as Vuance Ltd. and changed its name to SuperCom Ltd. in January 2013. SuperCom Ltd. was founded in 1988 and is based in Tel Aviv-Yafo, Israel."
SPFI,2017-12-31,NA,23742000,NA,23635000,89768000,131395000,0,23742000,NA,107000,131395000,107653000,0,0,NA,23635000,23635000,17885000,income_statement,Banks—Regional,"South Plains Financial, Inc.","South Plains Financial, Inc. operates as a bank holding company for City Bank that provides commercial and consumer financial services to small and medium-sized businesses and individuals. The company operates through two segments, Community Banking and Insurance. It offers deposit products, including demand deposit accounts, interest-bearing products, savings accounts, and certificate of deposits. The company also provides commercial real estate loans; general and specialized commercial loans, including agricultural production and real estate, energy, and finance, investment, and insurance loans, as well as loans to goods, services, restaurant and retail, construction, and other industries; residential construction loans; and 1-4 family residential loans, auto loans, and other loans for recreational vehicles or other purposes. In addition, it offers crop insurance products; trust products and services; investment services; mortgage banking services; online and mobile banking services; and debit and credit cards. The company operates 26 full-service banking locations; and 12 loan production offices located throughout Texas and Eastern New Mexico. South Plains Financial, Inc. was founded in 1941 and is headquartered in Lubbock, Texas."
SPFI,2018-12-31,NA,25389000,NA,29290000,97366000,140832000,0,25389000,NA,-3901000,140832000,115443000,0,0,NA,29290000,29290000,18077000,income_statement,Banks—Regional,"South Plains Financial, Inc.","South Plains Financial, Inc. operates as a bank holding company for City Bank that provides commercial and consumer financial services to small and medium-sized businesses and individuals. The company operates through two segments, Community Banking and Insurance. It offers deposit products, including demand deposit accounts, interest-bearing products, savings accounts, and certificate of deposits. The company also provides commercial real estate loans; general and specialized commercial loans, including agricultural production and real estate, energy, and finance, investment, and insurance loans, as well as loans to goods, services, restaurant and retail, construction, and other industries; residential construction loans; and 1-4 family residential loans, auto loans, and other loans for recreational vehicles or other purposes. In addition, it offers crop insurance products; trust products and services; investment services; mortgage banking services; online and mobile banking services; and debit and credit cards. The company operates 26 full-service banking locations; and 12 loan production offices located throughout Texas and Eastern New Mexico. South Plains Financial, Inc. was founded in 1941 and is headquartered in Lubbock, Texas."
SPFI,2019-12-31,NA,36701000,NA,29220000,102145000,158409000,0,36701000,NA,7481000,158409000,121708000,0,0,NA,29220000,29220000,19563000,income_statement,Banks—Regional,"South Plains Financial, Inc.","South Plains Financial, Inc. operates as a bank holding company for City Bank that provides commercial and consumer financial services to small and medium-sized businesses and individuals. The company operates through two segments, Community Banking and Insurance. It offers deposit products, including demand deposit accounts, interest-bearing products, savings accounts, and certificate of deposits. The company also provides commercial real estate loans; general and specialized commercial loans, including agricultural production and real estate, energy, and finance, investment, and insurance loans, as well as loans to goods, services, restaurant and retail, construction, and other industries; residential construction loans; and 1-4 family residential loans, auto loans, and other loans for recreational vehicles or other purposes. In addition, it offers crop insurance products; trust products and services; investment services; mortgage banking services; online and mobile banking services; and debit and credit cards. The company operates 26 full-service banking locations; and 12 loan production offices located throughout Texas and Eastern New Mexico. South Plains Financial, Inc. was founded in 1941 and is headquartered in Lubbock, Texas."
SPFI,2020-12-31,NA,56603000,NA,45353000,113288000,196000000,0,56603000,NA,11250000,196000000,139397000,0,0,NA,45353000,45353000,26109000,income_statement,Banks—Regional,"South Plains Financial, Inc.","South Plains Financial, Inc. operates as a bank holding company for City Bank that provides commercial and consumer financial services to small and medium-sized businesses and individuals. The company operates through two segments, Community Banking and Insurance. It offers deposit products, including demand deposit accounts, interest-bearing products, savings accounts, and certificate of deposits. The company also provides commercial real estate loans; general and specialized commercial loans, including agricultural production and real estate, energy, and finance, investment, and insurance loans, as well as loans to goods, services, restaurant and retail, construction, and other industries; residential construction loans; and 1-4 family residential loans, auto loans, and other loans for recreational vehicles or other purposes. In addition, it offers crop insurance products; trust products and services; investment services; mortgage banking services; online and mobile banking services; and debit and credit cards. The company operates 26 full-service banking locations; and 12 loan production offices located throughout Texas and Eastern New Mexico. South Plains Financial, Inc. was founded in 1941 and is headquartered in Lubbock, Texas."
SPG,2017-12-31,NA,2268246000,743076000,1947962000,337987000,4547256000,2802340000,2802340000,-809393000,23343000,5527336000,2724996000,980080000,-534094000,NA,2244903000,1944625000,131477000,income_statement,NA,NA,NA
SPG,2018-12-31,NA,2859241000,730438000,2440058000,334461000,4619424000,2923611000,2923611000,-815923000,36898000,5627388000,2703777000,1007964000,-64370000,NA,2822343000,2436721000,78898000,income_statement,NA,NA,NA
SPG,2019-12-31,NA,2453242000,603913000,2101584000,375313000,4638845000,2821343000,2821343000,-789353000,30054000,5660489000,2839146000,1021644000,-368101000,NA,2423188000,2098247000,101686000,income_statement,NA,NA,NA
SPG,2020-12-31,NA,1272687000,618766000,1112564000,333140000,3690898000,1971809000,1971809000,-784400000,-4637000,4578052000,2606243000,887154000,-699122000,NA,1277324000,1109227000,67941000,income_statement,NA,NA,NA
SPGI,2017-12-31,NA,2461000000,1409000000,1496000000,1438000000,4369000000,2751000000,2751000000,-149000000,823000000,6063000000,3312000000,1694000000,-290000000,NA,1638000000,1496000000,NA,income_statement,NA,NA,NA
SPGI,2018-12-31,NA,2681000000,1676000000,1958000000,1253000000,4420000000,2961000000,2961000000,-134000000,560000000,6258000000,3297000000,1838000000,-250000000,NA,2121000000,1958000000,NA,income_statement,NA,NA,NA
SPGI,2019-12-31,NA,2930000000,2325000000,2123000000,1360000000,4723000000,3159000000,3159000000,-141000000,627000000,6699000000,3540000000,1976000000,-229000000,NA,2303000000,2123000000,NA,income_statement,NA,NA,NA
SPGI,2020-12-31,NA,3228000000,2843000000,2339000000,1277000000,5350000000,3867000000,3867000000,-141000000,694000000,7442000000,3575000000,2092000000,-639000000,NA,2534000000,2339000000,NA,income_statement,NA,NA,NA
SPKE,2016-12-31,NA,76099000,93406000,14444000,85104000,207053000,83861000,83861000,-8859000,10426000,546697000,462836000,339644000,-7762000,NA,65673000,14444000,5300000,income_statement,Utilities—Regulated Electric,"Spark Energy, Inc.","Spark Energy, Inc., through its subsidiaries, operates as an independent retail energy services company in the United States. It operates through two segments, Retail Electricity and Retail Natural Gas. The company engages in the retail sales and distribution of electricity and natural gas to residential and commercial customers. As of December 31, 2019, it operated in 94 utility service territories across 19 states and the District of Columbia, and had approximately 672,000 residential customer equivalents. The company was founded in 1999 and is headquartered in Houston, Texas."
SPKE,2017-12-31,NA,113809000,101559000,19245000,109025000,254888000,94522000,94522000,-11134000,38765000,798055000,703533000,543167000,19287000,NA,75044000,16207000,9000000,income_statement,Utilities—Regulated Electric,"Spark Energy, Inc.","Spark Energy, Inc., through its subsidiaries, operates as an independent retail energy services company in the United States. It operates through two segments, Retail Electricity and Retail Natural Gas. The company engages in the retail sales and distribution of electricity and natural gas to residential and commercial customers. As of December 31, 2019, it operated in 94 utility service territories across 19 states and the District of Columbia, and had approximately 672,000 residential customer equivalents. The company was founded in 1999 and is headquartered in Houston, Texas."
SPKE,2018-12-31,NA,-12315000,44488000,-1186000,113146000,170335000,-5369000,-5369000,-9410000,2077000,1005928000,1011297000,835593000,-6946000,NA,-14392000,-9295000,9900000,income_statement,Utilities—Regulated Electric,"Spark Energy, Inc.","Spark Energy, Inc., through its subsidiaries, operates as an independent retail energy services company in the United States. It operates through two segments, Retail Electricity and Retail Natural Gas. The company engages in the retail sales and distribution of electricity and natural gas to residential and commercial customers. As of December 31, 2019, it operated in 94 utility service territories across 19 states and the District of Columbia, and had approximately 672,000 residential customer equivalents. The company was founded in 1999 and is headquartered in Houston, Texas."
SPKE,2019-12-31,NA,21470000,16067000,8450000,134862000,206900000,22651000,22651000,-8621000,7257000,813725000,791074000,606825000,-1181000,NA,14213000,359000,8400000,income_statement,Utilities—Regulated Electric,"Spark Energy, Inc.","Spark Energy, Inc., through its subsidiaries, operates as an independent retail energy services company in the United States. It operates through two segments, Retail Electricity and Retail Natural Gas. The company engages in the retail sales and distribution of electricity and natural gas to residential and commercial customers. As of December 31, 2019, it operated in 94 utility service territories across 19 states and the District of Columbia, and had approximately 672,000 residential customer equivalents. The company was founded in 1999 and is headquartered in Houston, Texas."
SPKEP,2016-12-31,NA,76099000,93406000,14444000,85104000,207053000,83861000,83861000,-8859000,10426000,546697000,462836000,339644000,-7762000,NA,65673000,14444000,5300000,income_statement,Utilities—Regulated Electric,"Spark Energy, Inc. - 8.75% Seri","Spark Energy, Inc., through its subsidiaries, operates as an independent retail energy services company in the United States. It operates through two segments, Retail Electricity and Retail Natural Gas. The company engages in the retail sales and distribution of electricity and natural gas to residential and commercial customers. As of December 31, 2019, it operated in 94 utility service territories across 19 states and the District of Columbia, and had approximately 672,000 residential customer equivalents. The company was founded in 1999 and is headquartered in Houston, Texas."
SPKEP,2017-12-31,NA,113809000,101559000,19245000,109025000,254888000,94522000,94522000,-11134000,38765000,798055000,703533000,543167000,19287000,NA,75044000,16207000,9000000,income_statement,Utilities—Regulated Electric,"Spark Energy, Inc. - 8.75% Seri","Spark Energy, Inc., through its subsidiaries, operates as an independent retail energy services company in the United States. It operates through two segments, Retail Electricity and Retail Natural Gas. The company engages in the retail sales and distribution of electricity and natural gas to residential and commercial customers. As of December 31, 2019, it operated in 94 utility service territories across 19 states and the District of Columbia, and had approximately 672,000 residential customer equivalents. The company was founded in 1999 and is headquartered in Houston, Texas."
SPKEP,2018-12-31,NA,-12315000,44488000,-1186000,113146000,170335000,-5369000,-5369000,-9410000,2077000,1005928000,1011297000,835593000,-6946000,NA,-14392000,-9295000,9900000,income_statement,Utilities—Regulated Electric,"Spark Energy, Inc. - 8.75% Seri","Spark Energy, Inc., through its subsidiaries, operates as an independent retail energy services company in the United States. It operates through two segments, Retail Electricity and Retail Natural Gas. The company engages in the retail sales and distribution of electricity and natural gas to residential and commercial customers. As of December 31, 2019, it operated in 94 utility service territories across 19 states and the District of Columbia, and had approximately 672,000 residential customer equivalents. The company was founded in 1999 and is headquartered in Houston, Texas."
SPKEP,2019-12-31,NA,21470000,16067000,8450000,134862000,206900000,22651000,22651000,-8621000,7257000,813725000,791074000,606825000,-1181000,NA,14213000,359000,8400000,income_statement,Utilities—Regulated Electric,"Spark Energy, Inc. - 8.75% Seri","Spark Energy, Inc., through its subsidiaries, operates as an independent retail energy services company in the United States. It operates through two segments, Retail Electricity and Retail Natural Gas. The company engages in the retail sales and distribution of electricity and natural gas to residential and commercial customers. As of December 31, 2019, it operated in 94 utility service territories across 19 states and the District of Columbia, and had approximately 672,000 residential customer equivalents. The company was founded in 1999 and is headquartered in Houston, Texas."
SPLK,2017-01-31,295850000,-341953000,NA,-347460000,781399000,752511000,-324738000,-324738000,-8549000,5507000,943564000,1268302000,191053000,-17215000,NA,-347460000,-347460000,13315000,income_statement,Software—Infrastructure,Splunk Inc.,"Splunk Inc. develops and markets software solutions that enable organizations to gain real-time operational intelligence in the United States and internationally. The company offers Splunk Enterprise, a real-time data platform, which include collection, indexing, search, reporting, analysis, alerting, monitoring, and data management capabilities; and Splunk Cloud, a cloud service for machine data. It also provides Splunk Enterprise Security that addresses security threats and information, and event management use cases; SignalFx, which provide real-time observability and troubleshooting for cloud infrastructure and applications; Splunk IT Service Intelligence that monitors health and key performance indicators of critical IT and business services; Splunk Phantom that automates and orchestrates incident response workflows; VictorOps for collaboration and IT issue resolution; Splunk Data Stream Processor, which collects, process, and distribute data with real-time stream processing; and Splunk Data Fabric Search that enables highly complex and high-performance searches of massive datasets. In addition, the company provides Splunk App for Amazon Web Services that collects and analyzes data from amazon web services data sources; Cisco Firepower App for Splunk that Incorporates advanced visualizations and investigative capabilities for Cisco Firepower and Firepower Management Console; Splunk Machine Learning Toolkit, which Includes custom visualizations and guided workflows; Splunk Connected Experiences that provides access to data, alerts, and actions on mobile and connected devices; and Splunk apps and add-ons. Further, the company offers application programming interfaces and software development kits; and maintenance and customer support, training, and consulting and implementation services, as well as operates Splunkbase and Splunk Answers Websites. Splunk Inc. was incorporated in 2003 and is headquartered in San Francisco, California."
SPLK,2018-01-31,301114000,-188861000,NA,-190218000,937019000,1052723000,-185410000,-185410000,-8794000,1357000,1309132000,1494542000,256409000,-3451000,NA,-190218000,-190218000,13315000,income_statement,Software—Infrastructure,Splunk Inc.,"Splunk Inc. develops and markets software solutions that enable organizations to gain real-time operational intelligence in the United States and internationally. The company offers Splunk Enterprise, a real-time data platform, which include collection, indexing, search, reporting, analysis, alerting, monitoring, and data management capabilities; and Splunk Cloud, a cloud service for machine data. It also provides Splunk Enterprise Security that addresses security threats and information, and event management use cases; SignalFx, which provide real-time observability and troubleshooting for cloud infrastructure and applications; Splunk IT Service Intelligence that monitors health and key performance indicators of critical IT and business services; Splunk Phantom that automates and orchestrates incident response workflows; VictorOps for collaboration and IT issue resolution; Splunk Data Stream Processor, which collects, process, and distribute data with real-time stream processing; and Splunk Data Fabric Search that enables highly complex and high-performance searches of massive datasets. In addition, the company provides Splunk App for Amazon Web Services that collects and analyzes data from amazon web services data sources; Cisco Firepower App for Splunk that Incorporates advanced visualizations and investigative capabilities for Cisco Firepower and Firepower Management Console; Splunk Machine Learning Toolkit, which Includes custom visualizations and guided workflows; Splunk Connected Experiences that provides access to data, alerts, and actions on mobile and connected devices; and Splunk apps and add-ons. Further, the company offers application programming interfaces and software development kits; and maintenance and customer support, training, and consulting and implementation services, as well as operates Splunkbase and Splunk Answers Websites. Splunk Inc. was incorporated in 2003 and is headquartered in San Francisco, California."
SPLK,2019-01-31,437825000,-263191000,NA,-275577000,1252333000,1458334000,-245139000,-245139000,-41963000,12386000,1803010000,2048149000,344676000,-18052000,NA,-275577000,-275577000,13315000,income_statement,Software—Infrastructure,Splunk Inc.,"Splunk Inc. develops and markets software solutions that enable organizations to gain real-time operational intelligence in the United States and internationally. The company offers Splunk Enterprise, a real-time data platform, which include collection, indexing, search, reporting, analysis, alerting, monitoring, and data management capabilities; and Splunk Cloud, a cloud service for machine data. It also provides Splunk Enterprise Security that addresses security threats and information, and event management use cases; SignalFx, which provide real-time observability and troubleshooting for cloud infrastructure and applications; Splunk IT Service Intelligence that monitors health and key performance indicators of critical IT and business services; Splunk Phantom that automates and orchestrates incident response workflows; VictorOps for collaboration and IT issue resolution; Splunk Data Stream Processor, which collects, process, and distribute data with real-time stream processing; and Splunk Data Fabric Search that enables highly complex and high-performance searches of massive datasets. In addition, the company provides Splunk App for Amazon Web Services that collects and analyzes data from amazon web services data sources; Cisco Firepower App for Splunk that Incorporates advanced visualizations and investigative capabilities for Cisco Firepower and Firepower Management Console; Splunk Machine Learning Toolkit, which Includes custom visualizations and guided workflows; Splunk Connected Experiences that provides access to data, alerts, and actions on mobile and connected devices; and Splunk apps and add-ons. Further, the company offers application programming interfaces and software development kits; and maintenance and customer support, training, and consulting and implementation services, as well as operates Splunkbase and Splunk Answers Websites. Splunk Inc. was incorporated in 2003 and is headquartered in San Francisco, California."
SPLK,2020-01-31,609018000,-331651000,NA,-336668000,1568425000,1929138000,-263435000,-263435000,-96249000,5017000,2358926000,2622361000,429788000,-68216000,NA,-336668000,-336668000,15130000,income_statement,Software—Infrastructure,Splunk Inc.,"Splunk Inc. develops and markets software solutions that enable organizations to gain real-time operational intelligence in the United States and internationally. The company offers Splunk Enterprise, a real-time data platform, which include collection, indexing, search, reporting, analysis, alerting, monitoring, and data management capabilities; and Splunk Cloud, a cloud service for machine data. It also provides Splunk Enterprise Security that addresses security threats and information, and event management use cases; SignalFx, which provide real-time observability and troubleshooting for cloud infrastructure and applications; Splunk IT Service Intelligence that monitors health and key performance indicators of critical IT and business services; Splunk Phantom that automates and orchestrates incident response workflows; VictorOps for collaboration and IT issue resolution; Splunk Data Stream Processor, which collects, process, and distribute data with real-time stream processing; and Splunk Data Fabric Search that enables highly complex and high-performance searches of massive datasets. In addition, the company provides Splunk App for Amazon Web Services that collects and analyzes data from amazon web services data sources; Cisco Firepower App for Splunk that Incorporates advanced visualizations and investigative capabilities for Cisco Firepower and Firepower Management Console; Splunk Machine Learning Toolkit, which Includes custom visualizations and guided workflows; Splunk Connected Experiences that provides access to data, alerts, and actions on mobile and connected devices; and Splunk apps and add-ons. Further, the company offers application programming interfaces and software development kits; and maintenance and customer support, training, and consulting and implementation services, as well as operates Splunkbase and Splunk Answers Websites. Splunk Inc. was incorporated in 2003 and is headquartered in San Francisco, California."
SPNE,2016-12-31,11434000,-43764000,NA,-43212000,98036000,75020000,-38759000,-38759000,NA,-552000,128860000,167619000,53840000,-5005000,NA,-43212000,-43212000,NA,income_statement,Medical Devices,SeaSpine Holdings Corporation,"SeaSpine Holdings Corporation, a medical technology company, focuses on the design, development, and commercialization of surgical solutions for the treatment of spinal disorders in the United States and internationally. The company provides orthobiologics and spinal implant solutions for the neurosurgeons and orthopedic spine surgeons to perform fusion procedures in the lumbar, thoracic, and cervical spine. Its orthobiologics products include demineralized bone matrices (DBM), collagen ceramic matrices, demineralized cancellous allograft bone products, and synthetic bone void fillers to improve bone fusion rates in a range of orthopedic surgeries, including spine, hip, and extremities procedures. The company also offers orthobiologics products in various forms, such as fibers, putties, pastes, strips, and DBM. Its spinal implant portfolio comprises products for spinal decompression, alignment, and stabilization that are used to facilitate fusion in degenerative, minimally invasive, and complex spinal deformity procedures throughout the lumbar, thoracic, and cervical regions of the spine. The company has development and licensing agreement with restor3d, Inc. to develop 3D-printed interbody devices. SeaSpine Holdings Corporation was incorporated in 2015 and is headquartered in Carlsbad, California."
SPNE,2017-12-31,12180000,-32233000,NA,-32115000,99678000,79988000,-35038000,-35038000,NA,-118000,131814000,166852000,51826000,2805000,NA,-32115000,-32115000,NA,income_statement,Medical Devices,SeaSpine Holdings Corporation,"SeaSpine Holdings Corporation, a medical technology company, focuses on the design, development, and commercialization of surgical solutions for the treatment of spinal disorders in the United States and internationally. The company provides orthobiologics and spinal implant solutions for the neurosurgeons and orthopedic spine surgeons to perform fusion procedures in the lumbar, thoracic, and cervical spine. Its orthobiologics products include demineralized bone matrices (DBM), collagen ceramic matrices, demineralized cancellous allograft bone products, and synthetic bone void fillers to improve bone fusion rates in a range of orthopedic surgeries, including spine, hip, and extremities procedures. The company also offers orthobiologics products in various forms, such as fibers, putties, pastes, strips, and DBM. Its spinal implant portfolio comprises products for spinal decompression, alignment, and stabilization that are used to facilitate fusion in degenerative, minimally invasive, and complex spinal deformity procedures throughout the lumbar, thoracic, and cervical regions of the spine. The company has development and licensing agreement with restor3d, Inc. to develop 3D-printed interbody devices. SeaSpine Holdings Corporation was incorporated in 2015 and is headquartered in Carlsbad, California."
SPNE,2018-12-31,12058000,-33395000,NA,-33524000,107189000,87474000,-34941000,-34941000,NA,129000,143443000,178384000,55969000,1546000,NA,-33524000,-33524000,NA,income_statement,Medical Devices,SeaSpine Holdings Corporation,"SeaSpine Holdings Corporation, a medical technology company, focuses on the design, development, and commercialization of surgical solutions for the treatment of spinal disorders in the United States and internationally. The company provides orthobiologics and spinal implant solutions for the neurosurgeons and orthopedic spine surgeons to perform fusion procedures in the lumbar, thoracic, and cervical spine. Its orthobiologics products include demineralized bone matrices (DBM), collagen ceramic matrices, demineralized cancellous allograft bone products, and synthetic bone void fillers to improve bone fusion rates in a range of orthopedic surgeries, including spine, hip, and extremities procedures. The company also offers orthobiologics products in various forms, such as fibers, putties, pastes, strips, and DBM. Its spinal implant portfolio comprises products for spinal decompression, alignment, and stabilization that are used to facilitate fusion in degenerative, minimally invasive, and complex spinal deformity procedures throughout the lumbar, thoracic, and cervical regions of the spine. The company has development and licensing agreement with restor3d, Inc. to develop 3D-printed interbody devices. SeaSpine Holdings Corporation was incorporated in 2015 and is headquartered in Carlsbad, California."
SPNE,2019-12-31,15125000,-38920000,NA,-39276000,117302000,101104000,-34492000,-34492000,NA,356000,159083000,193575000,57979000,-4428000,NA,-39276000,-39276000,NA,income_statement,Medical Devices,SeaSpine Holdings Corporation,"SeaSpine Holdings Corporation, a medical technology company, focuses on the design, development, and commercialization of surgical solutions for the treatment of spinal disorders in the United States and internationally. The company provides orthobiologics and spinal implant solutions for the neurosurgeons and orthopedic spine surgeons to perform fusion procedures in the lumbar, thoracic, and cervical spine. Its orthobiologics products include demineralized bone matrices (DBM), collagen ceramic matrices, demineralized cancellous allograft bone products, and synthetic bone void fillers to improve bone fusion rates in a range of orthopedic surgeries, including spine, hip, and extremities procedures. The company also offers orthobiologics products in various forms, such as fibers, putties, pastes, strips, and DBM. Its spinal implant portfolio comprises products for spinal decompression, alignment, and stabilization that are used to facilitate fusion in degenerative, minimally invasive, and complex spinal deformity procedures throughout the lumbar, thoracic, and cervical regions of the spine. The company has development and licensing agreement with restor3d, Inc. to develop 3D-printed interbody devices. SeaSpine Holdings Corporation was incorporated in 2015 and is headquartered in Carlsbad, California."
SPNS,2016-12-31,16488000,25373000,1704000,19336000,44460000,85788000,24840000,24840000,-270000,5772000,216190000,191350000,130402000,533000,NA,19601000,19336000,NA,income_statement,Software—Application,Sapiens International Corporati,"Sapiens International Corporation N.V. provides software solutions for the insurance and financial services industries in North America, Europe, the Asia Pacific, and South Africa. The company offers Sapiens CoreSuite and Sapiens IDITSuite for personal, commercial, and specialty lines, as well as reinsurance and workers' compensation; and Sapiens CoreSuite, Sapiens UnderwritingPro, Sapiens ApplicationPro, Sapiens IllustrationPro, and Sapiens ConsolidationMaster for life, pension, and annuities. It also provides Sapiens DigitalSuite for insurance customers, agents, brokers, risk managers, customer groups and third-party service providers; Sapiens AgentConnect and Sapiens CustomerConnect portals; Sapiens Intelligence, an analytics platform; Sapiens IntelligencePro, a comprehensive BI solution with pre-configured reports, dashboards, and scorecards; and Sapiens Advanced Analytics, which uses AI and Machine Learning to generate actionable insights based on different models across the insurance value chain. In addition, the company offers Sapiens ReinsuranceMaster, Sapiens ReinsurancePro, and Sapiens Reinsurance GO reinsurance solutions; and Sapiens Platform, Sapiens CoreSuite, Sapiens PolicyPro, and Sapiens ClaimsPro, as well as Sapiens PolicyGo, Sapiens ClaimsGo, and Sapiens Connect for workers' compensation. Further, it provides financial and compliance solutions, which comprise Sapiens FinancialPro, Sapiens Financial GO, Sapiens StatementPro, Sapiens CheckPro, and Sapiens Reporting Tools; and Sapiens Decision, an enterprise-scale platform that enables institutions to centrally author, store, and manage various organizational business logics. Additionally, the company offers tailor-made solutions based on its Sapiens eMerge platform; and program delivery, business, and managed services. It markets and sells its products and services through direct and partner sales. The company was founded in 1982 and is headquartered in Holon, Israel."
SPNS,2017-12-31,31955000,-2008000,2184000,352000,59211000,93516000,2350000,2350000,-1688000,-2564000,269194000,266844000,175678000,-4358000,NA,556000,352000,NA,income_statement,Software—Application,Sapiens International Corporati,"Sapiens International Corporation N.V. provides software solutions for the insurance and financial services industries in North America, Europe, the Asia Pacific, and South Africa. The company offers Sapiens CoreSuite and Sapiens IDITSuite for personal, commercial, and specialty lines, as well as reinsurance and workers' compensation; and Sapiens CoreSuite, Sapiens UnderwritingPro, Sapiens ApplicationPro, Sapiens IllustrationPro, and Sapiens ConsolidationMaster for life, pension, and annuities. It also provides Sapiens DigitalSuite for insurance customers, agents, brokers, risk managers, customer groups and third-party service providers; Sapiens AgentConnect and Sapiens CustomerConnect portals; Sapiens Intelligence, an analytics platform; Sapiens IntelligencePro, a comprehensive BI solution with pre-configured reports, dashboards, and scorecards; and Sapiens Advanced Analytics, which uses AI and Machine Learning to generate actionable insights based on different models across the insurance value chain. In addition, the company offers Sapiens ReinsuranceMaster, Sapiens ReinsurancePro, and Sapiens Reinsurance GO reinsurance solutions; and Sapiens Platform, Sapiens CoreSuite, Sapiens PolicyPro, and Sapiens ClaimsPro, as well as Sapiens PolicyGo, Sapiens ClaimsGo, and Sapiens Connect for workers' compensation. Further, it provides financial and compliance solutions, which comprise Sapiens FinancialPro, Sapiens Financial GO, Sapiens StatementPro, Sapiens CheckPro, and Sapiens Reporting Tools; and Sapiens Decision, an enterprise-scale platform that enables institutions to centrally author, store, and manage various organizational business logics. Additionally, the company offers tailor-made solutions based on its Sapiens eMerge platform; and program delivery, business, and managed services. It markets and sells its products and services through direct and partner sales. The company was founded in 1982 and is headquartered in Holon, Israel."
SPNS,2018-12-31,34414000,19031000,1440000,13785000,52133000,109569000,23022000,23022000,-3225000,5031000,289707000,266685000,180138000,-3991000,NA,14000000,13785000,NA,income_statement,Software—Application,Sapiens International Corporati,"Sapiens International Corporation N.V. provides software solutions for the insurance and financial services industries in North America, Europe, the Asia Pacific, and South Africa. The company offers Sapiens CoreSuite and Sapiens IDITSuite for personal, commercial, and specialty lines, as well as reinsurance and workers' compensation; and Sapiens CoreSuite, Sapiens UnderwritingPro, Sapiens ApplicationPro, Sapiens IllustrationPro, and Sapiens ConsolidationMaster for life, pension, and annuities. It also provides Sapiens DigitalSuite for insurance customers, agents, brokers, risk managers, customer groups and third-party service providers; Sapiens AgentConnect and Sapiens CustomerConnect portals; Sapiens Intelligence, an analytics platform; Sapiens IntelligencePro, a comprehensive BI solution with pre-configured reports, dashboards, and scorecards; and Sapiens Advanced Analytics, which uses AI and Machine Learning to generate actionable insights based on different models across the insurance value chain. In addition, the company offers Sapiens ReinsuranceMaster, Sapiens ReinsurancePro, and Sapiens Reinsurance GO reinsurance solutions; and Sapiens Platform, Sapiens CoreSuite, Sapiens PolicyPro, and Sapiens ClaimsPro, as well as Sapiens PolicyGo, Sapiens ClaimsGo, and Sapiens Connect for workers' compensation. Further, it provides financial and compliance solutions, which comprise Sapiens FinancialPro, Sapiens Financial GO, Sapiens StatementPro, Sapiens CheckPro, and Sapiens Reporting Tools; and Sapiens Decision, an enterprise-scale platform that enables institutions to centrally author, store, and manage various organizational business logics. Additionally, the company offers tailor-made solutions based on its Sapiens eMerge platform; and program delivery, business, and managed services. It markets and sells its products and services through direct and partner sales. The company was founded in 1982 and is headquartered in Holon, Israel."
SPNS,2019-12-31,37378000,35101000,1679000,26247000,54274000,129521000,37869000,37869000,-3030000,8610000,325674000,287805000,196153000,-2768000,NA,26491000,26247000,NA,income_statement,Software—Application,Sapiens International Corporati,"Sapiens International Corporation N.V. provides software solutions for the insurance and financial services industries in North America, Europe, the Asia Pacific, and South Africa. The company offers Sapiens CoreSuite and Sapiens IDITSuite for personal, commercial, and specialty lines, as well as reinsurance and workers' compensation; and Sapiens CoreSuite, Sapiens UnderwritingPro, Sapiens ApplicationPro, Sapiens IllustrationPro, and Sapiens ConsolidationMaster for life, pension, and annuities. It also provides Sapiens DigitalSuite for insurance customers, agents, brokers, risk managers, customer groups and third-party service providers; Sapiens AgentConnect and Sapiens CustomerConnect portals; Sapiens Intelligence, an analytics platform; Sapiens IntelligencePro, a comprehensive BI solution with pre-configured reports, dashboards, and scorecards; and Sapiens Advanced Analytics, which uses AI and Machine Learning to generate actionable insights based on different models across the insurance value chain. In addition, the company offers Sapiens ReinsuranceMaster, Sapiens ReinsurancePro, and Sapiens Reinsurance GO reinsurance solutions; and Sapiens Platform, Sapiens CoreSuite, Sapiens PolicyPro, and Sapiens ClaimsPro, as well as Sapiens PolicyGo, Sapiens ClaimsGo, and Sapiens Connect for workers' compensation. Further, it provides financial and compliance solutions, which comprise Sapiens FinancialPro, Sapiens Financial GO, Sapiens StatementPro, Sapiens CheckPro, and Sapiens Reporting Tools; and Sapiens Decision, an enterprise-scale platform that enables institutions to centrally author, store, and manage various organizational business logics. Additionally, the company offers tailor-made solutions based on its Sapiens eMerge platform; and program delivery, business, and managed services. It markets and sells its products and services through direct and partner sales. The company was founded in 1982 and is headquartered in Holon, Israel."
SPOK,2017-12-31,18702000,11559000,NA,-15306000,84452000,125484000,10706000,10706000,NA,26865000,171175000,160469000,45691000,859000,NA,-15306000,-15306000,NA,income_statement,Telecom Services,"Spok Holdings, Inc.","Spok Holdings, Inc., through its subsidiary, Spok, Inc., provides various communications solutions in the United States, Europe, Canada, Australia, Asia, and the Middle East. The company provides one-way messaging, including numeric messaging services, which enable subscribers to receive messages comprising numbers, such as phone numbers; and alphanumeric messages, including numbers and letters that enable subscribers to receive text messages. It also offers two-way messaging services that enable subscribers to send and receive messages to and from other wireless messaging devices, such as pagers, personal digital assistants, and personal computers; and voice mail, personalized greeting, message storage and retrieval, and equipment loss and/or maintenance protection to one-way and two-way messaging subscribers. In addition, the company develops, sells, and supports enterprise-wide systems to automate, centralize, and standardize clinical communications for contact centers, clinical alerting and notification, mobile communications, and messaging, as well as for public safety notifications. Further, it sells devices to resellers who lease or resell them to their subscribers; ancillary services, such as voicemail and equipment loss or maintenance protection, as well as provides a suite of professional services. The company serves businesses, professionals, management personnel, medical personnel, field sales personnel and service forces, members of the construction industry and construction trades, real estate brokers and developers, sales and services organizations, specialty trade organizations, manufacturing organizations, and government agencies. The company was formerly known as USA Mobility, Inc. and changed its name to Spok Holdings, Inc. in July 2014. Spok Holdings, Inc. is headquartered in Springfield, Virginia."
SPOK,2018-12-31,24464000,-2185000,NA,-1479000,87598000,119658000,-3173000,-3173000,NA,-706000,169474000,172647000,49816000,988000,NA,-1479000,-1479000,NA,income_statement,Telecom Services,"Spok Holdings, Inc.","Spok Holdings, Inc., through its subsidiary, Spok, Inc., provides various communications solutions in the United States, Europe, Canada, Australia, Asia, and the Middle East. The company provides one-way messaging, including numeric messaging services, which enable subscribers to receive messages comprising numbers, such as phone numbers; and alphanumeric messages, including numbers and letters that enable subscribers to receive text messages. It also offers two-way messaging services that enable subscribers to send and receive messages to and from other wireless messaging devices, such as pagers, personal digital assistants, and personal computers; and voice mail, personalized greeting, message storage and retrieval, and equipment loss and/or maintenance protection to one-way and two-way messaging subscribers. In addition, the company develops, sells, and supports enterprise-wide systems to automate, centralize, and standardize clinical communications for contact centers, clinical alerting and notification, mobile communications, and messaging, as well as for public safety notifications. Further, it sells devices to resellers who lease or resell them to their subscribers; ancillary services, such as voicemail and equipment loss or maintenance protection, as well as provides a suite of professional services. The company serves businesses, professionals, management personnel, medical personnel, field sales personnel and service forces, members of the construction industry and construction trades, real estate brokers and developers, sales and services organizations, specialty trade organizations, manufacturing organizations, and government agencies. The company was formerly known as USA Mobility, Inc. and changed its name to Spok Holdings, Inc. in July 2014. Spok Holdings, Inc. is headquartered in Springfield, Virginia."
SPOK,2019-12-31,27543000,-13423000,NA,-10765000,82672000,112504000,-6960000,-6960000,NA,-2658000,160289000,167249000,47785000,-6463000,NA,-10765000,-10765000,NA,income_statement,Telecom Services,"Spok Holdings, Inc.","Spok Holdings, Inc., through its subsidiary, Spok, Inc., provides various communications solutions in the United States, Europe, Canada, Australia, Asia, and the Middle East. The company provides one-way messaging, including numeric messaging services, which enable subscribers to receive messages comprising numbers, such as phone numbers; and alphanumeric messages, including numbers and letters that enable subscribers to receive text messages. It also offers two-way messaging services that enable subscribers to send and receive messages to and from other wireless messaging devices, such as pagers, personal digital assistants, and personal computers; and voice mail, personalized greeting, message storage and retrieval, and equipment loss and/or maintenance protection to one-way and two-way messaging subscribers. In addition, the company develops, sells, and supports enterprise-wide systems to automate, centralize, and standardize clinical communications for contact centers, clinical alerting and notification, mobile communications, and messaging, as well as for public safety notifications. Further, it sells devices to resellers who lease or resell them to their subscribers; ancillary services, such as voicemail and equipment loss or maintenance protection, as well as provides a suite of professional services. The company serves businesses, professionals, management personnel, medical personnel, field sales personnel and service forces, members of the construction industry and construction trades, real estate brokers and developers, sales and services organizations, specialty trade organizations, manufacturing organizations, and government agencies. The company was formerly known as USA Mobility, Inc. and changed its name to Spok Holdings, Inc. in July 2014. Spok Holdings, Inc. is headquartered in Springfield, Virginia."
SPOK,2020-12-31,15828000,-21770000,NA,-44225000,76147000,103373000,2342000,2342000,NA,22455000,148180000,145838000,44807000,-24112000,NA,-44225000,-44225000,NA,income_statement,Telecom Services,"Spok Holdings, Inc.","Spok Holdings, Inc., through its subsidiary, Spok, Inc., provides various communications solutions in the United States, Europe, Canada, Australia, Asia, and the Middle East. The company provides one-way messaging, including numeric messaging services, which enable subscribers to receive messages comprising numbers, such as phone numbers; and alphanumeric messages, including numbers and letters that enable subscribers to receive text messages. It also offers two-way messaging services that enable subscribers to send and receive messages to and from other wireless messaging devices, such as pagers, personal digital assistants, and personal computers; and voice mail, personalized greeting, message storage and retrieval, and equipment loss and/or maintenance protection to one-way and two-way messaging subscribers. In addition, the company develops, sells, and supports enterprise-wide systems to automate, centralize, and standardize clinical communications for contact centers, clinical alerting and notification, mobile communications, and messaging, as well as for public safety notifications. Further, it sells devices to resellers who lease or resell them to their subscribers; ancillary services, such as voicemail and equipment loss or maintenance protection, as well as provides a suite of professional services. The company serves businesses, professionals, management personnel, medical personnel, field sales personnel and service forces, members of the construction industry and construction trades, real estate brokers and developers, sales and services organizations, specialty trade organizations, manufacturing organizations, and government agencies. The company was formerly known as USA Mobility, Inc. and changed its name to Spok Holdings, Inc. in July 2014. Spok Holdings, Inc. is headquartered in Springfield, Virginia."
SPPI,2016-12-31,59123000,-72083000,NA,-69770000,86018000,110601000,-60486000,-60486000,-9694000,-2313000,146444000,206930000,35843000,-11597000,8563000,-69770000,-69770000,NA,income_statement,Biotechnology,"Spectrum Pharmaceuticals, Inc.","Spectrum Pharmaceuticals, Inc., a biopharma company, develops and commercializes oncology and hematology drug products. The company is developing ROLONTIS, a novel long-acting granulocyte colony-stimulating for chemotherapy-induced neutropenia; Poziotinib, a novel irreversible tyrosine kinase inhibitor for non-small cell lung cancer tumors with various mutations; and Anti-CD20-IFNÃ¡, an antibody-interferon fusion molecule directed against CD20 that is in Phase I development for the treatment of relapsed or refractory non-Hodgkin's lymphoma patients, including diffuse large B-cell lymphoma. It has co-development, commercialization, and in-license agreements with Hanmi Pharmaceutical Co. Ltd.; a patent and technology license agreement with The University of Texas M.D. Anderson Cancer Center; and in-license agreement with ImmunGene, Inc. for interferon therapeutics drug delivery platform. The company was formerly known as NeoTherapeutics, Inc. and changed its name to Spectrum Pharmaceuticals, Inc. in December 2002. Spectrum Pharmaceuticals, Inc. was founded in 1987 and is headquartered in Henderson, Nevada."
SPPI,2017-12-31,51525000,-122693000,NA,-92189000,64759000,0,-116284000,-116284000,-8072000,-21941000,0,116284000,0,-6409000,8563000,-100752000,-92189000,NA,income_statement,Biotechnology,"Spectrum Pharmaceuticals, Inc.","Spectrum Pharmaceuticals, Inc., a biopharma company, develops and commercializes oncology and hematology drug products. The company is developing ROLONTIS, a novel long-acting granulocyte colony-stimulating for chemotherapy-induced neutropenia; Poziotinib, a novel irreversible tyrosine kinase inhibitor for non-small cell lung cancer tumors with various mutations; and Anti-CD20-IFNÃ¡, an antibody-interferon fusion molecule directed against CD20 that is in Phase I development for the treatment of relapsed or refractory non-Hodgkin's lymphoma patients, including diffuse large B-cell lymphoma. It has co-development, commercialization, and in-license agreements with Hanmi Pharmaceutical Co. Ltd.; a patent and technology license agreement with The University of Texas M.D. Anderson Cancer Center; and in-license agreement with ImmunGene, Inc. for interferon therapeutics drug delivery platform. The company was formerly known as NeoTherapeutics, Inc. and changed its name to Spectrum Pharmaceuticals, Inc. in December 2002. Spectrum Pharmaceuticals, Inc. was founded in 1987 and is headquartered in Henderson, Nevada."
SPPI,2018-12-31,75157000,-128607000,NA,-120741000,62690000,0,-137847000,-137847000,-3132000,-1901000,0,137847000,0,9240000,5965000,-126706000,-120741000,NA,income_statement,Biotechnology,"Spectrum Pharmaceuticals, Inc.","Spectrum Pharmaceuticals, Inc., a biopharma company, develops and commercializes oncology and hematology drug products. The company is developing ROLONTIS, a novel long-acting granulocyte colony-stimulating for chemotherapy-induced neutropenia; Poziotinib, a novel irreversible tyrosine kinase inhibitor for non-small cell lung cancer tumors with various mutations; and Anti-CD20-IFNÃ¡, an antibody-interferon fusion molecule directed against CD20 that is in Phase I development for the treatment of relapsed or refractory non-Hodgkin's lymphoma patients, including diffuse large B-cell lymphoma. It has co-development, commercialization, and in-license agreements with Hanmi Pharmaceutical Co. Ltd.; a patent and technology license agreement with The University of Texas M.D. Anderson Cancer Center; and in-license agreement with ImmunGene, Inc. for interferon therapeutics drug delivery platform. The company was formerly known as NeoTherapeutics, Inc. and changed its name to Spectrum Pharmaceuticals, Inc. in December 2002. Spectrum Pharmaceuticals, Inc. was founded in 1987 and is headquartered in Henderson, Nevada."
SPPI,2019-12-31,79025000,-144594000,NA,-112689000,59873000,0,-138898000,-138898000,NA,-9208000,0,138898000,0,-5696000,22697000,-135386000,-112689000,NA,income_statement,Biotechnology,"Spectrum Pharmaceuticals, Inc.","Spectrum Pharmaceuticals, Inc., a biopharma company, develops and commercializes oncology and hematology drug products. The company is developing ROLONTIS, a novel long-acting granulocyte colony-stimulating for chemotherapy-induced neutropenia; Poziotinib, a novel irreversible tyrosine kinase inhibitor for non-small cell lung cancer tumors with various mutations; and Anti-CD20-IFNÃ¡, an antibody-interferon fusion molecule directed against CD20 that is in Phase I development for the treatment of relapsed or refractory non-Hodgkin's lymphoma patients, including diffuse large B-cell lymphoma. It has co-development, commercialization, and in-license agreements with Hanmi Pharmaceutical Co. Ltd.; a patent and technology license agreement with The University of Texas M.D. Anderson Cancer Center; and in-license agreement with ImmunGene, Inc. for interferon therapeutics drug delivery platform. The company was formerly known as NeoTherapeutics, Inc. and changed its name to Spectrum Pharmaceuticals, Inc. in December 2002. Spectrum Pharmaceuticals, Inc. was founded in 1987 and is headquartered in Henderson, Nevada."
SPRB,2018-12-31,8403000,-9858000,NA,-9858000,1569000,0,-9972000,-9972000,-65000,0,0,9972000,0,114000,NA,-9858000,-9858000,NA,income_statement,Biotechnology,"Spruce Biosciences, Inc.","Spruce Biosciences, Inc., a biopharmaceutical company, focuses on developing and commercializing novel therapies for rare endocrine disorders. The company develops tildacerfont, an non-steroidal therapy, which is in Phase IIb clinical trial for adult patients with classic congenital adrenal hyperplasia (CAH) and in Phase II clinical trial in children with classic CAH. It is also developing tildacerfont for females with polycystic ovary syndrome. The company has a license agreement with Eli Lilly and Company to research, develop, and commercialize compounds for various pharmaceutical uses. Spruce Biosciences, Inc. was founded in 2014 and is headquartered in Daly City, California."
SPRB,2019-12-31,10817000,-13088000,NA,-13088000,2290000,0,-13107000,-13107000,-65000,0,0,13107000,0,19000,NA,-13088000,-13088000,NA,income_statement,Biotechnology,"Spruce Biosciences, Inc.","Spruce Biosciences, Inc., a biopharmaceutical company, focuses on developing and commercializing novel therapies for rare endocrine disorders. The company develops tildacerfont, an non-steroidal therapy, which is in Phase IIb clinical trial for adult patients with classic congenital adrenal hyperplasia (CAH) and in Phase II clinical trial in children with classic CAH. It is also developing tildacerfont for females with polycystic ovary syndrome. The company has a license agreement with Eli Lilly and Company to research, develop, and commercialize compounds for various pharmaceutical uses. Spruce Biosciences, Inc. was founded in 2014 and is headquartered in Daly City, California."
SPRO,2016-12-31,NA,-32641000,-3808000,-25491000,7223000,-25998000,-33221000,-33221000,NA,0,335000,33556000,26333000,580000,NA,-32641000,-29928000,NA,income_statement,Biotechnology,"Spero Therapeutics, Inc.","Spero Therapeutics, Inc., a clinical-stage biopharmaceutical company, focuses on identifying, developing, and commercializing novel treatments for multi-drug resistant (MDR) bacterial infections and rare diseases in the United States. Its product candidates include tebipenem pivoxil hydrobromide (HBr), an oral carbapenem-class antibiotic to treat MDR gram-negative infections for adults; SPR206, a direct acting IV-administered agent to treat MDR Gram-negative infections in the hospital; and SPR720, an oral antibiotic for the treatment of pulmonary non-tuberculous mycobacterial disease. Spero Therapeutics, Inc. has license agreement with Meiji Seika Pharma Co., Ltd. to support the development of tebipenem HBr; collaboration agreement with Everest Medicines to develop, manufacture, and commercialize SPR206 in Greater China, South Korea, and Southeast Asian countries; collaboration agreement with Bill & Melinda Gates Medical Research Institute to develop SPR720 for the treatment of lung infections caused by Mycobacterium tuberculosis; and license agreement with Vertex Pharmaceuticals Incorporated for patents relating to SPR720, as well as SPR719, an active metabolite. The company was founded in 2013 and is headquartered in Cambridge, Massachusetts."
SPRO,2017-12-31,NA,-39886000,355000,-38743000,10840000,-30890000,-41730000,-41730000,NA,0,1979000,43709000,32869000,1844000,NA,-39886000,-46097000,NA,income_statement,Biotechnology,"Spero Therapeutics, Inc.","Spero Therapeutics, Inc., a clinical-stage biopharmaceutical company, focuses on identifying, developing, and commercializing novel treatments for multi-drug resistant (MDR) bacterial infections and rare diseases in the United States. Its product candidates include tebipenem pivoxil hydrobromide (HBr), an oral carbapenem-class antibiotic to treat MDR gram-negative infections for adults; SPR206, a direct acting IV-administered agent to treat MDR Gram-negative infections in the hospital; and SPR720, an oral antibiotic for the treatment of pulmonary non-tuberculous mycobacterial disease. Spero Therapeutics, Inc. has license agreement with Meiji Seika Pharma Co., Ltd. to support the development of tebipenem HBr; collaboration agreement with Everest Medicines to develop, manufacture, and commercialize SPR206 in Greater China, South Korea, and Southeast Asian countries; collaboration agreement with Bill & Melinda Gates Medical Research Institute to develop SPR720 for the treatment of lung infections caused by Mycobacterium tuberculosis; and license agreement with Vertex Pharmaceuticals Incorporated for patents relating to SPR720, as well as SPR719, an active metabolite. The company was founded in 2013 and is headquartered in Cambridge, Massachusetts."
SPRO,2018-12-31,NA,-41662000,355000,-41662000,12887000,-29919000,-42806000,-42806000,NA,0,3966000,46772000,33885000,1144000,NA,-41662000,-41662000,NA,income_statement,Biotechnology,"Spero Therapeutics, Inc.","Spero Therapeutics, Inc., a clinical-stage biopharmaceutical company, focuses on identifying, developing, and commercializing novel treatments for multi-drug resistant (MDR) bacterial infections and rare diseases in the United States. Its product candidates include tebipenem pivoxil hydrobromide (HBr), an oral carbapenem-class antibiotic to treat MDR gram-negative infections for adults; SPR206, a direct acting IV-administered agent to treat MDR Gram-negative infections in the hospital; and SPR720, an oral antibiotic for the treatment of pulmonary non-tuberculous mycobacterial disease. Spero Therapeutics, Inc. has license agreement with Meiji Seika Pharma Co., Ltd. to support the development of tebipenem HBr; collaboration agreement with Everest Medicines to develop, manufacture, and commercialize SPR206 in Greater China, South Korea, and Southeast Asian countries; collaboration agreement with Bill & Melinda Gates Medical Research Institute to develop SPR720 for the treatment of lung infections caused by Mycobacterium tuberculosis; and license agreement with Vertex Pharmaceuticals Incorporated for patents relating to SPR720, as well as SPR719, an active metabolite. The company was founded in 2013 and is headquartered in Cambridge, Massachusetts."
SPRO,2019-12-31,NA,-60925000,NA,-60925000,15588000,-47628000,-63216000,-63216000,NA,0,18147000,81363000,65775000,2291000,NA,-60925000,-60925000,NA,income_statement,Biotechnology,"Spero Therapeutics, Inc.","Spero Therapeutics, Inc., a clinical-stage biopharmaceutical company, focuses on identifying, developing, and commercializing novel treatments for multi-drug resistant (MDR) bacterial infections and rare diseases in the United States. Its product candidates include tebipenem pivoxil hydrobromide (HBr), an oral carbapenem-class antibiotic to treat MDR gram-negative infections for adults; SPR206, a direct acting IV-administered agent to treat MDR Gram-negative infections in the hospital; and SPR720, an oral antibiotic for the treatment of pulmonary non-tuberculous mycobacterial disease. Spero Therapeutics, Inc. has license agreement with Meiji Seika Pharma Co., Ltd. to support the development of tebipenem HBr; collaboration agreement with Everest Medicines to develop, manufacture, and commercialize SPR206 in Greater China, South Korea, and Southeast Asian countries; collaboration agreement with Bill & Melinda Gates Medical Research Institute to develop SPR720 for the treatment of lung infections caused by Mycobacterium tuberculosis; and license agreement with Vertex Pharmaceuticals Incorporated for patents relating to SPR720, as well as SPR719, an active metabolite. The company was founded in 2013 and is headquartered in Cambridge, Massachusetts."
SPRT,2016-12-31,5577000,-15933000,NA,-15956000,19629000,10929000,-15305000,-15305000,NA,307000,61660000,76965000,50731000,-628000,284000,-16240000,-15956000,NA,income_statement,Software—Application,"Support.com, Inc.","Support.com, Inc. provides customer support services, end user software, and cloud-based software primarily in the United States. The company offers turnkey and outsourced support services for service providers, retailers, original equipment manufacturers (OEMs), warranty providers, Internet of Things solution providers, and other technology companies. Its customer support services programs include pre-purchased concierge advice, device set-up and troubleshooting, inter-operability problem resolution, and virus and malware removal, wireless network set-up, and home security and automation system onboarding and support designed for consumer, and small and medium business markets. The company also provides Support.com Cloud, a software-as-a-service solution for companies to optimize support interactions with their customers using their own or third party support personnel, as well as enables companies to resolve complex technology issues for their customers, provide ease of use for customer self-service, and enhance the customer experience. In addition, it offers end-user software products, including SUPERAntiSpyware for malware protection and removal. The company provides its technology support services through partners. Support.com, Inc. was founded in 1997 and is headquartered in Wilmington, Delaware."
SPRT,2017-12-31,3033000,-922000,NA,-1526000,11121000,12733000,-1437000,-1437000,NA,604000,60121000,61558000,47388000,515000,NA,-1526000,-1526000,NA,income_statement,Software—Application,"Support.com, Inc.","Support.com, Inc. provides customer support services, end user software, and cloud-based software primarily in the United States. The company offers turnkey and outsourced support services for service providers, retailers, original equipment manufacturers (OEMs), warranty providers, Internet of Things solution providers, and other technology companies. Its customer support services programs include pre-purchased concierge advice, device set-up and troubleshooting, inter-operability problem resolution, and virus and malware removal, wireless network set-up, and home security and automation system onboarding and support designed for consumer, and small and medium business markets. The company also provides Support.com Cloud, a software-as-a-service solution for companies to optimize support interactions with their customers using their own or third party support personnel, as well as enables companies to resolve complex technology issues for their customers, provide ease of use for customer self-service, and enhance the customer experience. In addition, it offers end-user software products, including SUPERAntiSpyware for malware protection and removal. The company provides its technology support services through partners. Support.com, Inc. was founded in 1997 and is headquartered in Wilmington, Delaware."
SPRT,2018-12-31,2780000,-9101000,NA,-9100000,9231000,11945000,-66000,-66000,NA,-1000,69549000,69615000,57604000,-9035000,NA,-9100000,-9100000,NA,income_statement,Software—Application,"Support.com, Inc.","Support.com, Inc. provides customer support services, end user software, and cloud-based software primarily in the United States. The company offers turnkey and outsourced support services for service providers, retailers, original equipment manufacturers (OEMs), warranty providers, Internet of Things solution providers, and other technology companies. Its customer support services programs include pre-purchased concierge advice, device set-up and troubleshooting, inter-operability problem resolution, and virus and malware removal, wireless network set-up, and home security and automation system onboarding and support designed for consumer, and small and medium business markets. The company also provides Support.com Cloud, a software-as-a-service solution for companies to optimize support interactions with their customers using their own or third party support personnel, as well as enables companies to resolve complex technology issues for their customers, provide ease of use for customer self-service, and enhance the customer experience. In addition, it offers end-user software products, including SUPERAntiSpyware for malware protection and removal. The company provides its technology support services through partners. Support.com, Inc. was founded in 1997 and is headquartered in Wilmington, Delaware."
SPRT,2019-12-31,4078000,4000000,NA,3846000,9439000,16468000,2951000,2951000,NA,154000,63333000,60382000,46865000,2098000,NA,3846000,3846000,NA,income_statement,Software—Application,"Support.com, Inc.","Support.com, Inc. provides customer support services, end user software, and cloud-based software primarily in the United States. The company offers turnkey and outsourced support services for service providers, retailers, original equipment manufacturers (OEMs), warranty providers, Internet of Things solution providers, and other technology companies. Its customer support services programs include pre-purchased concierge advice, device set-up and troubleshooting, inter-operability problem resolution, and virus and malware removal, wireless network set-up, and home security and automation system onboarding and support designed for consumer, and small and medium business markets. The company also provides Support.com Cloud, a software-as-a-service solution for companies to optimize support interactions with their customers using their own or third party support personnel, as well as enables companies to resolve complex technology issues for their customers, provide ease of use for customer self-service, and enhance the customer experience. In addition, it offers end-user software products, including SUPERAntiSpyware for malware protection and removal. The company provides its technology support services through partners. Support.com, Inc. was founded in 1997 and is headquartered in Wilmington, Delaware."
SPSC,2017-12-31,23183000,10693000,NA,351000,108722000,146460000,9981000,9981000,NA,10342000,220085000,210104000,73625000,712000,NA,351000,351000,NA,income_statement,Software—Infrastructure,"SPS Commerce, Inc.","SPS Commerce, Inc. provides cloud-based supply chain management solutions worldwide. It offers solutions through the SPS Commerce platform, a cloud-based platform that enhances the way retailers, suppliers, grocers, distributors, and logistics firms manage and fulfill orders, administer sell-through performance, and source new items. The company offers Trading Partner Community solution, which enables retailers, grocers, and distributors to introduce changes to their supply chain requirements to their trading partner community, and onboard new vendors to receive their first orders; Trading Partner Fulfillment solution that provides fulfillment automation and replaces or augments an organization's existing staff and trading partner electronic communication infrastructure; and Trading Partner Assortment solution to manage individual attributes associated with each item a retailer or supplier sells. It also provides Trading Partner Analytics solution, which consists of data analytics applications that allow customers to enhance their visibility and analysis of their supply chains; Trading Partner Sourcing solutions that enables retailers to source providers of new items, suppliers to connect with new retailers, and retailing community; and Other Trading Partner Solutions, such as barcode labeling, planogram services, and scan and pack application that helps trading partners process information to streamline the picking and packaging process. The company sells its solutions through retailer, supplier, and logistic sales representatives to small- to mid-sized suppliers, as well as retailers, distributors, third-party logistics providers, and other trading partners. The company was formerly known as St. Paul Software, Inc. and changed its name to SPS Commerce, Inc. in May 2001. SPS Commerce, Inc. was incorporated in 1987 and is headquartered in Minneapolis, Minnesota."
SPSC,2018-12-31,22087000,28340000,NA,23872000,113581000,166492000,26731000,26731000,NA,4468000,248240000,221509000,81748000,1609000,NA,23872000,23872000,NA,income_statement,Software—Infrastructure,"SPS Commerce, Inc.","SPS Commerce, Inc. provides cloud-based supply chain management solutions worldwide. It offers solutions through the SPS Commerce platform, a cloud-based platform that enhances the way retailers, suppliers, grocers, distributors, and logistics firms manage and fulfill orders, administer sell-through performance, and source new items. The company offers Trading Partner Community solution, which enables retailers, grocers, and distributors to introduce changes to their supply chain requirements to their trading partner community, and onboard new vendors to receive their first orders; Trading Partner Fulfillment solution that provides fulfillment automation and replaces or augments an organization's existing staff and trading partner electronic communication infrastructure; and Trading Partner Assortment solution to manage individual attributes associated with each item a retailer or supplier sells. It also provides Trading Partner Analytics solution, which consists of data analytics applications that allow customers to enhance their visibility and analysis of their supply chains; Trading Partner Sourcing solutions that enables retailers to source providers of new items, suppliers to connect with new retailers, and retailing community; and Other Trading Partner Solutions, such as barcode labeling, planogram services, and scan and pack application that helps trading partners process information to streamline the picking and packaging process. The company sells its solutions through retailer, supplier, and logistic sales representatives to small- to mid-sized suppliers, as well as retailers, distributors, third-party logistics providers, and other trading partners. The company was formerly known as St. Paul Software, Inc. and changed its name to SPS Commerce, Inc. in May 2001. SPS Commerce, Inc. was incorporated in 1987 and is headquartered in Minneapolis, Minnesota."
SPSC,2019-12-31,28305000,42070000,NA,33712000,114859000,186885000,38406000,38406000,NA,8358000,279124000,240718000,92239000,3664000,NA,33712000,33712000,NA,income_statement,Software—Infrastructure,"SPS Commerce, Inc.","SPS Commerce, Inc. provides cloud-based supply chain management solutions worldwide. It offers solutions through the SPS Commerce platform, a cloud-based platform that enhances the way retailers, suppliers, grocers, distributors, and logistics firms manage and fulfill orders, administer sell-through performance, and source new items. The company offers Trading Partner Community solution, which enables retailers, grocers, and distributors to introduce changes to their supply chain requirements to their trading partner community, and onboard new vendors to receive their first orders; Trading Partner Fulfillment solution that provides fulfillment automation and replaces or augments an organization's existing staff and trading partner electronic communication infrastructure; and Trading Partner Assortment solution to manage individual attributes associated with each item a retailer or supplier sells. It also provides Trading Partner Analytics solution, which consists of data analytics applications that allow customers to enhance their visibility and analysis of their supply chains; Trading Partner Sourcing solutions that enables retailers to source providers of new items, suppliers to connect with new retailers, and retailing community; and Other Trading Partner Solutions, such as barcode labeling, planogram services, and scan and pack application that helps trading partners process information to streamline the picking and packaging process. The company sells its solutions through retailer, supplier, and logistic sales representatives to small- to mid-sized suppliers, as well as retailers, distributors, third-party logistics providers, and other trading partners. The company was formerly known as St. Paul Software, Inc. and changed its name to SPS Commerce, Inc. in May 2001. SPS Commerce, Inc. was incorporated in 1987 and is headquartered in Minneapolis, Minnesota."
SPSC,2020-12-31,31024000,52680000,NA,45586000,126074000,212794000,50158000,50158000,NA,7094000,312630000,262472000,99836000,2522000,NA,45586000,45586000,NA,income_statement,Software—Infrastructure,"SPS Commerce, Inc.","SPS Commerce, Inc. provides cloud-based supply chain management solutions worldwide. It offers solutions through the SPS Commerce platform, a cloud-based platform that enhances the way retailers, suppliers, grocers, distributors, and logistics firms manage and fulfill orders, administer sell-through performance, and source new items. The company offers Trading Partner Community solution, which enables retailers, grocers, and distributors to introduce changes to their supply chain requirements to their trading partner community, and onboard new vendors to receive their first orders; Trading Partner Fulfillment solution that provides fulfillment automation and replaces or augments an organization's existing staff and trading partner electronic communication infrastructure; and Trading Partner Assortment solution to manage individual attributes associated with each item a retailer or supplier sells. It also provides Trading Partner Analytics solution, which consists of data analytics applications that allow customers to enhance their visibility and analysis of their supply chains; Trading Partner Sourcing solutions that enables retailers to source providers of new items, suppliers to connect with new retailers, and retailing community; and Other Trading Partner Solutions, such as barcode labeling, planogram services, and scan and pack application that helps trading partners process information to streamline the picking and packaging process. The company sells its solutions through retailer, supplier, and logistic sales representatives to small- to mid-sized suppliers, as well as retailers, distributors, third-party logistics providers, and other trading partners. The company was formerly known as St. Paul Software, Inc. and changed its name to SPS Commerce, Inc. in May 2001. SPS Commerce, Inc. was incorporated in 1987 and is headquartered in Minneapolis, Minnesota."
SPTN,2016-12-31,NA,89963000,NA,56828000,963570000,1111494000,147924000,147924000,-19082000,32907000,7561084000,7413160000,6449590000,-57961000,-228000,57056000,56828000,NA,income_statement,Food Distribution,SpartanNash Company,"SpartanNash Company distributes and retails grocery products. It operates in three segments: Food Distribution, Military, and Retail. The Food Distribution segment offers approximately 52,000 stock-keeping units, such as dry groceries, produce, dairy products, meat, delicatessen items, bakery goods, frozen food, seafood, floral products, general merchandise, beverages, tobacco products, health and beauty care, and pharmacy products to independent retailers, national retailers, food service distributors, e-commerce providers, and corporate owned retail stores. This segment also offers various value-added services to retailers. The Military segment sells and distributes grocery products to military commissaries and exchanges located in 39 states across the United States and the District of Columbia, Europe, Cuba, Puerto Rico, Honduras, Bahrain, Djibouti, and Egypt. The Retail segment primarily operates neighborhood supermarkets. As of March 17, 2020, it operated 155 supermarkets, primarily under the banners of Family Fare, Martin's Super Markets, D&W Fresh Market, VG's Grocery, and Dan's Supermarket. SpartanNash Company also markets and distributes private brand items primarily under the Our Family, Open Acres, Good to Go!, Nash's Coffee, Crav'n Flavor, Culinary Tours, Top Care, Tippy Toes, Full Circle Market, Culinary Tours, PAWS Happy Life, Pure Harmony, Red Button Vintage Creamery, Stoked, and That's Smart! brands. The company was formerly known as Spartan Stores, Inc. and changed its name to SpartanNash Company in November 2013. SpartanNash Company was founded in 1917 and is headquartered in Grand Rapids, Michigan."
SPTN,2017-12-30,NA,-131644000,NA,-52845000,1014665000,1144909000,130244000,130244000,-25343000,-79027000,7963799000,7833555000,6818890000,-261888000,-228000,-52617000,-52845000,NA,income_statement,Food Distribution,SpartanNash Company,"SpartanNash Company distributes and retails grocery products. It operates in three segments: Food Distribution, Military, and Retail. The Food Distribution segment offers approximately 52,000 stock-keeping units, such as dry groceries, produce, dairy products, meat, delicatessen items, bakery goods, frozen food, seafood, floral products, general merchandise, beverages, tobacco products, health and beauty care, and pharmacy products to independent retailers, national retailers, food service distributors, e-commerce providers, and corporate owned retail stores. This segment also offers various value-added services to retailers. The Military segment sells and distributes grocery products to military commissaries and exchanges located in 39 states across the United States and the District of Columbia, Europe, Cuba, Puerto Rico, Honduras, Bahrain, Djibouti, and Egypt. The Retail segment primarily operates neighborhood supermarkets. As of March 17, 2020, it operated 155 supermarkets, primarily under the banners of Family Fare, Martin's Super Markets, D&W Fresh Market, VG's Grocery, and Dan's Supermarket. SpartanNash Company also markets and distributes private brand items primarily under the Our Family, Open Acres, Good to Go!, Nash's Coffee, Crav'n Flavor, Culinary Tours, Top Care, Tippy Toes, Full Circle Market, Culinary Tours, PAWS Happy Life, Pure Harmony, Red Button Vintage Creamery, Stoked, and That's Smart! brands. The company was formerly known as Spartan Stores, Inc. and changed its name to SpartanNash Company in November 2013. SpartanNash Company was founded in 1917 and is headquartered in Grand Rapids, Michigan."
SPTN,2018-12-29,NA,40698000,NA,33572000,997570000,1110406000,112836000,112836000,-30483000,6907000,8064552000,7951716000,6954146000,-72138000,-219000,33791000,33572000,NA,income_statement,Food Distribution,SpartanNash Company,"SpartanNash Company distributes and retails grocery products. It operates in three segments: Food Distribution, Military, and Retail. The Food Distribution segment offers approximately 52,000 stock-keeping units, such as dry groceries, produce, dairy products, meat, delicatessen items, bakery goods, frozen food, seafood, floral products, general merchandise, beverages, tobacco products, health and beauty care, and pharmacy products to independent retailers, national retailers, food service distributors, e-commerce providers, and corporate owned retail stores. This segment also offers various value-added services to retailers. The Military segment sells and distributes grocery products to military commissaries and exchanges located in 39 states across the United States and the District of Columbia, Europe, Cuba, Puerto Rico, Honduras, Bahrain, Djibouti, and Egypt. The Retail segment primarily operates neighborhood supermarkets. As of March 17, 2020, it operated 155 supermarkets, primarily under the banners of Family Fare, Martin's Super Markets, D&W Fresh Market, VG's Grocery, and Dan's Supermarket. SpartanNash Company also markets and distributes private brand items primarily under the Our Family, Open Acres, Good to Go!, Nash's Coffee, Crav'n Flavor, Culinary Tours, Top Care, Tippy Toes, Full Circle Market, Culinary Tours, PAWS Happy Life, Pure Harmony, Red Button Vintage Creamery, Stoked, and That's Smart! brands. The company was formerly known as Spartan Stores, Inc. and changed its name to SpartanNash Company in November 2013. SpartanNash Company was founded in 1917 and is headquartered in Grand Rapids, Michigan."
SPTN,2019-12-28,NA,3575000,NA,5742000,1192204000,1243830000,51626000,51626000,-34548000,-2342000,8536065000,8484439000,7292235000,-48051000,-175000,5917000,5742000,NA,income_statement,Food Distribution,SpartanNash Company,"SpartanNash Company distributes and retails grocery products. It operates in three segments: Food Distribution, Military, and Retail. The Food Distribution segment offers approximately 52,000 stock-keeping units, such as dry groceries, produce, dairy products, meat, delicatessen items, bakery goods, frozen food, seafood, floral products, general merchandise, beverages, tobacco products, health and beauty care, and pharmacy products to independent retailers, national retailers, food service distributors, e-commerce providers, and corporate owned retail stores. This segment also offers various value-added services to retailers. The Military segment sells and distributes grocery products to military commissaries and exchanges located in 39 states across the United States and the District of Columbia, Europe, Cuba, Puerto Rico, Honduras, Bahrain, Djibouti, and Egypt. The Retail segment primarily operates neighborhood supermarkets. As of March 17, 2020, it operated 155 supermarkets, primarily under the banners of Family Fare, Martin's Super Markets, D&W Fresh Market, VG's Grocery, and Dan's Supermarket. SpartanNash Company also markets and distributes private brand items primarily under the Our Family, Open Acres, Good to Go!, Nash's Coffee, Crav'n Flavor, Culinary Tours, Top Care, Tippy Toes, Full Circle Market, Culinary Tours, PAWS Happy Life, Pure Harmony, Red Button Vintage Creamery, Stoked, and That's Smart! brands. The company was formerly known as Spartan Stores, Inc. and changed its name to SpartanNash Company in November 2013. SpartanNash Company was founded in 1917 and is headquartered in Grand Rapids, Michigan."
SPWH,2017-01-28,NA,47285000,NA,29669000,202747000,263230000,60830000,60830000,-13402000,17616000,779956000,719126000,516726000,-13545000,NA,29669000,29669000,-347000,income_statement,Leisure,"Sportsman's Warehouse Holdings,","Sportsman's Warehouse Holdings, Inc., together with its subsidiaries, operates as an outdoor sporting goods retailer in the United States. It offers camping products, such as backpacks, camp essentials, canoes and kayaks, coolers, outdoor cooking equipment, sleeping bags, tents, and tools; and clothing products, including camouflage, jackets, hats, outerwear, sportswear, technical gear, and work wear. The company also provides fishing products comprising bait, electronics, fishing rods, flotation items, fly fishing products, lines, lures, reels, tackles, and small boats; and foot wear products consisting of hiking and work boots, socks, sport sandals, technical footwear, trial and casual shoes, and waders. In addition, it offers hunting and shooting products, such as ammunition, archery items, ATV accessories, blinds and tree stands, decoys, firearms, firearms safety and storage products, reloading equipment, and shooting gear products; and optics, electronics, and accessories, including gift items, GPS devices, knives, lighting, optics, and two-way radios. Further, the company's stores provide archery technician services, fishing-reel line winding, gun bore sighting and scope mounting, and cleaning services, as well as issues hunting and fishing licenses. Additionally, it offers various private label offerings under the Rustic Ridge, Killik, Vital Impact, Yukon Gold, Lost Creek, and Sportsman's Warehouse brands. As of February 01, 2020, the company operated through 103 stores in 27 states. Sportsman's Warehouse Holdings, Inc. was founded in 1986 and is headquartered in West Jordan, Utah."
SPWH,2018-02-03,NA,32830000,NA,17742000,225469000,273860000,49728000,49728000,-13738000,15088000,809671000,759943000,535811000,-16898000,NA,17742000,17742000,-1337000,income_statement,Leisure,"Sportsman's Warehouse Holdings,","Sportsman's Warehouse Holdings, Inc., together with its subsidiaries, operates as an outdoor sporting goods retailer in the United States. It offers camping products, such as backpacks, camp essentials, canoes and kayaks, coolers, outdoor cooking equipment, sleeping bags, tents, and tools; and clothing products, including camouflage, jackets, hats, outerwear, sportswear, technical gear, and work wear. The company also provides fishing products comprising bait, electronics, fishing rods, flotation items, fly fishing products, lines, lures, reels, tackles, and small boats; and foot wear products consisting of hiking and work boots, socks, sport sandals, technical footwear, trial and casual shoes, and waders. In addition, it offers hunting and shooting products, such as ammunition, archery items, ATV accessories, blinds and tree stands, decoys, firearms, firearms safety and storage products, reloading equipment, and shooting gear products; and optics, electronics, and accessories, including gift items, GPS devices, knives, lighting, optics, and two-way radios. Further, the company's stores provide archery technician services, fishing-reel line winding, gun bore sighting and scope mounting, and cleaning services, as well as issues hunting and fishing licenses. Additionally, it offers various private label offerings under the Rustic Ridge, Killik, Vital Impact, Yukon Gold, Lost Creek, and Sportsman's Warehouse brands. As of February 01, 2020, the company operated through 103 stores in 27 states. Sportsman's Warehouse Holdings, Inc. was founded in 1986 and is headquartered in West Jordan, Utah."
SPWH,2019-02-02,NA,30813000,NA,23750000,241918000,284930000,44019000,44019000,-13206000,7063000,849129000,805110000,564199000,-13206000,NA,23750000,23750000,-1007000,income_statement,Leisure,"Sportsman's Warehouse Holdings,","Sportsman's Warehouse Holdings, Inc., together with its subsidiaries, operates as an outdoor sporting goods retailer in the United States. It offers camping products, such as backpacks, camp essentials, canoes and kayaks, coolers, outdoor cooking equipment, sleeping bags, tents, and tools; and clothing products, including camouflage, jackets, hats, outerwear, sportswear, technical gear, and work wear. The company also provides fishing products comprising bait, electronics, fishing rods, flotation items, fly fishing products, lines, lures, reels, tackles, and small boats; and foot wear products consisting of hiking and work boots, socks, sport sandals, technical footwear, trial and casual shoes, and waders. In addition, it offers hunting and shooting products, such as ammunition, archery items, ATV accessories, blinds and tree stands, decoys, firearms, firearms safety and storage products, reloading equipment, and shooting gear products; and optics, electronics, and accessories, including gift items, GPS devices, knives, lighting, optics, and two-way radios. Further, the company's stores provide archery technician services, fishing-reel line winding, gun bore sighting and scope mounting, and cleaning services, as well as issues hunting and fishing licenses. Additionally, it offers various private label offerings under the Rustic Ridge, Killik, Vital Impact, Yukon Gold, Lost Creek, and Sportsman's Warehouse brands. As of February 01, 2020, the company operated through 103 stores in 27 states. Sportsman's Warehouse Holdings, Inc. was founded in 1986 and is headquartered in West Jordan, Utah."
SPWH,2020-02-01,NA,25469000,NA,20215000,263937000,296633000,34126000,34126000,-7995000,5254000,886401000,852275000,589768000,-8657000,NA,20215000,20215000,-1430000,income_statement,Leisure,"Sportsman's Warehouse Holdings,","Sportsman's Warehouse Holdings, Inc., together with its subsidiaries, operates as an outdoor sporting goods retailer in the United States. It offers camping products, such as backpacks, camp essentials, canoes and kayaks, coolers, outdoor cooking equipment, sleeping bags, tents, and tools; and clothing products, including camouflage, jackets, hats, outerwear, sportswear, technical gear, and work wear. The company also provides fishing products comprising bait, electronics, fishing rods, flotation items, fly fishing products, lines, lures, reels, tackles, and small boats; and foot wear products consisting of hiking and work boots, socks, sport sandals, technical footwear, trial and casual shoes, and waders. In addition, it offers hunting and shooting products, such as ammunition, archery items, ATV accessories, blinds and tree stands, decoys, firearms, firearms safety and storage products, reloading equipment, and shooting gear products; and optics, electronics, and accessories, including gift items, GPS devices, knives, lighting, optics, and two-way radios. Further, the company's stores provide archery technician services, fishing-reel line winding, gun bore sighting and scope mounting, and cleaning services, as well as issues hunting and fishing licenses. Additionally, it offers various private label offerings under the Rustic Ridge, Killik, Vital Impact, Yukon Gold, Lost Creek, and Sportsman's Warehouse brands. As of February 01, 2020, the company operated through 103 stores in 27 states. Sportsman's Warehouse Holdings, Inc. was founded in 1986 and is headquartered in West Jordan, Utah."
SPWR,2017-12-31,82247000,-1174812000,119415000,-929121000,278645000,-18645000,-379537000,-379537000,-90288000,-3944000,1794047000,2173584000,1812692000,-795275000,-124307000,-1170868000,-929121000,NA,income_statement,Solar,SunPower Corporation,"SunPower Corporation delivers solar solutions worldwide. It operates through SunPower Energy Services and SunPower Technologies segments. The company provides solar power components, including panels and system components, primarily to dealers, system integrators, and distributors. It also offers commercial rooftop and ground-mounted solar power systems, and residential mounting systems. In addition, the company provides post-installation operations and maintenance services. Further, it leases and sells solar power systems to residential customers; and sells inverters manufactured by third parties. The company also serves investors, financial institutions, project developers, electric utilities, independent power producers, commercial and governmental entities, production home builders, residential owners, and small commercial building owners. The company was founded in 1985 and is headquartered in San Jose, California. SunPower Corporation is a subsidiary of Total Energies Nouvelles ActivitÃ©s USA, SAS."
SPWR,2018-12-30,68905000,-916486000,58810000,-811091000,260111000,67879000,-261137000,-261137000,-108011000,1010000,1726085000,1987222000,1658206000,-655349000,-124307000,-917496000,-811091000,NA,income_statement,Solar,SunPower Corporation,"SunPower Corporation delivers solar solutions worldwide. It operates through SunPower Energy Services and SunPower Technologies segments. The company provides solar power components, including panels and system components, primarily to dealers, system integrators, and distributors. It also offers commercial rooftop and ground-mounted solar power systems, and residential mounting systems. In addition, the company provides post-installation operations and maintenance services. Further, it leases and sells solar power systems to residential customers; and sells inverters manufactured by third parties. The company also serves investors, financial institutions, project developers, electric utilities, independent power producers, commercial and governmental entities, production home builders, residential owners, and small commercial building owners. The company was founded in 1985 and is headquartered in San Jose, California. SunPower Corporation is a subsidiary of Total Energies Nouvelles ActivitÃ©s USA, SAS."
SPWR,2019-12-29,67515000,18910000,11336000,22159000,260443000,127572000,-200386000,-200386000,-53353000,26631000,1864225000,2064611000,1736653000,219296000,-124307000,-7721000,22159000,NA,income_statement,Solar,SunPower Corporation,"SunPower Corporation delivers solar solutions worldwide. It operates through SunPower Energy Services and SunPower Technologies segments. The company provides solar power components, including panels and system components, primarily to dealers, system integrators, and distributors. It also offers commercial rooftop and ground-mounted solar power systems, and residential mounting systems. In addition, the company provides post-installation operations and maintenance services. Further, it leases and sells solar power systems to residential customers; and sells inverters manufactured by third parties. The company also serves investors, financial institutions, project developers, electric utilities, independent power producers, commercial and governmental entities, production home builders, residential owners, and small commercial building owners. The company was founded in 1985 and is headquartered in San Jose, California. SunPower Corporation is a subsidiary of Total Energies Nouvelles ActivitÃ©s USA, SAS."
SPWR,2021-01-03,22381000,654569000,2319000,475048000,156596000,167682000,-11295000,-11295000,-33153000,57549000,1124829000,1136124000,957147000,665864000,-124307000,597020000,475048000,NA,income_statement,Solar,SunPower Corporation,"SunPower Corporation delivers solar solutions worldwide. It operates through SunPower Energy Services and SunPower Technologies segments. The company provides solar power components, including panels and system components, primarily to dealers, system integrators, and distributors. It also offers commercial rooftop and ground-mounted solar power systems, and residential mounting systems. In addition, the company provides post-installation operations and maintenance services. Further, it leases and sells solar power systems to residential customers; and sells inverters manufactured by third parties. The company also serves investors, financial institutions, project developers, electric utilities, independent power producers, commercial and governmental entities, production home builders, residential owners, and small commercial building owners. The company was founded in 1985 and is headquartered in San Jose, California. SunPower Corporation is a subsidiary of Total Energies Nouvelles ActivitÃ©s USA, SAS."
SQBG,2016-12-31,NA,15788000,74813000,-821000,9600000,86736000,77136000,77136000,-50538000,9157000,155528000,78392000,68792000,-61348000,104615000,6631000,-821000,NA,income_statement,Apparel Manufacturing,"Sequential Brands Group, Inc.","Sequential Brands Group, Inc., together with its subsidiaries, owns various consumer brands in the active and lifestyle categories. The company licenses its brands for a range of product categories, including apparel, footwear, fashion accessories, and home goods. Its brands include Jessica Simpson, AND1, Avia, Joe's, GAIAM, Ellen Tracy, William Rast, Heelys, Caribbean Joe, DVS, The Franklin Mint, Linens N Things, SPRI, and Nevados. The company promotes, markets, and licenses its brands through various distribution channels, including to retailers, wholesalers, and distributors in the United States and internationally. Sequential Brands Group, Inc. was incorporated in 2015 and is headquartered in New York, New York."
SQBG,2017-12-31,NA,-330584000,71547000,-185718000,6200000,83928000,77728000,77728000,-59000000,-44423000,124780000,47052000,40852000,-408312000,104615000,-286161000,-185718000,NA,income_statement,Apparel Manufacturing,"Sequential Brands Group, Inc.","Sequential Brands Group, Inc., together with its subsidiaries, owns various consumer brands in the active and lifestyle categories. The company licenses its brands for a range of product categories, including apparel, footwear, fashion accessories, and home goods. Its brands include Jessica Simpson, AND1, Avia, Joe's, GAIAM, Ellen Tracy, William Rast, Heelys, Caribbean Joe, DVS, The Franklin Mint, Linens N Things, SPRI, and Nevados. The company promotes, markets, and licenses its brands through various distribution channels, including to retailers, wholesalers, and distributors in the United States and internationally. Sequential Brands Group, Inc. was incorporated in 2015 and is headquartered in New York, New York."
SQBG,2018-12-31,NA,-13906000,70726000,-10484000,11800000,84167000,72367000,72367000,-55464000,-1944000,127290000,54923000,43123000,-86273000,6984000,-11962000,-10484000,NA,income_statement,Apparel Manufacturing,"Sequential Brands Group, Inc.","Sequential Brands Group, Inc., together with its subsidiaries, owns various consumer brands in the active and lifestyle categories. The company licenses its brands for a range of product categories, including apparel, footwear, fashion accessories, and home goods. Its brands include Jessica Simpson, AND1, Avia, Joe's, GAIAM, Ellen Tracy, William Rast, Heelys, Caribbean Joe, DVS, The Franklin Mint, Linens N Things, SPRI, and Nevados. The company promotes, markets, and licenses its brands through various distribution channels, including to retailers, wholesalers, and distributors in the United States and internationally. Sequential Brands Group, Inc. was incorporated in 2015 and is headquartered in New York, New York."
SQBG,2019-12-31,NA,-49071000,59324000,-159403000,12900000,57705000,44805000,44805000,-54760000,-8695000,101576000,56771000,43871000,-93876000,-125063000,-40376000,-159403000,NA,income_statement,Apparel Manufacturing,"Sequential Brands Group, Inc.","Sequential Brands Group, Inc., together with its subsidiaries, owns various consumer brands in the active and lifestyle categories. The company licenses its brands for a range of product categories, including apparel, footwear, fashion accessories, and home goods. Its brands include Jessica Simpson, AND1, Avia, Joe's, GAIAM, Ellen Tracy, William Rast, Heelys, Caribbean Joe, DVS, The Franklin Mint, Linens N Things, SPRI, and Nevados. The company promotes, markets, and licenses its brands through various distribution channels, including to retailers, wholesalers, and distributors in the United States and internationally. Sequential Brands Group, Inc. was incorporated in 2015 and is headquartered in New York, New York."
SQFT,2016-12-31,NA,-5357223,12658777,-5812485,5065579,22171727,6849963,6849963,-13531337,213860,32452112,25602149,10280385,-12207186,NA,-5571083,-5812485,NA,income_statement,REIT—Diversified,"Presidio Property Trust, Inc.","The Company is an internally managed, diversified REIT (formerly named NetREIT). The Company acquires, owns and manages a geographically diversified portfolio of real estate assets including office, industrial, retail and model home residential properties leased to homebuilders located throughout the United States. As of September 30, 2020, the Company owned or had an equity interest in: 128 Model Homes that are owned by six affiliated limited partnerships and one wholly-owned corporation; Ten office buildings and one industrial property, which totals approximately 998,016 rentable square feet; and Four retail shopping centers, which total approximately 131,722 rentable square feet."
SQFT,2017-12-31,NA,-2633399,14396349,-3484416,5200592,22577781,7666924,7666924,-12954079,208681,33374142,25707218,10796361,-10300323,NA,-2842080,-3484416,NA,income_statement,REIT—Diversified,"Presidio Property Trust, Inc.","The Company is an internally managed, diversified REIT (formerly named NetREIT). The Company acquires, owns and manages a geographically diversified portfolio of real estate assets including office, industrial, retail and model home residential properties leased to homebuilders located throughout the United States. As of September 30, 2020, the Company owned or had an equity interest in: 128 Model Homes that are owned by six affiliated limited partnerships and one wholly-owned corporation; Ten office buildings and one industrial property, which totals approximately 998,016 rentable square feet; and Four retail shopping centers, which total approximately 131,722 rentable square feet."
SQFT,2018-12-31,NA,4971290,15725650,3384294,4532703,21431117,7796809,7796809,-13041016,518567,32344013,24547204,10912896,-2825519,NA,4452723,3384294,NA,income_statement,REIT—Diversified,"Presidio Property Trust, Inc.","The Company is an internally managed, diversified REIT (formerly named NetREIT). The Company acquires, owns and manages a geographically diversified portfolio of real estate assets including office, industrial, retail and model home residential properties leased to homebuilders located throughout the United States. As of September 30, 2020, the Company owned or had an equity interest in: 128 Model Homes that are owned by six affiliated limited partnerships and one wholly-owned corporation; Ten office buildings and one industrial property, which totals approximately 998,016 rentable square feet; and Four retail shopping centers, which total approximately 131,722 rentable square feet."
SQFT,2019-12-31,NA,1384197,17440394,-610206,5268315,18206268,5573265,5573265,-10649646,611263,28641111,23067846,10434843,-4189068,NA,772934,-610206,NA,income_statement,REIT—Diversified,"Presidio Property Trust, Inc.","The Company is an internally managed, diversified REIT (formerly named NetREIT). The Company acquires, owns and manages a geographically diversified portfolio of real estate assets including office, industrial, retail and model home residential properties leased to homebuilders located throughout the United States. As of September 30, 2020, the Company owned or had an equity interest in: 128 Model Homes that are owned by six affiliated limited partnerships and one wholly-owned corporation; Ten office buildings and one industrial property, which totals approximately 998,016 rentable square feet; and Four retail shopping centers, which total approximately 131,722 rentable square feet."
SRAC,2019-12-31,NA,188445,NA,106901,404717,0,-404717,-404717,NA,81543,0,404717,0,593162,NA,106901,106901,NA,income_statement,Shell Companies,Stable Road Acquisition Corp.,"Stable Road Acquisition Corp. does not have significant operations. It intends to effect a merger, capital stock exchange, asset acquisition, stock purchase, reorganization, or similar business combination with one or more businesses in the cannabis industry. The company was founded in 2019 and is based in Venice, California."
SRAX,2016-12-31,NA,-4248233,NA,-4248233,16648705,12536052,-4112653,-4112653,-3210076,0,35763047,39875700,23226995,-135580,NA,-4248233,-4248233,1113000,income_statement,Advertising Agencies,"SRAX, Inc.","SRAX, Inc., a digital marketing and data technology company, provides tools to reach consumers with marketing and advertising communication in the United States. The company's machine learning technology analyzes marketing data to identify core consumers and their characteristics across marketing channels. It also offers SRAX IR, software as a service (Saas) that enables companies to understand their shareholder base through the tracking of holdings, the management of investor contact information, and identification of trends in the purchase and sale of issuer's securities; and BIGToken platform, a consumer data management platform where consumers rewarded for providing and verifying their data and completing activities within the platform. The company provides data management, audience optimization and recognition, multi-channel and omni channel media, and marketing services. The company markets and sells its services through its in-house sales team, as well as through industry specific events. The company was formerly known as Social Reality, Inc. and changed its name to SRAX, Inc. in August 2019. SRAX, Inc. was founded in 2009 and is headquartered in Los Angeles, California."
SRAX,2017-12-31,NA,-13032117,NA,-13032117,17016789,14019821,-2996968,-2996968,-4128524,0,23348714,26345682,9328893,-10035149,NA,-13032117,-13032117,1113000,income_statement,Advertising Agencies,"SRAX, Inc.","SRAX, Inc., a digital marketing and data technology company, provides tools to reach consumers with marketing and advertising communication in the United States. The company's machine learning technology analyzes marketing data to identify core consumers and their characteristics across marketing channels. It also offers SRAX IR, software as a service (Saas) that enables companies to understand their shareholder base through the tracking of holdings, the management of investor contact information, and identification of trends in the purchase and sale of issuer's securities; and BIGToken platform, a consumer data management platform where consumers rewarded for providing and verifying their data and completing activities within the platform. The company provides data management, audience optimization and recognition, multi-channel and omni channel media, and marketing services. The company markets and sells its services through its in-house sales team, as well as through industry specific events. The company was formerly known as Social Reality, Inc. and changed its name to SRAX, Inc. in August 2019. SRAX, Inc. was founded in 2009 and is headquartered in Los Angeles, California."
SRAX,2018-12-31,NA,8744000,NA,8744000,16562000,6724000,-11719000,-11719000,-7351000,0,9881000,21600000,3157000,20463000,NA,8744000,8744000,1113000,income_statement,Advertising Agencies,"SRAX, Inc.","SRAX, Inc., a digital marketing and data technology company, provides tools to reach consumers with marketing and advertising communication in the United States. The company's machine learning technology analyzes marketing data to identify core consumers and their characteristics across marketing channels. It also offers SRAX IR, software as a service (Saas) that enables companies to understand their shareholder base through the tracking of holdings, the management of investor contact information, and identification of trends in the purchase and sale of issuer's securities; and BIGToken platform, a consumer data management platform where consumers rewarded for providing and verifying their data and completing activities within the platform. The company provides data management, audience optimization and recognition, multi-channel and omni channel media, and marketing services. The company markets and sells its services through its in-house sales team, as well as through industry specific events. The company was formerly known as Social Reality, Inc. and changed its name to SRAX, Inc. in August 2019. SRAX, Inc. was founded in 2009 and is headquartered in Los Angeles, California."
SRAX,2019-12-31,NA,-16859000,NA,-16859000,16860000,1904000,-17858000,-17858000,-725000,0,3584000,21442000,1680000,999000,NA,-16859000,-16859000,1738000,income_statement,Advertising Agencies,"SRAX, Inc.","SRAX, Inc., a digital marketing and data technology company, provides tools to reach consumers with marketing and advertising communication in the United States. The company's machine learning technology analyzes marketing data to identify core consumers and their characteristics across marketing channels. It also offers SRAX IR, software as a service (Saas) that enables companies to understand their shareholder base through the tracking of holdings, the management of investor contact information, and identification of trends in the purchase and sale of issuer's securities; and BIGToken platform, a consumer data management platform where consumers rewarded for providing and verifying their data and completing activities within the platform. The company provides data management, audience optimization and recognition, multi-channel and omni channel media, and marketing services. The company markets and sells its services through its in-house sales team, as well as through industry specific events. The company was formerly known as Social Reality, Inc. and changed its name to SRAX, Inc. in August 2019. SRAX, Inc. was founded in 2009 and is headquartered in Los Angeles, California."
SRCE,2017-12-31,NA,101360000,1508000,68051000,163162000,275657000,0,107031000,NA,33309000,275657000,168626000,0,-5671000,NA,68051000,67531000,5464000,income_statement,Banks—Regional,1st Source Corporation,"1st Source Corporation operates as the holding company for 1st Source Bank that provides commercial and consumer banking services, trust and wealth advisory services, and insurance to individual and business clients. Its consumer banking services include checking and savings accounts; certificates of deposit; individual retirement accounts; online and mobile banking products; consumer loans, real estate loans, and lines of credit; and financial planning, financial literacy, and other consultative services, as well as debit and credit cards. The company also offers commercial, small business, agricultural, and real estate loans for general corporate purposes, including financing for industrial and commercial properties, equipment, inventories, accounts receivables, and renewable energy and acquisition financing; and commercial leasing, treasury management, and retirement planning services. In addition, it provides a range of trust, investment, agency, and custodial services comprising administration of estates and personal trusts, as well as management of investment accounts for individuals, employee benefit plans, and charitable foundations. Further, the company offers equipment loan and lease products for new and used aircraft, auto and light trucks, construction equipment, and medium and heavy duty trucks; and leases construction equipment, various types of trucks, vans, automobiles, motor coaches, shuttle buses, and other equipment. Additionally, it provides corporate and personal property, casualty, and individual and group health and life insurance products and services; and investment advisory services to trust and investment clients. As of December 31, 2019, the company operated through 80 banking centers in 17 counties in Indiana and Michigan, and Sarasota County in Florida. 1st Source Corporation was founded in 1863 and is headquartered in South Bend, Indiana."
SRCE,2018-12-31,NA,105027000,1508000,82414000,173691000,291622000,0,111425000,NA,22613000,291622000,180197000,0,-6398000,NA,82414000,81869000,6506000,income_statement,Banks—Regional,1st Source Corporation,"1st Source Corporation operates as the holding company for 1st Source Bank that provides commercial and consumer banking services, trust and wealth advisory services, and insurance to individual and business clients. Its consumer banking services include checking and savings accounts; certificates of deposit; individual retirement accounts; online and mobile banking products; consumer loans, real estate loans, and lines of credit; and financial planning, financial literacy, and other consultative services, as well as debit and credit cards. The company also offers commercial, small business, agricultural, and real estate loans for general corporate purposes, including financing for industrial and commercial properties, equipment, inventories, accounts receivables, and renewable energy and acquisition financing; and commercial leasing, treasury management, and retirement planning services. In addition, it provides a range of trust, investment, agency, and custodial services comprising administration of estates and personal trusts, as well as management of investment accounts for individuals, employee benefit plans, and charitable foundations. Further, the company offers equipment loan and lease products for new and used aircraft, auto and light trucks, construction equipment, and medium and heavy duty trucks; and leases construction equipment, various types of trucks, vans, automobiles, motor coaches, shuttle buses, and other equipment. Additionally, it provides corporate and personal property, casualty, and individual and group health and life insurance products and services; and investment advisory services to trust and investment clients. As of December 31, 2019, the company operated through 80 banking centers in 17 counties in Indiana and Michigan, and Sarasota County in Florida. 1st Source Corporation was founded in 1863 and is headquartered in South Bend, Indiana."
SRCE,2019-12-31,NA,120154000,20359000,91960000,177278000,310414000,0,125351000,NA,28139000,310414000,185063000,0,-5197000,NA,92015000,91442000,7785000,income_statement,Banks—Regional,1st Source Corporation,"1st Source Corporation operates as the holding company for 1st Source Bank that provides commercial and consumer banking services, trust and wealth advisory services, and insurance to individual and business clients. Its consumer banking services include checking and savings accounts; certificates of deposit; individual retirement accounts; online and mobile banking products; consumer loans, real estate loans, and lines of credit; and financial planning, financial literacy, and other consultative services, as well as debit and credit cards. The company also offers commercial, small business, agricultural, and real estate loans for general corporate purposes, including financing for industrial and commercial properties, equipment, inventories, accounts receivables, and renewable energy and acquisition financing; and commercial leasing, treasury management, and retirement planning services. In addition, it provides a range of trust, investment, agency, and custodial services comprising administration of estates and personal trusts, as well as management of investment accounts for individuals, employee benefit plans, and charitable foundations. Further, the company offers equipment loan and lease products for new and used aircraft, auto and light trucks, construction equipment, and medium and heavy duty trucks; and leases construction equipment, various types of trucks, vans, automobiles, motor coaches, shuttle buses, and other equipment. Additionally, it provides corporate and personal property, casualty, and individual and group health and life insurance products and services; and investment advisory services to trust and investment clients. As of December 31, 2019, the company operated through 80 banking centers in 17 counties in Indiana and Michigan, and Sarasota County in Florida. 1st Source Corporation was founded in 1863 and is headquartered in South Bend, Indiana."
SRCE,2020-12-31,NA,106341000,43825000,81437000,173760000,295198000,0,113536000,NA,24880000,295198000,181662000,0,-7195000,NA,81461000,81437000,7902000,income_statement,Banks—Regional,1st Source Corporation,"1st Source Corporation operates as the holding company for 1st Source Bank that provides commercial and consumer banking services, trust and wealth advisory services, and insurance to individual and business clients. Its consumer banking services include checking and savings accounts; certificates of deposit; individual retirement accounts; online and mobile banking products; consumer loans, real estate loans, and lines of credit; and financial planning, financial literacy, and other consultative services, as well as debit and credit cards. The company also offers commercial, small business, agricultural, and real estate loans for general corporate purposes, including financing for industrial and commercial properties, equipment, inventories, accounts receivables, and renewable energy and acquisition financing; and commercial leasing, treasury management, and retirement planning services. In addition, it provides a range of trust, investment, agency, and custodial services comprising administration of estates and personal trusts, as well as management of investment accounts for individuals, employee benefit plans, and charitable foundations. Further, the company offers equipment loan and lease products for new and used aircraft, auto and light trucks, construction equipment, and medium and heavy duty trucks; and leases construction equipment, various types of trucks, vans, automobiles, motor coaches, shuttle buses, and other equipment. Additionally, it provides corporate and personal property, casualty, and individual and group health and life insurance products and services; and investment advisory services to trust and investment clients. As of December 31, 2019, the company operated through 80 banking centers in 17 counties in Indiana and Michigan, and Sarasota County in Florida. 1st Source Corporation was founded in 1863 and is headquartered in South Bend, Indiana."
SRCL,2016-12-31,NA,328100000,10600000,206300000,777100000,1495900000,589500000,589500000,-97800000,120200000,3562300000,2972800000,2066400000,-261400000,NA,207900000,178200000,NA,income_statement,Waste Management,"Stericycle, Inc.","Stericycle, Inc., together with its subsidiaries, provides regulated and compliance solutions to the healthcare, retail, and commercial businesses in the United States, Europe, and internationally. It operates through three segments: North America RWCS; International RWCS; and Domestic Communication and Related Services. It collects and processes regulated and specialized waste for disposal services; and collects personal and confidential information for secure destruction, recall/return, and communication services. The company's services also include medical waste disposal, pharmaceutical waste disposal, hazardous waste management, sustainability solutions for expired or unused inventory, secure information destruction of documents and e-media, and compliance services; and regulated recall and returns management communication, logistics, and data management services for expired, withdrawn, or recalled products. In addition, it offers compliance programs under the Steri-Safe, Clinical Services, First Practice Management, SeguriMed, and EnviroAssure brand names. The company serves healthcare businesses, including hospitals, physician and dental practices, outpatient clinics, long-term care facilities, etc.; retailers and manufacturers; financial and professional service providers; governmental entities; and other businesses. Stericycle, Inc. was founded in 1989 and is headquartered in Bannockburn, Illinois."
SRCL,2017-12-31,NA,-107900000,12000000,42400000,840200000,1463600000,505000000,505000000,-93700000,-150900000,3580700000,3075700000,2117100000,-612900000,NA,43000000,23400000,NA,income_statement,Waste Management,"Stericycle, Inc.","Stericycle, Inc., together with its subsidiaries, provides regulated and compliance solutions to the healthcare, retail, and commercial businesses in the United States, Europe, and internationally. It operates through three segments: North America RWCS; International RWCS; and Domestic Communication and Related Services. It collects and processes regulated and specialized waste for disposal services; and collects personal and confidential information for secure destruction, recall/return, and communication services. The company's services also include medical waste disposal, pharmaceutical waste disposal, hazardous waste management, sustainability solutions for expired or unused inventory, secure information destruction of documents and e-media, and compliance services; and regulated recall and returns management communication, logistics, and data management services for expired, withdrawn, or recalled products. In addition, it offers compliance programs under the Steri-Safe, Clinical Services, First Practice Management, SeguriMed, and EnviroAssure brand names. The company serves healthcare businesses, including hospitals, physician and dental practices, outpatient clinics, long-term care facilities, etc.; retailers and manufacturers; financial and professional service providers; governmental entities; and other businesses. Stericycle, Inc. was founded in 1989 and is headquartered in Bannockburn, Illinois."
SRCL,2018-12-31,NA,-275400000,9700000,-244700000,804900000,1394800000,459600000,459600000,-103300000,-29800000,3485900000,3026300000,2091100000,-735000000,NA,-245600000,-253300000,NA,income_statement,Waste Management,"Stericycle, Inc.","Stericycle, Inc., together with its subsidiaries, provides regulated and compliance solutions to the healthcare, retail, and commercial businesses in the United States, Europe, and internationally. It operates through three segments: North America RWCS; International RWCS; and Domestic Communication and Related Services. It collects and processes regulated and specialized waste for disposal services; and collects personal and confidential information for secure destruction, recall/return, and communication services. The company's services also include medical waste disposal, pharmaceutical waste disposal, hazardous waste management, sustainability solutions for expired or unused inventory, secure information destruction of documents and e-media, and compliance services; and regulated recall and returns management communication, logistics, and data management services for expired, withdrawn, or recalled products. In addition, it offers compliance programs under the Steri-Safe, Clinical Services, First Practice Management, SeguriMed, and EnviroAssure brand names. The company serves healthcare businesses, including hospitals, physician and dental practices, outpatient clinics, long-term care facilities, etc.; retailers and manufacturers; financial and professional service providers; governmental entities; and other businesses. Stericycle, Inc. was founded in 1989 and is headquartered in Bannockburn, Illinois."
SRCL,2019-12-31,NA,-362800000,3800000,-346800000,768500000,1180800000,267100000,267100000,-118100000,-16800000,3308900000,3041800000,2128100000,-629900000,NA,-346000000,-346800000,NA,income_statement,Waste Management,"Stericycle, Inc.","Stericycle, Inc., together with its subsidiaries, provides regulated and compliance solutions to the healthcare, retail, and commercial businesses in the United States, Europe, and internationally. It operates through three segments: North America RWCS; International RWCS; and Domestic Communication and Related Services. It collects and processes regulated and specialized waste for disposal services; and collects personal and confidential information for secure destruction, recall/return, and communication services. The company's services also include medical waste disposal, pharmaceutical waste disposal, hazardous waste management, sustainability solutions for expired or unused inventory, secure information destruction of documents and e-media, and compliance services; and regulated recall and returns management communication, logistics, and data management services for expired, withdrawn, or recalled products. In addition, it offers compliance programs under the Steri-Safe, Clinical Services, First Practice Management, SeguriMed, and EnviroAssure brand names. The company serves healthcare businesses, including hospitals, physician and dental practices, outpatient clinics, long-term care facilities, etc.; retailers and manufacturers; financial and professional service providers; governmental entities; and other businesses. Stericycle, Inc. was founded in 1989 and is headquartered in Bannockburn, Illinois."
SRDX,2017-09-30,NA,7033000,NA,3926000,20378000,30173000,7376000,7376000,-152000,3107000,73112000,65736000,42939000,-343000,NA,3926000,3926000,NA,income_statement,Medical Devices,"Surmodics, Inc.","Surmodics, Inc., together with its subsidiaries, provides surface modification technologies for intravascular medical devices, and chemical components for in vitro diagnostic immunoassay tests and microarrays in the United States and internationally. The company operates through two segments, Medical Device and In Vitro Diagnostics. The Medical Device segment engages in the provision of surface modification coating technologies to enhance access, deliverability, and predictable deployment of medical devices; and drug-delivery coating technologies to provide site-specific drug-delivery from the surface of a medical device for coronary, peripheral, neuro-vascular and structural heart, and other markets, as well as design, development, and manufacturing of interventional medical devices, primarily balloons and catheters, including drug-coated balloons for peripheral arterial disease treatment and other applications. The Vitro Diagnostics segment designs, develops, and manufactures component products and technologies for diagnostic immunoassay, as well as molecular test and biomedical research applications. This segment offers protein stabilization reagents, substrates, surface coatings, and antigens. Surmodics, Inc. was founded in 1979 and is headquartered in Eden Prairie, Minnesota."
SRDX,2018-09-30,NA,-7532000,NA,-4457000,23111000,26366000,764000,764000,-152000,-3075000,81336000,80572000,54970000,-8296000,NA,-4457000,-4457000,NA,income_statement,Medical Devices,"Surmodics, Inc.","Surmodics, Inc., together with its subsidiaries, provides surface modification technologies for intravascular medical devices, and chemical components for in vitro diagnostic immunoassay tests and microarrays in the United States and internationally. The company operates through two segments, Medical Device and In Vitro Diagnostics. The Medical Device segment engages in the provision of surface modification coating technologies to enhance access, deliverability, and predictable deployment of medical devices; and drug-delivery coating technologies to provide site-specific drug-delivery from the surface of a medical device for coronary, peripheral, neuro-vascular and structural heart, and other markets, as well as design, development, and manufacturing of interventional medical devices, primarily balloons and catheters, including drug-coated balloons for peripheral arterial disease treatment and other applications. The Vitro Diagnostics segment designs, develops, and manufactures component products and technologies for diagnostic immunoassay, as well as molecular test and biomedical research applications. This segment offers protein stabilization reagents, substrates, surface coatings, and antigens. Surmodics, Inc. was founded in 1979 and is headquartered in Eden Prairie, Minnesota."
SRDX,2019-09-30,NA,7558000,NA,7592000,24550000,33812000,6857000,6857000,-152000,-34000,100077000,93220000,66265000,701000,NA,7592000,7592000,NA,income_statement,Medical Devices,"Surmodics, Inc.","Surmodics, Inc., together with its subsidiaries, provides surface modification technologies for intravascular medical devices, and chemical components for in vitro diagnostic immunoassay tests and microarrays in the United States and internationally. The company operates through two segments, Medical Device and In Vitro Diagnostics. The Medical Device segment engages in the provision of surface modification coating technologies to enhance access, deliverability, and predictable deployment of medical devices; and drug-delivery coating technologies to provide site-specific drug-delivery from the surface of a medical device for coronary, peripheral, neuro-vascular and structural heart, and other markets, as well as design, development, and manufacturing of interventional medical devices, primarily balloons and catheters, including drug-coated balloons for peripheral arterial disease treatment and other applications. The Vitro Diagnostics segment designs, develops, and manufactures component products and technologies for diagnostic immunoassay, as well as molecular test and biomedical research applications. This segment offers protein stabilization reagents, substrates, surface coatings, and antigens. Surmodics, Inc. was founded in 1979 and is headquartered in Eden Prairie, Minnesota."
SRDX,2020-09-30,NA,-1454000,NA,1123000,28392000,29359000,-1251000,-1251000,-133000,-2577000,94864000,96115000,65505000,-203000,NA,1123000,1123000,NA,income_statement,Medical Devices,"Surmodics, Inc.","Surmodics, Inc., together with its subsidiaries, provides surface modification technologies for intravascular medical devices, and chemical components for in vitro diagnostic immunoassay tests and microarrays in the United States and internationally. The company operates through two segments, Medical Device and In Vitro Diagnostics. The Medical Device segment engages in the provision of surface modification coating technologies to enhance access, deliverability, and predictable deployment of medical devices; and drug-delivery coating technologies to provide site-specific drug-delivery from the surface of a medical device for coronary, peripheral, neuro-vascular and structural heart, and other markets, as well as design, development, and manufacturing of interventional medical devices, primarily balloons and catheters, including drug-coated balloons for peripheral arterial disease treatment and other applications. The Vitro Diagnostics segment designs, develops, and manufactures component products and technologies for diagnostic immunoassay, as well as molecular test and biomedical research applications. This segment offers protein stabilization reagents, substrates, surface coatings, and antigens. Surmodics, Inc. was founded in 1979 and is headquartered in Eden Prairie, Minnesota."
SRE,2016-12-31,NA,1907000000,2290000000,1370000000,71000000,3009000000,1626000000,1626000000,-556000000,389000000,10183000000,8557000000,7174000000,281000000,-31000000,1518000000,1370000000,NA,income_statement,NA,NA,NA
SRE,2017-12-31,NA,1319000000,2470000000,256000000,127000000,3599000000,2036000000,2036000000,-623000000,938000000,9640000000,7604000000,6041000000,-717000000,-31000000,381000000,256000000,NA,income_statement,NA,NA,NA
SRE,2018-12-31,NA,888000000,2110000000,1049000000,157000000,3679000000,2031000000,2031000000,-887000000,-49000000,10102000000,8071000000,6423000000,-1143000000,188000000,937000000,924000000,NA,income_statement,NA,NA,NA
SRE,2019-12-31,NA,2313000000,1876000000,2197000000,132000000,4196000000,2495000000,2495000000,-1078000000,315000000,10829000000,8334000000,6633000000,-182000000,363000000,1998000000,2055000000,NA,income_statement,NA,NA,NA
SREV,2016-12-31,8344000,-28697000,NA,-32126000,93467000,87818000,-13993000,-13993000,-11030000,3429000,252887000,266880000,165069000,-14704000,NA,-32126000,-32126000,NA,income_statement,Software—Application,"ServiceSource International, In","ServiceSource International, Inc. operates as a digital customer journey experience company. The company provides digital solutions, including demand qualification, demand conversion, and account management; customer success solutions, such as onboarding, adoption, and renewals management; and channel management services. It also offers sales performance analysis, business case, pricing and contract structuring, data integration, implementation, launch, performance and execution, and client benchmarking and continuous improvement solutions. The company sells its solutions through sales organization worldwide. ServiceSource International, Inc. was founded in 2002 and is headquartered in Denver, Colorado."
SREV,2017-12-31,5729000,-31493000,NA,-29846000,86088000,75418000,-16399000,-16399000,-11683000,-1647000,239127000,255526000,163709000,-15094000,NA,-29846000,-29846000,NA,income_statement,Software—Application,"ServiceSource International, In","ServiceSource International, Inc. operates as a digital customer journey experience company. The company provides digital solutions, including demand qualification, demand conversion, and account management; customer success solutions, such as onboarding, adoption, and renewals management; and channel management services. It also offers sales performance analysis, business case, pricing and contract structuring, data integration, implementation, launch, performance and execution, and client benchmarking and continuous improvement solutions. The company sells its solutions through sales organization worldwide. ServiceSource International, Inc. was founded in 2002 and is headquartered in Denver, Colorado."
SREV,2018-12-31,6436000,-24435000,NA,-24885000,80638000,73647000,-13427000,-13427000,-7396000,450000,238340000,251767000,164693000,-11008000,NA,-24885000,-24885000,NA,income_statement,Software—Application,"ServiceSource International, In","ServiceSource International, Inc. operates as a digital customer journey experience company. The company provides digital solutions, including demand qualification, demand conversion, and account management; customer success solutions, such as onboarding, adoption, and renewals management; and channel management services. It also offers sales performance analysis, business case, pricing and contract structuring, data integration, implementation, launch, performance and execution, and client benchmarking and continuous improvement solutions. The company sells its solutions through sales organization worldwide. ServiceSource International, Inc. was founded in 2002 and is headquartered in Denver, Colorado."
SREV,2019-12-31,4848000,-18240000,NA,-18683000,73473000,62980000,-15341000,-15341000,-388000,443000,216135000,231476000,153155000,-2899000,NA,-18683000,-18683000,NA,income_statement,Software—Application,"ServiceSource International, In","ServiceSource International, Inc. operates as a digital customer journey experience company. The company provides digital solutions, including demand qualification, demand conversion, and account management; customer success solutions, such as onboarding, adoption, and renewals management; and channel management services. It also offers sales performance analysis, business case, pricing and contract structuring, data integration, implementation, launch, performance and execution, and client benchmarking and continuous improvement solutions. The company sells its solutions through sales organization worldwide. ServiceSource International, Inc. was founded in 2002 and is headquartered in Denver, Colorado."
SRGA,2016-12-31,16090000,-17460000,NA,-14399000,116125000,132349000,134000,134000,-1655000,-3061000,272865000,272731000,140516000,-17594000,NA,-14399000,-17907000,NA,income_statement,Medical Devices,"Surgalign Holdings, Inc.","Surgalign Holdings, Inc., a medical technology company, designs, develops, manufactures, and distributes biologic, metal, and synthetic implants worldwide. It offers coflex interlaminar stabilization device, an implant for the treatment of moderate to severe lumbar spinal stenosis in conjunction with decompression; SImmetry sacroiliac joint fusion system, which decreases in opioid use, pain, and disability; and Fortilink IBF system with TETRAfuse ?3D technology. The company's implants are used in the fields of orthopedic, spine, sports medicine, plastic surgery, trauma, and other surgical procedures to repair and promote the natural healing of human bone and other human tissues; and to enhance surgical outcomes. It markets its products through its direct distribution force and various OEM relationships to healthcare providers, hospitals, and other healthcare facilities, as well as through a network of independent distributors. The company was founded in 1997 and is headquartered in Deerfield, Illinois."
SRGA,2017-12-31,13315000,26255000,NA,6906000,115009000,143072000,14748000,14748000,-3180000,19349000,280349000,265601000,137277000,11507000,NA,6906000,3183000,NA,income_statement,Medical Devices,"Surgalign Holdings, Inc.","Surgalign Holdings, Inc., a medical technology company, designs, develops, manufactures, and distributes biologic, metal, and synthetic implants worldwide. It offers coflex interlaminar stabilization device, an implant for the treatment of moderate to severe lumbar spinal stenosis in conjunction with decompression; SImmetry sacroiliac joint fusion system, which decreases in opioid use, pain, and disability; and Fortilink IBF system with TETRAfuse ?3D technology. The company's implants are used in the fields of orthopedic, spine, sports medicine, plastic surgery, trauma, and other surgical procedures to repair and promote the natural healing of human bone and other human tissues; and to enhance surgical outcomes. It markets its products through its direct distribution force and various OEM relationships to healthcare providers, hospitals, and other healthcare facilities, as well as through a network of independent distributors. The company was founded in 1997 and is headquartered in Deerfield, Illinois."
SRGA,2018-12-31,14410000,-7391000,NA,-3123000,119724000,141260000,7126000,7126000,-2771000,-4268000,280362000,273236000,139102000,-14517000,NA,-3123000,-5243000,NA,income_statement,Medical Devices,"Surgalign Holdings, Inc.","Surgalign Holdings, Inc., a medical technology company, designs, develops, manufactures, and distributes biologic, metal, and synthetic implants worldwide. It offers coflex interlaminar stabilization device, an implant for the treatment of moderate to severe lumbar spinal stenosis in conjunction with decompression; SImmetry sacroiliac joint fusion system, which decreases in opioid use, pain, and disability; and Fortilink IBF system with TETRAfuse ?3D technology. The company's implants are used in the fields of orthopedic, spine, sports medicine, plastic surgery, trauma, and other surgical procedures to repair and promote the natural healing of human bone and other human tissues; and to enhance surgical outcomes. It markets its products through its direct distribution force and various OEM relationships to healthcare providers, hospitals, and other healthcare facilities, as well as through a network of independent distributors. The company was founded in 1997 and is headquartered in Deerfield, Illinois."
SRGA,2019-12-31,16836000,-194405000,NA,-211642000,157675000,174711000,200000,200000,-12571000,17237000,308384000,308184000,133673000,-194605000,NA,-211642000,-211642000,NA,income_statement,Medical Devices,"Surgalign Holdings, Inc.","Surgalign Holdings, Inc., a medical technology company, designs, develops, manufactures, and distributes biologic, metal, and synthetic implants worldwide. It offers coflex interlaminar stabilization device, an implant for the treatment of moderate to severe lumbar spinal stenosis in conjunction with decompression; SImmetry sacroiliac joint fusion system, which decreases in opioid use, pain, and disability; and Fortilink IBF system with TETRAfuse ?3D technology. The company's implants are used in the fields of orthopedic, spine, sports medicine, plastic surgery, trauma, and other surgical procedures to repair and promote the natural healing of human bone and other human tissues; and to enhance surgical outcomes. It markets its products through its direct distribution force and various OEM relationships to healthcare providers, hospitals, and other healthcare facilities, as well as through a network of independent distributors. The company was founded in 1997 and is headquartered in Deerfield, Illinois."
SRNE,2017-12-31,76963000,-24929000,7042000,9132000,38332000,92379000,51274000,51274000,-4980000,-36038000,151856000,100582000,59477000,-76203000,NA,11109000,9132000,NA,income_statement,Biotechnology,"Sorrento Therapeutics, Inc.","Sorrento Therapeutics, Inc., a clinical stage biopharma company, develops therapies for cancer, autoimmune, inflammatory, and neurodegenerative diseases. It operates through two segments, Sorrento Therapeutics and Scilex. The company provides cancer therapeutics by leveraging its proprietary G-MAB antibody library and targeted delivery modalities, which include chimeric antigen receptor T-cell therapy (CAR-T), dimeric antigen receptor T-cell therapy, and antibody drug conjugates, as well as bispecific antibody approaches. It also offers Sofusa, a drug delivery technology that delivers biologics directly into the lymphatic system. In addition, the company's clinical programs in development include anti-CD38 CAR-T therapy for the treatment of multiple myeloma, as well as for amyloidosis and graft-versus-host diseases. Further, it develops resiniferatoxin, a non-opioid-based TRPV1 agonist neurotoxin for late stage cancer and osteoarthritis knee pain treatment; and ZTlido, a lidocaine delivery system for the treatment of postherpetic neuralgia. Additionally, the company engages in the development of SEMDEXA, an injectable viscous gel formulation, which is Phase III trial for the treatment of sciatica, a pathology of low back pain; and SP-103, an investigational non-aqueous lidocaine topical system undergoing clinical development in chronic low back pain conditions. It has various collaborations with SmartPharm Therapeutics Inc. to develop gene-encoded antibody vaccine to protect against COVID-19; Celularity, Inc. for initiating Phase I/II clinical study, including up to 86 patients with COVID-19; and Mount Sinai Health System to develop COVI-SHIELD, an antibody therapy targeting SARS-CoV-2 infection, as well as a research testing agreement with The University of Texas Medical Branch at Galveston for the preclinical testing of Sorrento's COVID-19 therapeutic product candidates. The company was founded in 2006 and is based in San Diego, California."
SRNE,2018-12-31,76963000,-218800000,-1972000,-203540000,63638000,-62830000,-129477000,-129477000,-57631000,-6274000,21193000,150670000,84023000,-89323000,NA,-212526000,-203540000,NA,income_statement,Biotechnology,"Sorrento Therapeutics, Inc.","Sorrento Therapeutics, Inc., a clinical stage biopharma company, develops therapies for cancer, autoimmune, inflammatory, and neurodegenerative diseases. It operates through two segments, Sorrento Therapeutics and Scilex. The company provides cancer therapeutics by leveraging its proprietary G-MAB antibody library and targeted delivery modalities, which include chimeric antigen receptor T-cell therapy (CAR-T), dimeric antigen receptor T-cell therapy, and antibody drug conjugates, as well as bispecific antibody approaches. It also offers Sofusa, a drug delivery technology that delivers biologics directly into the lymphatic system. In addition, the company's clinical programs in development include anti-CD38 CAR-T therapy for the treatment of multiple myeloma, as well as for amyloidosis and graft-versus-host diseases. Further, it develops resiniferatoxin, a non-opioid-based TRPV1 agonist neurotoxin for late stage cancer and osteoarthritis knee pain treatment; and ZTlido, a lidocaine delivery system for the treatment of postherpetic neuralgia. Additionally, the company engages in the development of SEMDEXA, an injectable viscous gel formulation, which is Phase III trial for the treatment of sciatica, a pathology of low back pain; and SP-103, an investigational non-aqueous lidocaine topical system undergoing clinical development in chronic low back pain conditions. It has various collaborations with SmartPharm Therapeutics Inc. to develop gene-encoded antibody vaccine to protect against COVID-19; Celularity, Inc. for initiating Phase I/II clinical study, including up to 86 patients with COVID-19; and Mount Sinai Health System to develop COVI-SHIELD, an antibody therapy targeting SARS-CoV-2 infection, as well as a research testing agreement with The University of Texas Medical Branch at Galveston for the preclinical testing of Sorrento's COVID-19 therapeutic product candidates. The company was founded in 2006 and is based in San Diego, California."
SRNE,2019-12-31,111340000,-363485000,-45832000,-292068000,103557000,-87684000,-195182000,-195182000,-36139000,-473000,31432000,226614000,119116000,-168303000,NA,-363012000,-292068000,NA,income_statement,Biotechnology,"Sorrento Therapeutics, Inc.","Sorrento Therapeutics, Inc., a clinical stage biopharma company, develops therapies for cancer, autoimmune, inflammatory, and neurodegenerative diseases. It operates through two segments, Sorrento Therapeutics and Scilex. The company provides cancer therapeutics by leveraging its proprietary G-MAB antibody library and targeted delivery modalities, which include chimeric antigen receptor T-cell therapy (CAR-T), dimeric antigen receptor T-cell therapy, and antibody drug conjugates, as well as bispecific antibody approaches. It also offers Sofusa, a drug delivery technology that delivers biologics directly into the lymphatic system. In addition, the company's clinical programs in development include anti-CD38 CAR-T therapy for the treatment of multiple myeloma, as well as for amyloidosis and graft-versus-host diseases. Further, it develops resiniferatoxin, a non-opioid-based TRPV1 agonist neurotoxin for late stage cancer and osteoarthritis knee pain treatment; and ZTlido, a lidocaine delivery system for the treatment of postherpetic neuralgia. Additionally, the company engages in the development of SEMDEXA, an injectable viscous gel formulation, which is Phase III trial for the treatment of sciatica, a pathology of low back pain; and SP-103, an investigational non-aqueous lidocaine topical system undergoing clinical development in chronic low back pain conditions. It has various collaborations with SmartPharm Therapeutics Inc. to develop gene-encoded antibody vaccine to protect against COVID-19; Celularity, Inc. for initiating Phase I/II clinical study, including up to 86 patients with COVID-19; and Mount Sinai Health System to develop COVI-SHIELD, an antibody therapy targeting SARS-CoV-2 infection, as well as a research testing agreement with The University of Texas Medical Branch at Galveston for the preclinical testing of Sorrento's COVID-19 therapeutic product candidates. The company was founded in 2006 and is based in San Diego, California."
SRNE,2020-12-31,111340000,-316424000,-24420000,-298461000,116179000,30046000,-201526000,-201526000,-20181000,-2014000,39986000,241512000,9940000,-114898000,NA,-314410000,-298461000,NA,income_statement,Biotechnology,"Sorrento Therapeutics, Inc.","Sorrento Therapeutics, Inc., a clinical stage biopharma company, develops therapies for cancer, autoimmune, inflammatory, and neurodegenerative diseases. It operates through two segments, Sorrento Therapeutics and Scilex. The company provides cancer therapeutics by leveraging its proprietary G-MAB antibody library and targeted delivery modalities, which include chimeric antigen receptor T-cell therapy (CAR-T), dimeric antigen receptor T-cell therapy, and antibody drug conjugates, as well as bispecific antibody approaches. It also offers Sofusa, a drug delivery technology that delivers biologics directly into the lymphatic system. In addition, the company's clinical programs in development include anti-CD38 CAR-T therapy for the treatment of multiple myeloma, as well as for amyloidosis and graft-versus-host diseases. Further, it develops resiniferatoxin, a non-opioid-based TRPV1 agonist neurotoxin for late stage cancer and osteoarthritis knee pain treatment; and ZTlido, a lidocaine delivery system for the treatment of postherpetic neuralgia. Additionally, the company engages in the development of SEMDEXA, an injectable viscous gel formulation, which is Phase III trial for the treatment of sciatica, a pathology of low back pain; and SP-103, an investigational non-aqueous lidocaine topical system undergoing clinical development in chronic low back pain conditions. It has various collaborations with SmartPharm Therapeutics Inc. to develop gene-encoded antibody vaccine to protect against COVID-19; Celularity, Inc. for initiating Phase I/II clinical study, including up to 86 patients with COVID-19; and Mount Sinai Health System to develop COVI-SHIELD, an antibody therapy targeting SARS-CoV-2 infection, as well as a research testing agreement with The University of Texas Medical Branch at Galveston for the preclinical testing of Sorrento's COVID-19 therapeutic product candidates. The company was founded in 2006 and is based in San Diego, California."
SRPT,2016-12-31,166107000,-267265000,NA,-267265000,81200000,-180639000,-261868000,-261868000,-1892000,0,5421000,267289000,186060000,-5397000,NA,-267265000,-267265000,NA,income_statement,Biotechnology,"Sarepta Therapeutics, Inc.","Sarepta Therapeutics, Inc., a commercial-stage biopharmaceutical company, focuses on the discovery and development of RNA-targeted therapeutics, gene therapy, and other genetic therapeutic modalities approaches for the treatment of rare diseases. The company offers EXONDYS 51 injection to treat duchenne muscular dystrophy (DMD) in patients who have a confirmed mutation of the DMD gene that is amenable to exon 51 skipping; and VYONDYS 53 for the treatment of DMD in patients who have a confirmed mutation of the DMD gene that is amenable to exon 53 skipping. It also developing Casimersen, a product candidate that uses phosphorodiamidate morpholino oligomer (PMO) chemistry and exon-skipping technology to skip exon 45 of the DMD gene; SRP-5051, a peptide conjugated PMO that binds exon 51 of dystrophin pre-mRNA; SRP-9001, a DMD micro-dystrophin gene therapy program; SRP-9003, a limb-girdle muscular dystrophies gene therapy program; and LYS-SAF 302 to treat mucopolysaccharidosis type IIIA. The company has collaboration agreements with F. Hoffman-La Roche Ltd; Nationwide Children's Hospital; Lysogene; Duke University; Genethon; StrideBio; the United States Army Medical Research Institute of Infectious Diseases; the Department of Defense's lead laboratory; the Dyno Therapeutics, Inc; and Personalis, Inc. It also has a research and option agreement with Codiak BioSciences, Inc. to design and develop engineered exosome therapeutics to deliver gene therapy, gene editing, and RNA technologies for neuromuscular diseases; and research collaboration with Genevant Sciences for lipid nanoparticle-based gene editing therapeutics. Sarepta Therapeutics, Inc. was founded in 1980 and is headquartered in Cambridge, Massachusetts."
SRPT,2017-12-31,166107000,-48628000,NA,-50688000,122682000,147231000,-142611000,-142611000,-5801000,2060000,154584000,297195000,7353000,93983000,NA,-50688000,-50688000,NA,income_statement,Biotechnology,"Sarepta Therapeutics, Inc.","Sarepta Therapeutics, Inc., a commercial-stage biopharmaceutical company, focuses on the discovery and development of RNA-targeted therapeutics, gene therapy, and other genetic therapeutic modalities approaches for the treatment of rare diseases. The company offers EXONDYS 51 injection to treat duchenne muscular dystrophy (DMD) in patients who have a confirmed mutation of the DMD gene that is amenable to exon 51 skipping; and VYONDYS 53 for the treatment of DMD in patients who have a confirmed mutation of the DMD gene that is amenable to exon 53 skipping. It also developing Casimersen, a product candidate that uses phosphorodiamidate morpholino oligomer (PMO) chemistry and exon-skipping technology to skip exon 45 of the DMD gene; SRP-5051, a peptide conjugated PMO that binds exon 51 of dystrophin pre-mRNA; SRP-9001, a DMD micro-dystrophin gene therapy program; SRP-9003, a limb-girdle muscular dystrophies gene therapy program; and LYS-SAF 302 to treat mucopolysaccharidosis type IIIA. The company has collaboration agreements with F. Hoffman-La Roche Ltd; Nationwide Children's Hospital; Lysogene; Duke University; Genethon; StrideBio; the United States Army Medical Research Institute of Infectious Diseases; the Department of Defense's lead laboratory; the Dyno Therapeutics, Inc; and Personalis, Inc. It also has a research and option agreement with Codiak BioSciences, Inc. to design and develop engineered exosome therapeutics to deliver gene therapy, gene editing, and RNA technologies for neuromuscular diseases; and research collaboration with Genevant Sciences for lipid nanoparticle-based gene editing therapeutics. Sarepta Therapeutics, Inc. was founded in 1980 and is headquartered in Cambridge, Massachusetts."
SRPT,2018-12-31,NA,-362610000,NA,-361918000,209983000,-131102000,-341950000,-341950000,-33709000,-692000,301034000,642984000,432136000,-20660000,NA,-361918000,-361918000,NA,income_statement,Biotechnology,"Sarepta Therapeutics, Inc.","Sarepta Therapeutics, Inc., a commercial-stage biopharmaceutical company, focuses on the discovery and development of RNA-targeted therapeutics, gene therapy, and other genetic therapeutic modalities approaches for the treatment of rare diseases. The company offers EXONDYS 51 injection to treat duchenne muscular dystrophy (DMD) in patients who have a confirmed mutation of the DMD gene that is amenable to exon 51 skipping; and VYONDYS 53 for the treatment of DMD in patients who have a confirmed mutation of the DMD gene that is amenable to exon 53 skipping. It also developing Casimersen, a product candidate that uses phosphorodiamidate morpholino oligomer (PMO) chemistry and exon-skipping technology to skip exon 45 of the DMD gene; SRP-5051, a peptide conjugated PMO that binds exon 51 of dystrophin pre-mRNA; SRP-9001, a DMD micro-dystrophin gene therapy program; SRP-9003, a limb-girdle muscular dystrophies gene therapy program; and LYS-SAF 302 to treat mucopolysaccharidosis type IIIA. The company has collaboration agreements with F. Hoffman-La Roche Ltd; Nationwide Children's Hospital; Lysogene; Duke University; Genethon; StrideBio; the United States Army Medical Research Institute of Infectious Diseases; the Department of Defense's lead laboratory; the Dyno Therapeutics, Inc; and Personalis, Inc. It also has a research and option agreement with Codiak BioSciences, Inc. to design and develop engineered exosome therapeutics to deliver gene therapy, gene editing, and RNA technologies for neuromuscular diseases; and research collaboration with Genevant Sciences for lipid nanoparticle-based gene editing therapeutics. Sarepta Therapeutics, Inc. was founded in 1980 and is headquartered in Cambridge, Massachusetts."
SRPT,2019-12-31,NA,-713880000,NA,-715075000,284812000,-236462000,-522123000,-522123000,-30669000,1195000,380833000,902956000,617295000,-191757000,NA,-715075000,-715075000,NA,income_statement,Biotechnology,"Sarepta Therapeutics, Inc.","Sarepta Therapeutics, Inc., a commercial-stage biopharmaceutical company, focuses on the discovery and development of RNA-targeted therapeutics, gene therapy, and other genetic therapeutic modalities approaches for the treatment of rare diseases. The company offers EXONDYS 51 injection to treat duchenne muscular dystrophy (DMD) in patients who have a confirmed mutation of the DMD gene that is amenable to exon 51 skipping; and VYONDYS 53 for the treatment of DMD in patients who have a confirmed mutation of the DMD gene that is amenable to exon 53 skipping. It also developing Casimersen, a product candidate that uses phosphorodiamidate morpholino oligomer (PMO) chemistry and exon-skipping technology to skip exon 45 of the DMD gene; SRP-5051, a peptide conjugated PMO that binds exon 51 of dystrophin pre-mRNA; SRP-9001, a DMD micro-dystrophin gene therapy program; SRP-9003, a limb-girdle muscular dystrophies gene therapy program; and LYS-SAF 302 to treat mucopolysaccharidosis type IIIA. The company has collaboration agreements with F. Hoffman-La Roche Ltd; Nationwide Children's Hospital; Lysogene; Duke University; Genethon; StrideBio; the United States Army Medical Research Institute of Infectious Diseases; the Department of Defense's lead laboratory; the Dyno Therapeutics, Inc; and Personalis, Inc. It also has a research and option agreement with Codiak BioSciences, Inc. to design and develop engineered exosome therapeutics to deliver gene therapy, gene editing, and RNA technologies for neuromuscular diseases; and research collaboration with Genevant Sciences for lipid nanoparticle-based gene editing therapeutics. Sarepta Therapeutics, Inc. was founded in 1980 and is headquartered in Cambridge, Massachusetts."
SRRA,2016-12-31,31646000,-47724000,NA,-47867000,13713000,0,-45359000,-45359000,-200000,143000,0,45359000,0,-2365000,NA,-47867000,-47867000,NA,income_statement,Biotechnology,"Sierra Oncology, Inc.","Sierra Oncology, Inc. researches, develops, and commercializes therapies for the treatment of patients with hematology and oncology needs. Its lead drug candidate, momelotinib, is a selective and orally-bioavailable JAK1, JAK2, and ACVR1 inhibitor that has been investigated in two completed Phase 3 trials for the treatment of myelofibrosis. The company is also advancing SRA737, an orally bioavailable small molecule inhibitor Checkpoint kinase 1 is being investigated in two Phase 1/2 clinical trials; and SRA141, an orally bioavailable small molecule inhibitor of cell division cycle 7 kinase. The company was formerly known as ProNAi Therapeutics, Inc. and changed its name to Sierra Oncology, Inc. in January 2017. Sierra Oncology, Inc. was founded in 2003 and is headquartered in Vancouver, Canada."
SRRA,2017-12-31,30157000,-41859000,NA,-42015000,12462000,0,-42619000,-42619000,-200000,156000,0,42619000,0,760000,NA,-42015000,-42015000,NA,income_statement,Biotechnology,"Sierra Oncology, Inc.","Sierra Oncology, Inc. researches, develops, and commercializes therapies for the treatment of patients with hematology and oncology needs. Its lead drug candidate, momelotinib, is a selective and orally-bioavailable JAK1, JAK2, and ACVR1 inhibitor that has been investigated in two completed Phase 3 trials for the treatment of myelofibrosis. The company is also advancing SRA737, an orally bioavailable small molecule inhibitor Checkpoint kinase 1 is being investigated in two Phase 1/2 clinical trials; and SRA141, an orally bioavailable small molecule inhibitor of cell division cycle 7 kinase. The company was formerly known as ProNAi Therapeutics, Inc. and changed its name to Sierra Oncology, Inc. in January 2017. Sierra Oncology, Inc. was founded in 2003 and is headquartered in Vancouver, Canada."
SRRA,2018-12-31,41078000,-53637000,NA,-53335000,14339000,0,-55417000,-55417000,-200000,-302000,0,55417000,0,1780000,NA,-53335000,-53335000,NA,income_statement,Biotechnology,"Sierra Oncology, Inc.","Sierra Oncology, Inc. researches, develops, and commercializes therapies for the treatment of patients with hematology and oncology needs. Its lead drug candidate, momelotinib, is a selective and orally-bioavailable JAK1, JAK2, and ACVR1 inhibitor that has been investigated in two completed Phase 3 trials for the treatment of myelofibrosis. The company is also advancing SRA737, an orally bioavailable small molecule inhibitor Checkpoint kinase 1 is being investigated in two Phase 1/2 clinical trials; and SRA141, an orally bioavailable small molecule inhibitor of cell division cycle 7 kinase. The company was formerly known as ProNAi Therapeutics, Inc. and changed its name to Sierra Oncology, Inc. in January 2017. Sierra Oncology, Inc. was founded in 2003 and is headquartered in Vancouver, Canada."
SRRA,2019-12-31,53249000,-88435000,NA,-88275000,13743000,0,-66992000,-66992000,-900000,-160000,0,66992000,0,-21443000,NA,-88275000,-88275000,NA,income_statement,Biotechnology,"Sierra Oncology, Inc.","Sierra Oncology, Inc. researches, develops, and commercializes therapies for the treatment of patients with hematology and oncology needs. Its lead drug candidate, momelotinib, is a selective and orally-bioavailable JAK1, JAK2, and ACVR1 inhibitor that has been investigated in two completed Phase 3 trials for the treatment of myelofibrosis. The company is also advancing SRA737, an orally bioavailable small molecule inhibitor Checkpoint kinase 1 is being investigated in two Phase 1/2 clinical trials; and SRA141, an orally bioavailable small molecule inhibitor of cell division cycle 7 kinase. The company was formerly known as ProNAi Therapeutics, Inc. and changed its name to Sierra Oncology, Inc. in January 2017. Sierra Oncology, Inc. was founded in 2003 and is headquartered in Vancouver, Canada."
SRRK,2016-12-31,NA,-16207000,NA,-16207000,4112000,-12098000,-16210000,-16210000,-42000,0,379000,16589000,12477000,3000,NA,-16207000,-16207000,NA,income_statement,Biotechnology,Scholar Rock Holding Corporatio,"Scholar Rock Holding Corporation, a clinical-stage biopharmaceutical company, focuses on the discovery and development of medicines for the treatment of serious diseases in which signaling by protein growth factors plays a fundamental role. Its lead antibody product candidate is SRK-015, a novel inhibitor of the activation of myostatin, which is in Phase II clinical trials for the treatment of spinal muscular atrophy. The company is also developing SRK-181, which is in Phase I clinical trials for the treatment of cancers that are resistant to checkpoint inhibitor therapies, such as anti-PD-1 or anti-PD-L1. In addition, it is developing a pipeline of novel product candidates for a range of serious diseases, including neuromuscular disorders, cancer, fibrosis, and anemia. The company has a collaboration agreement with Gilead Sciences, Inc. to discover and develop specific inhibitors of transforming growth factor beta activation for the treatment of fibrotic diseases. Scholar Rock Holding Corporation was founded in 2012 and is headquartered in Cambridge, Massachusetts."
SRRK,2017-12-31,NA,-24995000,NA,-24995000,5085000,-19944000,-25029000,-25029000,NA,0,0,25029000,19944000,34000,NA,-24995000,-24995000,NA,income_statement,Biotechnology,Scholar Rock Holding Corporatio,"Scholar Rock Holding Corporation, a clinical-stage biopharmaceutical company, focuses on the discovery and development of medicines for the treatment of serious diseases in which signaling by protein growth factors plays a fundamental role. Its lead antibody product candidate is SRK-015, a novel inhibitor of the activation of myostatin, which is in Phase II clinical trials for the treatment of spinal muscular atrophy. The company is also developing SRK-181, which is in Phase I clinical trials for the treatment of cancers that are resistant to checkpoint inhibitor therapies, such as anti-PD-1 or anti-PD-L1. In addition, it is developing a pipeline of novel product candidates for a range of serious diseases, including neuromuscular disorders, cancer, fibrosis, and anemia. The company has a collaboration agreement with Gilead Sciences, Inc. to discover and develop specific inhibitors of transforming growth factor beta activation for the treatment of fibrotic diseases. Scholar Rock Holding Corporation was founded in 2012 and is headquartered in Cambridge, Massachusetts."
SRRK,2018-12-31,NA,-49326000,NA,-49326000,14382000,-36310000,-50692000,-50692000,NA,0,0,50692000,36310000,1366000,NA,-49326000,-49326000,NA,income_statement,Biotechnology,Scholar Rock Holding Corporatio,"Scholar Rock Holding Corporation, a clinical-stage biopharmaceutical company, focuses on the discovery and development of medicines for the treatment of serious diseases in which signaling by protein growth factors plays a fundamental role. Its lead antibody product candidate is SRK-015, a novel inhibitor of the activation of myostatin, which is in Phase II clinical trials for the treatment of spinal muscular atrophy. The company is also developing SRK-181, which is in Phase I clinical trials for the treatment of cancers that are resistant to checkpoint inhibitor therapies, such as anti-PD-1 or anti-PD-L1. In addition, it is developing a pipeline of novel product candidates for a range of serious diseases, including neuromuscular disorders, cancer, fibrosis, and anemia. The company has a collaboration agreement with Gilead Sciences, Inc. to discover and develop specific inhibitors of transforming growth factor beta activation for the treatment of fibrotic diseases. Scholar Rock Holding Corporation was founded in 2012 and is headquartered in Cambridge, Massachusetts."
SRRK,2019-12-31,NA,-51000000,NA,-51000000,20817000,-33725000,-54542000,-54542000,NA,0,20492000,75034000,54217000,3542000,NA,-51000000,-51000000,NA,income_statement,Biotechnology,Scholar Rock Holding Corporatio,"Scholar Rock Holding Corporation, a clinical-stage biopharmaceutical company, focuses on the discovery and development of medicines for the treatment of serious diseases in which signaling by protein growth factors plays a fundamental role. Its lead antibody product candidate is SRK-015, a novel inhibitor of the activation of myostatin, which is in Phase II clinical trials for the treatment of spinal muscular atrophy. The company is also developing SRK-181, which is in Phase I clinical trials for the treatment of cancers that are resistant to checkpoint inhibitor therapies, such as anti-PD-1 or anti-PD-L1. In addition, it is developing a pipeline of novel product candidates for a range of serious diseases, including neuromuscular disorders, cancer, fibrosis, and anemia. The company has a collaboration agreement with Gilead Sciences, Inc. to discover and develop specific inhibitors of transforming growth factor beta activation for the treatment of fibrotic diseases. Scholar Rock Holding Corporation was founded in 2012 and is headquartered in Cambridge, Massachusetts."
SRTS,2016-12-31,1824150,-346448,NA,-346448,8384772,9845803,-363119,-363119,-21867,0,14811175,15174294,4965372,16671,NA,-346448,-346448,NA,income_statement,Medical Devices,"Sensus Healthcare, Inc.","Sensus Healthcare, Inc. manufactures, distributes, and markets superficial radiation therapy devices to healthcare providers worldwide. It offers SRT-100, a photon X-ray low energy superficial radiotherapy system that provides patients an alternative to surgery for treating non-melanoma skin cancers; and SRT-100 Vision, which provides the user with a superficial radiation therapy-tailored treatment planning application that integrates the embedded high frequency ultrasound imaging module, volumetric tumor analysis, beam margins planning, and dosimetry parameters. The company also provides SRT-100 Plus; Sculptura product, a proprietary robotic intraoperative radiation therapy system that uses patented Beam Sculpting capabilities to treat various cancers during surgery; and Sentinel service program, which offers its customers protection for their systems. In addition, it sells disposable lead shielding replacements; and disposable radiation safety items, such as aprons, eye shields, and disposable applicator tips, which are used to treat various sized lesions and various areas of the body. Sensus Healthcare, Inc. was founded in 2010 and is headquartered in Boca Raton, Florida."
SRTS,2017-12-31,5490489,-3710514,NA,-3710514,12026942,13799991,-3717440,-3717440,-68881,0,20587827,24305267,6787836,6926,NA,-3710514,-3710514,NA,income_statement,Medical Devices,"Sensus Healthcare, Inc.","Sensus Healthcare, Inc. manufactures, distributes, and markets superficial radiation therapy devices to healthcare providers worldwide. It offers SRT-100, a photon X-ray low energy superficial radiotherapy system that provides patients an alternative to surgery for treating non-melanoma skin cancers; and SRT-100 Vision, which provides the user with a superficial radiation therapy-tailored treatment planning application that integrates the embedded high frequency ultrasound imaging module, volumetric tumor analysis, beam margins planning, and dosimetry parameters. The company also provides SRT-100 Plus; Sculptura product, a proprietary robotic intraoperative radiation therapy system that uses patented Beam Sculpting capabilities to treat various cancers during surgery; and Sentinel service program, which offers its customers protection for their systems. In addition, it sells disposable lead shielding replacements; and disposable radiation safety items, such as aprons, eye shields, and disposable applicator tips, which are used to treat various sized lesions and various areas of the body. Sensus Healthcare, Inc. was founded in 2010 and is headquartered in Boca Raton, Florida."
SRTS,2018-12-31,6260406,-2022761,NA,-2022761,12655836,16910888,-2005354,-2005354,-156685,0,26427190,28432544,9516302,-17407,NA,-2022761,-2022761,NA,income_statement,Medical Devices,"Sensus Healthcare, Inc.","Sensus Healthcare, Inc. manufactures, distributes, and markets superficial radiation therapy devices to healthcare providers worldwide. It offers SRT-100, a photon X-ray low energy superficial radiotherapy system that provides patients an alternative to surgery for treating non-melanoma skin cancers; and SRT-100 Vision, which provides the user with a superficial radiation therapy-tailored treatment planning application that integrates the embedded high frequency ultrasound imaging module, volumetric tumor analysis, beam margins planning, and dosimetry parameters. The company also provides SRT-100 Plus; Sculptura product, a proprietary robotic intraoperative radiation therapy system that uses patented Beam Sculpting capabilities to treat various cancers during surgery; and Sentinel service program, which offers its customers protection for their systems. In addition, it sells disposable lead shielding replacements; and disposable radiation safety items, such as aprons, eye shields, and disposable applicator tips, which are used to treat various sized lesions and various areas of the body. Sensus Healthcare, Inc. was founded in 2010 and is headquartered in Boca Raton, Florida."
SRTS,2019-12-31,6417619,-1700003,NA,-1700003,13107818,17557144,-1968293,-1968293,NA,0,27263248,29231541,9706104,268290,NA,-1700003,-1700003,NA,income_statement,Medical Devices,"Sensus Healthcare, Inc.","Sensus Healthcare, Inc. manufactures, distributes, and markets superficial radiation therapy devices to healthcare providers worldwide. It offers SRT-100, a photon X-ray low energy superficial radiotherapy system that provides patients an alternative to surgery for treating non-melanoma skin cancers; and SRT-100 Vision, which provides the user with a superficial radiation therapy-tailored treatment planning application that integrates the embedded high frequency ultrasound imaging module, volumetric tumor analysis, beam margins planning, and dosimetry parameters. The company also provides SRT-100 Plus; Sculptura product, a proprietary robotic intraoperative radiation therapy system that uses patented Beam Sculpting capabilities to treat various cancers during surgery; and Sentinel service program, which offers its customers protection for their systems. In addition, it sells disposable lead shielding replacements; and disposable radiation safety items, such as aprons, eye shields, and disposable applicator tips, which are used to treat various sized lesions and various areas of the body. Sensus Healthcare, Inc. was founded in 2010 and is headquartered in Boca Raton, Florida."
SSB,2017-12-31,NA,168805000,NA,87554000,276919000,537125000,0,234306000,NA,81251000,537125000,302819000,0,-65501000,NA,87554000,87554000,25900000,income_statement,Banks—Regional,South State Corporation,"South State Corporation operates as the bank holding company for South State Bank that provides a range of retail and commercial banking services, mortgage lending services, and trust and wealth management services. The company accepts demand deposits, savings deposits, interest-bearing transaction accounts, checking accounts, money market accounts, certificates of deposit, and other time deposits. It also offers commercial real estate loans, residential real estate loans, commercial and industrial loans, and other consumer loans; lending and credit card services; and automated teller machines processing services. In addition, the company provides treasury management services, merchant services, debit card products, automated clearing house services, lock-box services, remote deposit capture services, and other treasury services. As of December 31, 2019, it served customers through 155 financial centers in 29 South Carolina counties, nine North Carolina counties, 17 Georgia counties, and four Virginia counties. The company was formerly known as First Financial Holdings, Inc. and changed its name to South State Corporation in July 2013. South State Corporation was founded in 1933 and is headquartered in Columbia, South Carolina."
SSB,2018-12-31,NA,224255000,NA,178871000,335560000,645182000,0,280247000,NA,45384000,645182000,364935000,0,-55992000,NA,178871000,178871000,29375000,income_statement,Banks—Regional,South State Corporation,"South State Corporation operates as the bank holding company for South State Bank that provides a range of retail and commercial banking services, mortgage lending services, and trust and wealth management services. The company accepts demand deposits, savings deposits, interest-bearing transaction accounts, checking accounts, money market accounts, certificates of deposit, and other time deposits. It also offers commercial real estate loans, residential real estate loans, commercial and industrial loans, and other consumer loans; lending and credit card services; and automated teller machines processing services. In addition, the company provides treasury management services, merchant services, debit card products, automated clearing house services, lock-box services, remote deposit capture services, and other treasury services. As of December 31, 2019, it served customers through 155 financial centers in 29 South Carolina counties, nine North Carolina counties, 17 Georgia counties, and four Virginia counties. The company was formerly known as First Financial Holdings, Inc. and changed its name to South State Corporation in July 2013. South State Corporation was founded in 1933 and is headquartered in Columbia, South Carolina."
SSB,2019-12-31,NA,230425000,NA,186483000,338196000,635063000,0,265374000,NA,43942000,635063000,369689000,0,-34949000,NA,186483000,186483000,31493000,income_statement,Banks—Regional,South State Corporation,"South State Corporation operates as the bank holding company for South State Bank that provides a range of retail and commercial banking services, mortgage lending services, and trust and wealth management services. The company accepts demand deposits, savings deposits, interest-bearing transaction accounts, checking accounts, money market accounts, certificates of deposit, and other time deposits. It also offers commercial real estate loans, residential real estate loans, commercial and industrial loans, and other consumer loans; lending and credit card services; and automated teller machines processing services. In addition, the company provides treasury management services, merchant services, debit card products, automated clearing house services, lock-box services, remote deposit capture services, and other treasury services. As of December 31, 2019, it served customers through 155 financial centers in 29 South Carolina counties, nine North Carolina counties, 17 Georgia counties, and four Virginia counties. The company was formerly known as First Financial Holdings, Inc. and changed its name to South State Corporation in July 2013. South State Corporation was founded in 1933 and is headquartered in Columbia, South Carolina."
SSB,2020-12-31,NA,103972000,NA,120632000,75587000,901616000,0,190133000,NA,-16660000,901616000,711483000,0,-86161000,NA,120632000,120632000,635896000,income_statement,Banks—Regional,South State Corporation,"South State Corporation operates as the bank holding company for South State Bank that provides a range of retail and commercial banking services, mortgage lending services, and trust and wealth management services. The company accepts demand deposits, savings deposits, interest-bearing transaction accounts, checking accounts, money market accounts, certificates of deposit, and other time deposits. It also offers commercial real estate loans, residential real estate loans, commercial and industrial loans, and other consumer loans; lending and credit card services; and automated teller machines processing services. In addition, the company provides treasury management services, merchant services, debit card products, automated clearing house services, lock-box services, remote deposit capture services, and other treasury services. As of December 31, 2019, it served customers through 155 financial centers in 29 South Carolina counties, nine North Carolina counties, 17 Georgia counties, and four Virginia counties. The company was formerly known as First Financial Holdings, Inc. and changed its name to South State Corporation in July 2013. South State Corporation was founded in 1933 and is headquartered in Columbia, South Carolina."
SSBI,2017-12-31,NA,5922000,NA,3292000,10119000,19767000,0,5922000,NA,2630000,19767000,13845000,0,0,NA,3292000,3292000,3726000,income_statement,Banks—Regional,Summit State Bank,"Summit State Bank provides various banking products and services to individuals and businesses primarily in Sonoma County, California. It offers personal and business checking, money market, sweep, savings, and demand accounts; time certificates of deposit; and specialized deposit accounts, such as professional, small business packaged, tiered, individual retirement, and other retirement plan accounts. The company also provides loans, including commercial loans and leases; lines of credit; commercial real estate, small business administration, residential mortgage, and construction loans; and home equity lines of credit, as well as term loans, credit lines to individuals, equipment loans, and business lines of credit. Its loan products also comprise loans for accounts receivable and inventory financing, loans to agriculture-related businesses, and equipment and expansion financing programs. In addition, the company provides Internet and telephone banking; and other services, such as banking by appointment, online banking, direct payroll and social security deposits, letters of credit, access to national automated teller machine networks, courier, safe deposit boxes, night depository facilities, notary, travelers checks, lockbox, and banking by mail. Further, it offers cash management and electronic bill payment services. The company operates through five depository offices located in Santa Rosa, Rohnert Park, Healdsburg, and Petaluma, as well as loan production offices in Roseville, California and Scottsdale, Arizona. Summit State Bank was founded in 1982 and is headquartered in Santa Rosa, California."
SSBI,2018-12-31,NA,8044000,NA,5827000,11495000,23401000,0,8044000,NA,2217000,23401000,15357000,0,0,NA,5827000,5827000,3862000,income_statement,Banks—Regional,Summit State Bank,"Summit State Bank provides various banking products and services to individuals and businesses primarily in Sonoma County, California. It offers personal and business checking, money market, sweep, savings, and demand accounts; time certificates of deposit; and specialized deposit accounts, such as professional, small business packaged, tiered, individual retirement, and other retirement plan accounts. The company also provides loans, including commercial loans and leases; lines of credit; commercial real estate, small business administration, residential mortgage, and construction loans; and home equity lines of credit, as well as term loans, credit lines to individuals, equipment loans, and business lines of credit. Its loan products also comprise loans for accounts receivable and inventory financing, loans to agriculture-related businesses, and equipment and expansion financing programs. In addition, the company provides Internet and telephone banking; and other services, such as banking by appointment, online banking, direct payroll and social security deposits, letters of credit, access to national automated teller machine networks, courier, safe deposit boxes, night depository facilities, notary, travelers checks, lockbox, and banking by mail. Further, it offers cash management and electronic bill payment services. The company operates through five depository offices located in Santa Rosa, Rohnert Park, Healdsburg, and Petaluma, as well as loan production offices in Roseville, California and Scottsdale, Arizona. Summit State Bank was founded in 1982 and is headquartered in Santa Rosa, California."
SSBI,2019-12-31,NA,8875000,NA,6477000,12178000,24938000,0,8875000,NA,2398000,24938000,16063000,0,0,NA,6477000,6477000,3885000,income_statement,Banks—Regional,Summit State Bank,"Summit State Bank provides various banking products and services to individuals and businesses primarily in Sonoma County, California. It offers personal and business checking, money market, sweep, savings, and demand accounts; time certificates of deposit; and specialized deposit accounts, such as professional, small business packaged, tiered, individual retirement, and other retirement plan accounts. The company also provides loans, including commercial loans and leases; lines of credit; commercial real estate, small business administration, residential mortgage, and construction loans; and home equity lines of credit, as well as term loans, credit lines to individuals, equipment loans, and business lines of credit. Its loan products also comprise loans for accounts receivable and inventory financing, loans to agriculture-related businesses, and equipment and expansion financing programs. In addition, the company provides Internet and telephone banking; and other services, such as banking by appointment, online banking, direct payroll and social security deposits, letters of credit, access to national automated teller machine networks, courier, safe deposit boxes, night depository facilities, notary, travelers checks, lockbox, and banking by mail. Further, it offers cash management and electronic bill payment services. The company operates through five depository offices located in Santa Rosa, Rohnert Park, Healdsburg, and Petaluma, as well as loan production offices in Roseville, California and Scottsdale, Arizona. Summit State Bank was founded in 1982 and is headquartered in Santa Rosa, California."
SSBI,2020-12-31,NA,14939000,NA,10518000,12353000,32608000,0,14939000,NA,4421000,32608000,17669000,0,0,NA,10518000,10518000,5316000,income_statement,Banks—Regional,Summit State Bank,"Summit State Bank provides various banking products and services to individuals and businesses primarily in Sonoma County, California. It offers personal and business checking, money market, sweep, savings, and demand accounts; time certificates of deposit; and specialized deposit accounts, such as professional, small business packaged, tiered, individual retirement, and other retirement plan accounts. The company also provides loans, including commercial loans and leases; lines of credit; commercial real estate, small business administration, residential mortgage, and construction loans; and home equity lines of credit, as well as term loans, credit lines to individuals, equipment loans, and business lines of credit. Its loan products also comprise loans for accounts receivable and inventory financing, loans to agriculture-related businesses, and equipment and expansion financing programs. In addition, the company provides Internet and telephone banking; and other services, such as banking by appointment, online banking, direct payroll and social security deposits, letters of credit, access to national automated teller machine networks, courier, safe deposit boxes, night depository facilities, notary, travelers checks, lockbox, and banking by mail. Further, it offers cash management and electronic bill payment services. The company operates through five depository offices located in Santa Rosa, Rohnert Park, Healdsburg, and Petaluma, as well as loan production offices in Roseville, California and Scottsdale, Arizona. Summit State Bank was founded in 1982 and is headquartered in Santa Rosa, California."
SSKN,2016-12-31,1929000,-3080000,NA,-3335000,19739000,18071000,-3597000,-3597000,-4900000,255000,30707000,34304000,12636000,517000,NA,-3335000,-3335000,NA,income_statement,Medical Devices,"Strata Skin Sciences, Inc.","STRATA Skin Sciences, Inc., a medical technology company, develops, commercializes, and markets products for the treatment of dermatologic conditions in the United States and Asia. The company operates in two segments, Dermatology Recurring Procedures and Dermatology Procedures Equipment. Its products include XTRAC excimer laser and VTRAC lamp systems that are used for the treatment of skin disorders, such as psoriasis, vitiligo, atopic dermatitis, and eczema, among others. The company distributes its products internationally through distributors, and domestically directly to physicians. STRATA Skin Sciences, Inc. was founded in 1989 and is based in Horsham, Pennsylvania."
SSKN,2017-12-31,1711000,-21385000,NA,-21514000,18853000,18984000,-1580000,-1580000,-3196000,129000,31763000,33343000,12779000,-19805000,NA,-21514000,-21514000,NA,income_statement,Medical Devices,"Strata Skin Sciences, Inc.","STRATA Skin Sciences, Inc., a medical technology company, develops, commercializes, and markets products for the treatment of dermatologic conditions in the United States and Asia. The company operates in two segments, Dermatology Recurring Procedures and Dermatology Procedures Equipment. Its products include XTRAC excimer laser and VTRAC lamp systems that are used for the treatment of skin disorders, such as psoriasis, vitiligo, atopic dermatitis, and eczema, among others. The company distributes its products internationally through distributors, and domestically directly to physicians. STRATA Skin Sciences, Inc. was founded in 1989 and is based in Horsham, Pennsylvania."
SSKN,2018-12-31,1065000,-4297000,NA,-4033000,19421000,17400000,-3086000,-3086000,-1142000,-264000,29855000,32941000,12455000,-1211000,NA,-4033000,-4033000,NA,income_statement,Medical Devices,"Strata Skin Sciences, Inc.","STRATA Skin Sciences, Inc., a medical technology company, develops, commercializes, and markets products for the treatment of dermatologic conditions in the United States and Asia. The company operates in two segments, Dermatology Recurring Procedures and Dermatology Procedures Equipment. Its products include XTRAC excimer laser and VTRAC lamp systems that are used for the treatment of skin disorders, such as psoriasis, vitiligo, atopic dermatitis, and eczema, among others. The company distributes its products internationally through distributors, and domestically directly to physicians. STRATA Skin Sciences, Inc. was founded in 1989 and is based in Horsham, Pennsylvania."
SSKN,2019-12-31,1002000,-3939000,NA,-3790000,22278000,20270000,-3010000,-3010000,-515000,-149000,31586000,34596000,11316000,-929000,NA,-3790000,-3790000,NA,income_statement,Medical Devices,"Strata Skin Sciences, Inc.","STRATA Skin Sciences, Inc., a medical technology company, develops, commercializes, and markets products for the treatment of dermatologic conditions in the United States and Asia. The company operates in two segments, Dermatology Recurring Procedures and Dermatology Procedures Equipment. Its products include XTRAC excimer laser and VTRAC lamp systems that are used for the treatment of skin disorders, such as psoriasis, vitiligo, atopic dermatitis, and eczema, among others. The company distributes its products internationally through distributors, and domestically directly to physicians. STRATA Skin Sciences, Inc. was founded in 1989 and is based in Horsham, Pennsylvania."
SSNC,2017-12-31,153300000,282700000,NA,328900000,238100000,788900000,397500000,397500000,-108600000,-46200000,1675300000,1277800000,886400000,-114800000,NA,328900000,328900000,NA,income_statement,Software—Application,"SS&C Technologies Holdings, Inc","SS&C Technologies Holdings, Inc., together with its subsidiaries, provides software products and software-enabled services to financial services and healthcare industries. The company owns and operates technology stack across securities accounting, front-to-back-office operations, performance and risk analytics, regulatory reporting, and healthcare information processes. Its products and services allow professionals in the financial services and healthcare industries to automate complex business processes and are instrumental in helping its clients to manage information processing requirements. The company's software-enabled services include SS&C GlobeOp, SS&C asset management solutions, Black Diamond wealth platform, Advent outsourcing services, Advent data solutions, ALPS advisors, and virtual data rooms, as well as pharmacy, healthcare administration, and health outcomes optimization solutions. Its software products comprise portfolio accounting software, portfolio management software, trading software, digital process automation product suite, and banking and lending solutions, as well as research, analytics, and training solutions. The company also provides professional services that consist of consulting and implementation services to assist clients; and product support services. It operates in the United States; the United Kingdom; Europe, the Middle East, and Africa; the Asia Pacific and Japan; Canada; and the Americas. The company was founded in 1986 and is headquartered in Windsor, Connecticut."
SSNC,2018-12-31,305500000,125100000,NA,103200000,513800000,1408800000,589500000,589500000,-280100000,21900000,3421100000,2831600000,2012300000,-464400000,NA,103200000,103200000,NA,income_statement,Software—Application,"SS&C Technologies Holdings, Inc","SS&C Technologies Holdings, Inc., together with its subsidiaries, provides software products and software-enabled services to financial services and healthcare industries. The company owns and operates technology stack across securities accounting, front-to-back-office operations, performance and risk analytics, regulatory reporting, and healthcare information processes. Its products and services allow professionals in the financial services and healthcare industries to automate complex business processes and are instrumental in helping its clients to manage information processing requirements. The company's software-enabled services include SS&C GlobeOp, SS&C asset management solutions, Black Diamond wealth platform, Advent outsourcing services, Advent data solutions, ALPS advisors, and virtual data rooms, as well as pharmacy, healthcare administration, and health outcomes optimization solutions. Its software products comprise portfolio accounting software, portfolio management software, trading software, digital process automation product suite, and banking and lending solutions, as well as research, analytics, and training solutions. The company also provides professional services that consist of consulting and implementation services to assist clients; and product support services. It operates in the United States; the United Kingdom; Europe, the Middle East, and Africa; the Asia Pacific and Japan; Canada; and the Americas. The company was founded in 1986 and is headquartered in Windsor, Connecticut."
SSNC,2019-12-31,382200000,531700000,NA,438500000,713100000,2025600000,930300000,930300000,-409600000,93200000,4632900000,3702600000,2607300000,-398600000,NA,438500000,438500000,NA,income_statement,Software—Application,"SS&C Technologies Holdings, Inc","SS&C Technologies Holdings, Inc., together with its subsidiaries, provides software products and software-enabled services to financial services and healthcare industries. The company owns and operates technology stack across securities accounting, front-to-back-office operations, performance and risk analytics, regulatory reporting, and healthcare information processes. Its products and services allow professionals in the financial services and healthcare industries to automate complex business processes and are instrumental in helping its clients to manage information processing requirements. The company's software-enabled services include SS&C GlobeOp, SS&C asset management solutions, Black Diamond wealth platform, Advent outsourcing services, Advent data solutions, ALPS advisors, and virtual data rooms, as well as pharmacy, healthcare administration, and health outcomes optimization solutions. Its software products comprise portfolio accounting software, portfolio management software, trading software, digital process automation product suite, and banking and lending solutions, as well as research, analytics, and training solutions. The company also provides professional services that consist of consulting and implementation services to assist clients; and product support services. It operates in the United States; the United Kingdom; Europe, the Middle East, and Africa; the Asia Pacific and Japan; Canada; and the Americas. The company was founded in 1986 and is headquartered in Windsor, Connecticut."
SSNC,2020-12-31,399400000,775800000,NA,625200000,708600000,2093800000,985800000,985800000,-245900000,150600000,4667900000,3682100000,2574100000,-210000000,NA,625200000,625200000,NA,income_statement,Software—Application,"SS&C Technologies Holdings, Inc","SS&C Technologies Holdings, Inc., together with its subsidiaries, provides software products and software-enabled services to financial services and healthcare industries. The company owns and operates technology stack across securities accounting, front-to-back-office operations, performance and risk analytics, regulatory reporting, and healthcare information processes. Its products and services allow professionals in the financial services and healthcare industries to automate complex business processes and are instrumental in helping its clients to manage information processing requirements. The company's software-enabled services include SS&C GlobeOp, SS&C asset management solutions, Black Diamond wealth platform, Advent outsourcing services, Advent data solutions, ALPS advisors, and virtual data rooms, as well as pharmacy, healthcare administration, and health outcomes optimization solutions. Its software products comprise portfolio accounting software, portfolio management software, trading software, digital process automation product suite, and banking and lending solutions, as well as research, analytics, and training solutions. The company also provides professional services that consist of consulting and implementation services to assist clients; and product support services. It operates in the United States; the United Kingdom; Europe, the Middle East, and Africa; the Asia Pacific and Japan; Canada; and the Americas. The company was founded in 1986 and is headquartered in Windsor, Connecticut."
SSNT,2016-12-31,NA,1212665,NA,3436399,10732444,12727242,1267343,1267343,-64678,-2223734,34121970,32854627,21394728,-54678,1184005,3436399,3436399,NA,income_statement,Software—Application,"SilverSun Technologies, Inc.","SilverSun Technologies, Inc. operates as a business application, technology, and consulting company. The company resells enterprise resource planning software for the financial accounting requirements, as well as offers training, technical support, and professional services. It also resells warehouse management system software, which controls the movement and storage of materials; and customer relationship management, human capital management, and business intelligence products. In addition, the company provides managed, cybersecurity, business continuity, disaster recovery, data back-up, network maintenance and service upgrades, and application hosting services. It serves small and medium-sized businesses that sell services and products to various end users, manufacturers, wholesalers, and distributors in the United States. The company was formerly known as Trey Resources, Inc. and changed its name to SilverSun Technologies, Inc. in June 2011. SilverSun Technologies, Inc. was founded in 1988 and is headquartered in East Hanover, New Jersey."
SSNT,2017-12-31,NA,907562,NA,-486469,12204197,13865440,939258,939258,-31696,1394031,34852028,33912770,20986588,-31696,1184005,-486469,-486469,NA,income_statement,Software—Application,"SilverSun Technologies, Inc.","SilverSun Technologies, Inc. operates as a business application, technology, and consulting company. The company resells enterprise resource planning software for the financial accounting requirements, as well as offers training, technical support, and professional services. It also resells warehouse management system software, which controls the movement and storage of materials; and customer relationship management, human capital management, and business intelligence products. In addition, the company provides managed, cybersecurity, business continuity, disaster recovery, data back-up, network maintenance and service upgrades, and application hosting services. It serves small and medium-sized businesses that sell services and products to various end users, manufacturers, wholesalers, and distributors in the United States. The company was formerly known as Trey Resources, Inc. and changed its name to SilverSun Technologies, Inc. in June 2011. SilverSun Technologies, Inc. was founded in 1988 and is headquartered in East Hanover, New Jersey."
SSNT,2018-12-31,NA,-1202785,NA,262432,14366526,13854850,-1161103,-1161103,-41682,-281212,36103818,37264921,22248968,-41682,1184005,-921573,262432,NA,income_statement,Software—Application,"SilverSun Technologies, Inc.","SilverSun Technologies, Inc. operates as a business application, technology, and consulting company. The company resells enterprise resource planning software for the financial accounting requirements, as well as offers training, technical support, and professional services. It also resells warehouse management system software, which controls the movement and storage of materials; and customer relationship management, human capital management, and business intelligence products. In addition, the company provides managed, cybersecurity, business continuity, disaster recovery, data back-up, network maintenance and service upgrades, and application hosting services. It serves small and medium-sized businesses that sell services and products to various end users, manufacturers, wholesalers, and distributors in the United States. The company was formerly known as Trey Resources, Inc. and changed its name to SilverSun Technologies, Inc. in June 2011. SilverSun Technologies, Inc. was founded in 1988 and is headquartered in East Hanover, New Jersey."
SSNT,2019-12-31,NA,-1922870,NA,6794226,15628620,14678454,-1670201,-1670201,-39814,-455006,38502482,40172683,23824028,-252669,8262090,-1467864,6794226,NA,income_statement,Software—Application,"SilverSun Technologies, Inc.","SilverSun Technologies, Inc. operates as a business application, technology, and consulting company. The company resells enterprise resource planning software for the financial accounting requirements, as well as offers training, technical support, and professional services. It also resells warehouse management system software, which controls the movement and storage of materials; and customer relationship management, human capital management, and business intelligence products. In addition, the company provides managed, cybersecurity, business continuity, disaster recovery, data back-up, network maintenance and service upgrades, and application hosting services. It serves small and medium-sized businesses that sell services and products to various end users, manufacturers, wholesalers, and distributors in the United States. The company was formerly known as Trey Resources, Inc. and changed its name to SilverSun Technologies, Inc. in June 2011. SilverSun Technologies, Inc. was founded in 1988 and is headquartered in East Hanover, New Jersey."
SSP,2016-12-31,NA,93188000,632000,67235000,6953000,343932000,114931000,114931000,-18039000,33266000,874451000,759520000,530519000,-21743000,7313000,59922000,66418000,173797000,income_statement,Broadcasting,E.W. Scripps Company (The),"The E.W. Scripps Company, together with its subsidiaries, operates as a media enterprise through a portfolio of local and national media brands. The company operates through Local Media, National Media, and Other segments. The Local Media segment operates broadcast television stations, which produce news, information, and entertainment content, as well as its related digital operations. This segment also runs network, syndicated, and original programming. The National Media segment offers content services through apps on Internet-connected devices, such as set-top boxes, smartphones, smart televisions, and tablets. This segment also operates Katz, which broadcasts content through over-the-air on local broadcasters' digital sub-channels, and cable and satellite; Newsy, a national news network, which provides politics, entertainment, science, and technology news; and Triton that offers digital audio technology and measurement services for digital audio marketplace. In addition, this segment operates Stitcher that create original podcasts, a digital audio recording of a themed series; provides a mobile application where consumers can stream the latest news, sports, talk, and entertainment on demand; offers podcast ad agency services; and operates Midroll Media advertising network. The company also operates Scripps National Spelling Bee, an investigative reporting newsroom in Washington, D.C. It serves audiences and businesses. It operates through a network of 60 television stations. The company was formerly known as Scripps Howard, Inc. The E.W. Scripps Company was founded in 1878 and is headquartered in Cincinnati, Ohio."
SSP,2017-12-31,NA,-32076000,632000,-13106000,6953000,266520000,24308000,24308000,-26697000,-20054000,876972000,852664000,610452000,-56384000,-2595000,-12022000,-13106000,185869000,income_statement,Broadcasting,E.W. Scripps Company (The),"The E.W. Scripps Company, together with its subsidiaries, operates as a media enterprise through a portfolio of local and national media brands. The company operates through Local Media, National Media, and Other segments. The Local Media segment operates broadcast television stations, which produce news, information, and entertainment content, as well as its related digital operations. This segment also runs network, syndicated, and original programming. The National Media segment offers content services through apps on Internet-connected devices, such as set-top boxes, smartphones, smart televisions, and tablets. This segment also operates Katz, which broadcasts content through over-the-air on local broadcasters' digital sub-channels, and cable and satellite; Newsy, a national news network, which provides politics, entertainment, science, and technology news; and Triton that offers digital audio technology and measurement services for digital audio marketplace. In addition, this segment operates Stitcher that create original podcasts, a digital audio recording of a themed series; provides a mobile application where consumers can stream the latest news, sports, talk, and entertainment on demand; offers podcast ad agency services; and operates Midroll Media advertising network. The company also operates Scripps National Spelling Bee, an investigative reporting newsroom in Washington, D.C. It serves audiences and businesses. It operates through a network of 60 television stations. The company was formerly known as Scripps Howard, Inc. The E.W. Scripps Company was founded in 1878 and is headquartered in Cincinnati, Ohio."
SSP,2018-12-31,NA,74175000,NA,20381000,6953000,455591000,145117000,145117000,-36184000,18098000,1208425000,1063308000,752834000,-70942000,-36328000,56077000,19473000,246487000,income_statement,Broadcasting,E.W. Scripps Company (The),"The E.W. Scripps Company, together with its subsidiaries, operates as a media enterprise through a portfolio of local and national media brands. The company operates through Local Media, National Media, and Other segments. The Local Media segment operates broadcast television stations, which produce news, information, and entertainment content, as well as its related digital operations. This segment also runs network, syndicated, and original programming. The National Media segment offers content services through apps on Internet-connected devices, such as set-top boxes, smartphones, smart televisions, and tablets. This segment also operates Katz, which broadcasts content through over-the-air on local broadcasters' digital sub-channels, and cable and satellite; Newsy, a national news network, which provides politics, entertainment, science, and technology news; and Triton that offers digital audio technology and measurement services for digital audio marketplace. In addition, this segment operates Stitcher that create original podcasts, a digital audio recording of a themed series; provides a mobile application where consumers can stream the latest news, sports, talk, and entertainment on demand; offers podcast ad agency services; and operates Midroll Media advertising network. The company also operates Scripps National Spelling Bee, an investigative reporting newsroom in Washington, D.C. It serves audiences and businesses. It operates through a network of 60 television stations. The company was formerly known as Scripps Howard, Inc. The E.W. Scripps Company was founded in 1878 and is headquartered in Cincinnati, Ohio."
SSP,2019-12-31,NA,-20875000,NA,-18378000,6953000,466612000,86566000,86566000,-80596000,-2497000,1423836000,1337270000,957224000,-107441000,NA,-18378000,-18378000,293060000,income_statement,Broadcasting,E.W. Scripps Company (The),"The E.W. Scripps Company, together with its subsidiaries, operates as a media enterprise through a portfolio of local and national media brands. The company operates through Local Media, National Media, and Other segments. The Local Media segment operates broadcast television stations, which produce news, information, and entertainment content, as well as its related digital operations. This segment also runs network, syndicated, and original programming. The National Media segment offers content services through apps on Internet-connected devices, such as set-top boxes, smartphones, smart televisions, and tablets. This segment also operates Katz, which broadcasts content through over-the-air on local broadcasters' digital sub-channels, and cable and satellite; Newsy, a national news network, which provides politics, entertainment, science, and technology news; and Triton that offers digital audio technology and measurement services for digital audio marketplace. In addition, this segment operates Stitcher that create original podcasts, a digital audio recording of a themed series; provides a mobile application where consumers can stream the latest news, sports, talk, and entertainment on demand; offers podcast ad agency services; and operates Midroll Media advertising network. The company also operates Scripps National Spelling Bee, an investigative reporting newsroom in Washington, D.C. It serves audiences and businesses. It operates through a network of 60 television stations. The company was formerly known as Scripps Howard, Inc. The E.W. Scripps Company was founded in 1878 and is headquartered in Cincinnati, Ohio."
SSPK,2019-12-31,NA,2773987,NA,2773987,526001,0,-526001,-526001,NA,0,0,526001,0,3299988,NA,2773987,-359681,NA,income_statement,Shell Companies,Silver Spike Acquisition Corp.,"Silver Spike Acquisition Corp. does not have significant operations. It intends to effect a merger, amalgamation, share exchange, asset acquisition, share purchase, reorganization, or other similar business combination with one or more businesses operating in the cannabis industry. Silver Spike Acquisition Corp. was founded in 2019 and is based in New York, New York."
SSRM,2017-12-31,NA,74587000,23043000,69316000,20307000,109069000,72798000,72798000,-28382000,3121000,448773000,375975000,339704000,1789000,NA,71466000,69316000,-923000,income_statement,Gold,SSR Mining Inc.,"SSR Mining Inc., a resource company, engages in the acquisition, exploration, development, and operation of precious metal resource properties in the Americas. The company primarily explores for gold and silver deposits. Its projects include the Marigold mine located in southeastern Humboldt County, Nevada, the United States; the Seabee Gold Operation located in Saskatchewan, Canada; and the Puna Operations in Jujuy, Argentina. The company was formerly known as Silver Standard Resources Inc. and changed its name to SSR Mining Inc. in August 2017. SSR Mining Inc. was founded in 1946 and is headquartered in Vancouver, Canada."
SSRM,2018-12-31,NA,8090000,31829000,6379000,32941000,175564000,23665000,23665000,-28202000,8121000,420675000,397010000,245111000,-15575000,NA,-31000,6379000,3459000,income_statement,Gold,SSR Mining Inc.,"SSR Mining Inc., a resource company, engages in the acquisition, exploration, development, and operation of precious metal resource properties in the Americas. The company primarily explores for gold and silver deposits. Its projects include the Marigold mine located in southeastern Humboldt County, Nevada, the United States; the Seabee Gold Operation located in Saskatchewan, Canada; and the Puna Operations in Jujuy, Argentina. The company was formerly known as Silver Standard Resources Inc. and changed its name to SSR Mining Inc. in August 2017. SSR Mining Inc. was founded in 1946 and is headquartered in Vancouver, Canada."
SSRM,2019-12-31,NA,86129000,513626000,57315000,18115000,277040000,118595000,118595000,-23049000,30372000,606850000,488255000,329810000,-32466000,NA,55757000,57315000,3743000,income_statement,Gold,SSR Mining Inc.,"SSR Mining Inc., a resource company, engages in the acquisition, exploration, development, and operation of precious metal resource properties in the Americas. The company primarily explores for gold and silver deposits. Its projects include the Marigold mine located in southeastern Humboldt County, Nevada, the United States; the Seabee Gold Operation located in Saskatchewan, Canada; and the Puna Operations in Jujuy, Argentina. The company was formerly known as Silver Standard Resources Inc. and changed its name to SSR Mining Inc. in August 2017. SSR Mining Inc. was founded in 1946 and is headquartered in Vancouver, Canada."
SSRM,2020-12-31,NA,181321000,513626000,133494000,24626000,404844000,219639000,219639000,-19916000,40853000,853089000,633450000,448245000,-38318000,NA,140468000,133494000,3887000,income_statement,Gold,SSR Mining Inc.,"SSR Mining Inc., a resource company, engages in the acquisition, exploration, development, and operation of precious metal resource properties in the Americas. The company primarily explores for gold and silver deposits. Its projects include the Marigold mine located in southeastern Humboldt County, Nevada, the United States; the Seabee Gold Operation located in Saskatchewan, Canada; and the Puna Operations in Jujuy, Argentina. The company was formerly known as Silver Standard Resources Inc. and changed its name to SSR Mining Inc. in August 2017. SSR Mining Inc. was founded in 1946 and is headquartered in Vancouver, Canada."
SSSS,2016-12-31,NA,-74994895,NA,-74994895,-2731784,736283,3468067,3468067,-4731430,0,736283,-2731784,0,-78462962,NA,-74994895,-74994895,NA,income_statement,Asset Management,SuRo Capital Corp.,"Sutter Rock Capital Corp. is specializing in growth capital, B round and beyond, emerging growth, and pre-IPO investments in late stage venture-backed private companies. It makes direct (primary rounds) investments in companies and also makes secondary direct investments. The fund operates as a Business development Company. The fund may also invest in select publicly-traded equity securities of companies that otherwise meet its investment criteria. It seeks to invest in the technology subsectors of social/mobile marketplaces, sustainability, cloud computing and big data, social media, mobile computing and applications, software as a service, Internet commerce, green technology and education technology. The fund invests in the form of non-controlling equity and equity-related investments, including common stock, warrants, preferred stock and similar forms of senior equity, which may or may not be convertible into a portfolio company's common equity, and convertible debt securities with a significant equity component. It will invest in companies based in United States. It generally invests in companies with a market value of over $100 million. Typically, the firm exits its position within 18 months of going public, or 12 months after any relevant lock-up has expired."
SSSS,2017-12-31,NA,17620834,NA,17567933,16981863,852768,-16129095,-16129095,-4696819,52901,852768,16981863,0,33749929,NA,17567933,17567933,NA,income_statement,Asset Management,SuRo Capital Corp.,"Sutter Rock Capital Corp. is specializing in growth capital, B round and beyond, emerging growth, and pre-IPO investments in late stage venture-backed private companies. It makes direct (primary rounds) investments in companies and also makes secondary direct investments. The fund operates as a Business development Company. The fund may also invest in select publicly-traded equity securities of companies that otherwise meet its investment criteria. It seeks to invest in the technology subsectors of social/mobile marketplaces, sustainability, cloud computing and big data, social media, mobile computing and applications, software as a service, Internet commerce, green technology and education technology. The fund invests in the form of non-controlling equity and equity-related investments, including common stock, warrants, preferred stock and similar forms of senior equity, which may or may not be convertible into a portfolio company's common equity, and convertible debt securities with a significant equity component. It will invest in companies based in United States. It generally invests in companies with a market value of over $100 million. Typically, the firm exits its position within 18 months of going public, or 12 months after any relevant lock-up has expired."
SSSS,2018-12-31,NA,1374737,NA,891743,9223948,1617836,-7606112,-7606112,-4545471,482994,1617836,9223948,0,8980849,NA,891743,891743,NA,income_statement,Asset Management,SuRo Capital Corp.,"Sutter Rock Capital Corp. is specializing in growth capital, B round and beyond, emerging growth, and pre-IPO investments in late stage venture-backed private companies. It makes direct (primary rounds) investments in companies and also makes secondary direct investments. The fund operates as a Business development Company. The fund may also invest in select publicly-traded equity securities of companies that otherwise meet its investment criteria. It seeks to invest in the technology subsectors of social/mobile marketplaces, sustainability, cloud computing and big data, social media, mobile computing and applications, software as a service, Internet commerce, green technology and education technology. The fund invests in the form of non-controlling equity and equity-related investments, including common stock, warrants, preferred stock and similar forms of senior equity, which may or may not be convertible into a portfolio company's common equity, and convertible debt securities with a significant equity component. It will invest in companies based in United States. It generally invests in companies with a market value of over $100 million. Typically, the firm exits its position within 18 months of going public, or 12 months after any relevant lock-up has expired."
SSSS,2019-12-31,NA,23987522,NA,23953697,8540397,1495724,-7044673,-7044673,-2372570,33825,1495724,8540397,0,31032195,NA,23953697,23953697,NA,income_statement,Asset Management,SuRo Capital Corp.,"Sutter Rock Capital Corp. is specializing in growth capital, B round and beyond, emerging growth, and pre-IPO investments in late stage venture-backed private companies. It makes direct (primary rounds) investments in companies and also makes secondary direct investments. The fund operates as a Business development Company. The fund may also invest in select publicly-traded equity securities of companies that otherwise meet its investment criteria. It seeks to invest in the technology subsectors of social/mobile marketplaces, sustainability, cloud computing and big data, social media, mobile computing and applications, software as a service, Internet commerce, green technology and education technology. The fund invests in the form of non-controlling equity and equity-related investments, including common stock, warrants, preferred stock and similar forms of senior equity, which may or may not be convertible into a portfolio company's common equity, and convertible debt securities with a significant equity component. It will invest in companies based in United States. It generally invests in companies with a market value of over $100 million. Typically, the firm exits its position within 18 months of going public, or 12 months after any relevant lock-up has expired."
SSTI,2016-12-31,4093000,-6860000,NA,-6860000,6837000,5958000,-4972000,-4972000,-1317000,0,15507000,20479000,9549000,-1888000,NA,-6860000,-6860000,NA,income_statement,Software—Application,"ShotSpotter, Inc.","ShotSpotter, Inc. provides precision-policing and security solutions for law enforcement and security personnel in the United States, South Africa, and the Bahamas. Its solutions include ShotSpotter Flex, a public safety solution, which serves cities and municipalities to identify, locate, and deter gun violence by incorporating a real-time gunshot detection system into their policing systems; and ShotSpotter Missions, a cloud-based patrol management solution to help police departments plan patrol missions and tactics for crime deterrence. The company also provides ShotSpotter SecureCampus that helps the law enforcement and security personnel serving universities, colleges, and other educational institutions to mitigate risk and enhance security by notifying authorities and first responders of an active-shooter. In addition, it offers ShotSpotter SiteSecure, which serves customers, such as corporations to safeguard their facilities; and public agencies focused on protecting critical infrastructure, including train stations, airports, and freeways. Further, it provides ShotSpotter Labs, a technology to adapt and extend or commercial technology to address significant wildlife and environmental issues. The company sells its solutions through its direct sales teams. ShotSpotter, Inc. was founded in 1996 and is headquartered in Newark, California."
SSTI,2017-12-31,4159000,-9820000,NA,-9980000,11774000,12393000,-3540000,-3540000,-1114000,160000,23763000,27303000,11370000,-6280000,NA,-9980000,-9980000,NA,income_statement,Software—Application,"ShotSpotter, Inc.","ShotSpotter, Inc. provides precision-policing and security solutions for law enforcement and security personnel in the United States, South Africa, and the Bahamas. Its solutions include ShotSpotter Flex, a public safety solution, which serves cities and municipalities to identify, locate, and deter gun violence by incorporating a real-time gunshot detection system into their policing systems; and ShotSpotter Missions, a cloud-based patrol management solution to help police departments plan patrol missions and tactics for crime deterrence. The company also provides ShotSpotter SecureCampus that helps the law enforcement and security personnel serving universities, colleges, and other educational institutions to mitigate risk and enhance security by notifying authorities and first responders of an active-shooter. In addition, it offers ShotSpotter SiteSecure, which serves customers, such as corporations to safeguard their facilities; and public agencies focused on protecting critical infrastructure, including train stations, airports, and freeways. Further, it provides ShotSpotter Labs, a technology to adapt and extend or commercial technology to address significant wildlife and environmental issues. The company sells its solutions through its direct sales teams. ShotSpotter, Inc. was founded in 1996 and is headquartered in Newark, California."
SSTI,2018-12-31,4987000,-2738000,NA,-2725000,16602000,19907000,-1682000,-1682000,NA,-13000,34753000,36435000,14846000,-1056000,NA,-2725000,-2725000,NA,income_statement,Software—Application,"ShotSpotter, Inc.","ShotSpotter, Inc. provides precision-policing and security solutions for law enforcement and security personnel in the United States, South Africa, and the Bahamas. Its solutions include ShotSpotter Flex, a public safety solution, which serves cities and municipalities to identify, locate, and deter gun violence by incorporating a real-time gunshot detection system into their policing systems; and ShotSpotter Missions, a cloud-based patrol management solution to help police departments plan patrol missions and tactics for crime deterrence. The company also provides ShotSpotter SecureCampus that helps the law enforcement and security personnel serving universities, colleges, and other educational institutions to mitigate risk and enhance security by notifying authorities and first responders of an active-shooter. In addition, it offers ShotSpotter SiteSecure, which serves customers, such as corporations to safeguard their facilities; and public agencies focused on protecting critical infrastructure, including train stations, airports, and freeways. Further, it provides ShotSpotter Labs, a technology to adapt and extend or commercial technology to address significant wildlife and environmental issues. The company sells its solutions through its direct sales teams. ShotSpotter, Inc. was founded in 1996 and is headquartered in Newark, California."
SSTI,2019-12-31,5344000,1757000,NA,1798000,17404000,24343000,1595000,1595000,NA,-41000,40752000,39157000,16409000,162000,NA,1798000,1798000,NA,income_statement,Software—Application,"ShotSpotter, Inc.","ShotSpotter, Inc. provides precision-policing and security solutions for law enforcement and security personnel in the United States, South Africa, and the Bahamas. Its solutions include ShotSpotter Flex, a public safety solution, which serves cities and municipalities to identify, locate, and deter gun violence by incorporating a real-time gunshot detection system into their policing systems; and ShotSpotter Missions, a cloud-based patrol management solution to help police departments plan patrol missions and tactics for crime deterrence. The company also provides ShotSpotter SecureCampus that helps the law enforcement and security personnel serving universities, colleges, and other educational institutions to mitigate risk and enhance security by notifying authorities and first responders of an active-shooter. In addition, it offers ShotSpotter SiteSecure, which serves customers, such as corporations to safeguard their facilities; and public agencies focused on protecting critical infrastructure, including train stations, airports, and freeways. Further, it provides ShotSpotter Labs, a technology to adapt and extend or commercial technology to address significant wildlife and environmental issues. The company sells its solutions through its direct sales teams. ShotSpotter, Inc. was founded in 1996 and is headquartered in Newark, California."
SSYS,2016-12-31,97778000,-87067000,2160000,-77219000,287118000,323148000,-61748000,-61748000,-1323000,-9446000,672458000,734206000,349310000,-25319000,NA,-77621000,-77219000,NA,income_statement,Computer Hardware,"Stratasys, Ltd.","Stratasys Ltd. provides 3D printing and additive manufacturing solutions for individuals, businesses, and enterprises. Its 3D printing systems utilize its fused deposition modeling (FDM) and inkjet-based PolyJet technologies to enable the production of prototypes, tools used for production, and manufactured goods directly from 3D CAD files or other 3D content. The company offers entry-level desktop 3D printers to systems for rapid prototyping, and production systems for direct digital manufacturing. It also provides 3D printing consumable materials, including FDM cartridge-based materials, PolyJet cartridge-based materials, non-color digital materials, and color variations. In addition, the company offers GrabCAD Print software that provides job programming, scheduling, monitoring, and analytics across various 3D printing technologies; and GrabCAD Workbench, a cloud-based project data management solution. Further, it operates Thingiverse, an online community for sharing downloadable digital 3D designs; and GrabCAD Community for mechanical engineers, designers, manufacturers, and students to best practices through tutorials, discussion forums, and design/print challenges. Additionally, the company offers customer support, basic warranty, and extended support programs, as well as strategy, operations, and engineering consultancy services; leases or rents 3D printers and 3D production systems; produces prototypes and end-use parts for customers from a customer-provided CAD file; and offers plastic and metal parts for rapid prototyping and production processes, as well as related professional services, carbon-fiber based printers, and elastomeric materials. Its products and services are primarily used in the automotive, aerospace, medical, dental, education, and consumer goods markets. The company sells its products through a network of resellers and independent sales agents worldwide. Stratasys Ltd. was founded in 1989 and is headquartered in Eden Prairie, Minnesota."
SSYS,2017-12-31,96237000,-31186000,1652000,-39981000,257063000,324288000,-29012000,-29012000,-1323000,9273000,668362000,697374000,344074000,-2174000,NA,-40459000,-39981000,NA,income_statement,Computer Hardware,"Stratasys, Ltd.","Stratasys Ltd. provides 3D printing and additive manufacturing solutions for individuals, businesses, and enterprises. Its 3D printing systems utilize its fused deposition modeling (FDM) and inkjet-based PolyJet technologies to enable the production of prototypes, tools used for production, and manufactured goods directly from 3D CAD files or other 3D content. The company offers entry-level desktop 3D printers to systems for rapid prototyping, and production systems for direct digital manufacturing. It also provides 3D printing consumable materials, including FDM cartridge-based materials, PolyJet cartridge-based materials, non-color digital materials, and color variations. In addition, the company offers GrabCAD Print software that provides job programming, scheduling, monitoring, and analytics across various 3D printing technologies; and GrabCAD Workbench, a cloud-based project data management solution. Further, it operates Thingiverse, an online community for sharing downloadable digital 3D designs; and GrabCAD Community for mechanical engineers, designers, manufacturers, and students to best practices through tutorials, discussion forums, and design/print challenges. Additionally, the company offers customer support, basic warranty, and extended support programs, as well as strategy, operations, and engineering consultancy services; leases or rents 3D printers and 3D production systems; produces prototypes and end-use parts for customers from a customer-provided CAD file; and offers plastic and metal parts for rapid prototyping and production processes, as well as related professional services, carbon-fiber based printers, and elastomeric materials. Its products and services are primarily used in the automotive, aerospace, medical, dental, education, and consumer goods markets. The company sells its products through a network of resellers and independent sales agents worldwide. Stratasys Ltd. was founded in 1989 and is headquartered in Eden Prairie, Minnesota."
SSYS,2018-12-31,98964000,-6489000,852000,-10964000,235107000,325235000,-8836000,-8836000,-1323000,4736000,663237000,672073000,338002000,2347000,NA,-11225000,-11899000,NA,income_statement,Computer Hardware,"Stratasys, Ltd.","Stratasys Ltd. provides 3D printing and additive manufacturing solutions for individuals, businesses, and enterprises. Its 3D printing systems utilize its fused deposition modeling (FDM) and inkjet-based PolyJet technologies to enable the production of prototypes, tools used for production, and manufactured goods directly from 3D CAD files or other 3D content. The company offers entry-level desktop 3D printers to systems for rapid prototyping, and production systems for direct digital manufacturing. It also provides 3D printing consumable materials, including FDM cartridge-based materials, PolyJet cartridge-based materials, non-color digital materials, and color variations. In addition, the company offers GrabCAD Print software that provides job programming, scheduling, monitoring, and analytics across various 3D printing technologies; and GrabCAD Workbench, a cloud-based project data management solution. Further, it operates Thingiverse, an online community for sharing downloadable digital 3D designs; and GrabCAD Community for mechanical engineers, designers, manufacturers, and students to best practices through tutorials, discussion forums, and design/print challenges. Additionally, the company offers customer support, basic warranty, and extended support programs, as well as strategy, operations, and engineering consultancy services; leases or rents 3D printers and 3D production systems; produces prototypes and end-use parts for customers from a customer-provided CAD file; and offers plastic and metal parts for rapid prototyping and production processes, as well as related professional services, carbon-fiber based printers, and elastomeric materials. Its products and services are primarily used in the automotive, aerospace, medical, dental, education, and consumer goods markets. The company sells its products through a network of resellers and independent sales agents worldwide. Stratasys Ltd. was founded in 1989 and is headquartered in Eden Prairie, Minnesota."
SSYS,2019-12-31,94253000,-7556000,622000,-10849000,231138000,314434000,-10957000,-10957000,NA,3523000,636080000,647037000,321646000,3401000,NA,-11079000,-10849000,NA,income_statement,Computer Hardware,"Stratasys, Ltd.","Stratasys Ltd. provides 3D printing and additive manufacturing solutions for individuals, businesses, and enterprises. Its 3D printing systems utilize its fused deposition modeling (FDM) and inkjet-based PolyJet technologies to enable the production of prototypes, tools used for production, and manufactured goods directly from 3D CAD files or other 3D content. The company offers entry-level desktop 3D printers to systems for rapid prototyping, and production systems for direct digital manufacturing. It also provides 3D printing consumable materials, including FDM cartridge-based materials, PolyJet cartridge-based materials, non-color digital materials, and color variations. In addition, the company offers GrabCAD Print software that provides job programming, scheduling, monitoring, and analytics across various 3D printing technologies; and GrabCAD Workbench, a cloud-based project data management solution. Further, it operates Thingiverse, an online community for sharing downloadable digital 3D designs; and GrabCAD Community for mechanical engineers, designers, manufacturers, and students to best practices through tutorials, discussion forums, and design/print challenges. Additionally, the company offers customer support, basic warranty, and extended support programs, as well as strategy, operations, and engineering consultancy services; leases or rents 3D printers and 3D production systems; produces prototypes and end-use parts for customers from a customer-provided CAD file; and offers plastic and metal parts for rapid prototyping and production processes, as well as related professional services, carbon-fiber based printers, and elastomeric materials. Its products and services are primarily used in the automotive, aerospace, medical, dental, education, and consumer goods markets. The company sells its products through a network of resellers and independent sales agents worldwide. Stratasys Ltd. was founded in 1989 and is headquartered in Eden Prairie, Minnesota."
STAA,2016-12-30,20668000,-12444000,NA,-12129000,50255000,58369000,-12554000,-12554000,-112000,-315000,82432000,94986000,24063000,110000,NA,-12129000,-12129000,NA,income_statement,Medical Instruments & Supplies,STAAR Surgical Company,"STAAR Surgical Company, together with its subsidiaries, designs, develops, manufactures, markets, and sells implantable lenses for the eye, and delivery systems to deliver the lenses into the eye. The company provides Visian implantable collamer lenses (ICLs) to treat visual disorders, such as myopia, hyperopia, astigmatism, and presbyopia; and Hyperopic ICL, which treats far-sightedness. It also offers intraocular lenses (IOLs), including collamer material and silicone foldable IOLs, and nanoFLEX IOL that produces a clearer image, as well as preloaded injectors for use in cataract surgery. In addition, the company sells injector parts and other related instruments and devices. STAAR Surgical Company markets its products to health care providers, including ophthalmic surgeons, vision centers, surgical centers, hospitals, government facilities, and distributors primarily under the STAAR, EVO Visian ICL, Evolution in Visual Freedom, Visian, Collamer, CentraFLOW, AquaPORT, nanoFLEX, nanoPOINT, and Afinity trademarks. The company sells its products directly through its sales representatives in the United States, Japan, Spain, Germany, Canada, the United Kingdom, and Singapore, as well as through independent distributors in China, Korea, India, and internationally. STAAR Surgical Company was founded in 1982 and is based in Lake Forest, California."
STAA,2017-12-29,20044000,-2296000,NA,-2139000,47867000,64280000,-3631000,-3631000,-112000,-157000,90611000,94242000,26331000,1335000,NA,-2139000,-2139000,NA,income_statement,Medical Instruments & Supplies,STAAR Surgical Company,"STAAR Surgical Company, together with its subsidiaries, designs, develops, manufactures, markets, and sells implantable lenses for the eye, and delivery systems to deliver the lenses into the eye. The company provides Visian implantable collamer lenses (ICLs) to treat visual disorders, such as myopia, hyperopia, astigmatism, and presbyopia; and Hyperopic ICL, which treats far-sightedness. It also offers intraocular lenses (IOLs), including collamer material and silicone foldable IOLs, and nanoFLEX IOL that produces a clearer image, as well as preloaded injectors for use in cataract surgery. In addition, the company sells injector parts and other related instruments and devices. STAAR Surgical Company markets its products to health care providers, including ophthalmic surgeons, vision centers, surgical centers, hospitals, government facilities, and distributors primarily under the STAAR, EVO Visian ICL, Evolution in Visual Freedom, Visian, Collamer, CentraFLOW, AquaPORT, nanoFLEX, nanoPOINT, and Afinity trademarks. The company sells its products directly through its sales representatives in the United States, Japan, Spain, Germany, Canada, the United Kingdom, and Singapore, as well as through independent distributors in China, Korea, India, and internationally. STAAR Surgical Company was founded in 1982 and is based in Lake Forest, California."
STAA,2018-12-28,22028000,6639000,NA,4968000,62919000,91510000,6563000,6563000,NA,1671000,123954000,117391000,32444000,76000,NA,4968000,4968000,NA,income_statement,Medical Instruments & Supplies,STAAR Surgical Company,"STAAR Surgical Company, together with its subsidiaries, designs, develops, manufactures, markets, and sells implantable lenses for the eye, and delivery systems to deliver the lenses into the eye. The company provides Visian implantable collamer lenses (ICLs) to treat visual disorders, such as myopia, hyperopia, astigmatism, and presbyopia; and Hyperopic ICL, which treats far-sightedness. It also offers intraocular lenses (IOLs), including collamer material and silicone foldable IOLs, and nanoFLEX IOL that produces a clearer image, as well as preloaded injectors for use in cataract surgery. In addition, the company sells injector parts and other related instruments and devices. STAAR Surgical Company markets its products to health care providers, including ophthalmic surgeons, vision centers, surgical centers, hospitals, government facilities, and distributors primarily under the STAAR, EVO Visian ICL, Evolution in Visual Freedom, Visian, Collamer, CentraFLOW, AquaPORT, nanoFLEX, nanoPOINT, and Afinity trademarks. The company sells its products directly through its sales representatives in the United States, Japan, Spain, Germany, Canada, the United Kingdom, and Singapore, as well as through independent distributors in China, Korea, India, and internationally. STAAR Surgical Company was founded in 1982 and is based in Lake Forest, California."
STAA,2020-01-03,25298000,13026000,NA,14048000,74842000,111954000,11814000,11814000,NA,-1022000,150185000,138371000,38231000,1212000,NA,14048000,14048000,NA,income_statement,Medical Instruments & Supplies,STAAR Surgical Company,"STAAR Surgical Company, together with its subsidiaries, designs, develops, manufactures, markets, and sells implantable lenses for the eye, and delivery systems to deliver the lenses into the eye. The company provides Visian implantable collamer lenses (ICLs) to treat visual disorders, such as myopia, hyperopia, astigmatism, and presbyopia; and Hyperopic ICL, which treats far-sightedness. It also offers intraocular lenses (IOLs), including collamer material and silicone foldable IOLs, and nanoFLEX IOL that produces a clearer image, as well as preloaded injectors for use in cataract surgery. In addition, the company sells injector parts and other related instruments and devices. STAAR Surgical Company markets its products to health care providers, including ophthalmic surgeons, vision centers, surgical centers, hospitals, government facilities, and distributors primarily under the STAAR, EVO Visian ICL, Evolution in Visual Freedom, Visian, Collamer, CentraFLOW, AquaPORT, nanoFLEX, nanoPOINT, and Afinity trademarks. The company sells its products directly through its sales representatives in the United States, Japan, Spain, Germany, Canada, the United Kingdom, and Singapore, as well as through independent distributors in China, Korea, India, and internationally. STAAR Surgical Company was founded in 1982 and is based in Lake Forest, California."
STAF,2016-12-31,NA,-6591430,NA,-6618858,31275434,32806291,-1508572,-1508572,-4784572,27429,187580603,189089174,154774312,-5082858,NA,-6618858,-9663430,NA,income_statement,Staffing & Employment Services,"Staffing 360 Solutions, Inc.","Staffing 360 Solutions, Inc., a staffing company, engages in the acquisition of staffing companies in the United States and the United Kingdom. The company operates through three segments: Commercial Â US, Professional Â US, and Professional - UK. Its services primarily comprise the provision of temporary contractors; and the recruitment of candidates for permanent placement. It focuses primarily on the staffing companies supporting accounting and finance, information technology, engineering, administration, and commercial disciplines. The company was formerly known as Golden Fork Corporation and changed its name to Staffing 360 Solutions, Inc. in April 2012. Staffing 360 Solutions, Inc. was incorporated in 2009 and is headquartered in New York, New York."
STAF,2017-12-30,NA,-17559000,NA,-18491000,32350000,36741000,825000,825000,-6490000,932000,192650000,191825000,155909000,-18384000,NA,-18491000,-20700000,NA,income_statement,Staffing & Employment Services,"Staffing 360 Solutions, Inc.","Staffing 360 Solutions, Inc., a staffing company, engages in the acquisition of staffing companies in the United States and the United Kingdom. The company operates through three segments: Commercial Â US, Professional Â US, and Professional - UK. Its services primarily comprise the provision of temporary contractors; and the recruitment of candidates for permanent placement. It focuses primarily on the staffing companies supporting accounting and finance, information technology, engineering, administration, and commercial disciplines. The company was formerly known as Golden Fork Corporation and changed its name to Staffing 360 Solutions, Inc. in April 2012. Staffing 360 Solutions, Inc. was incorporated in 2009 and is headquartered in New York, New York."
STAF,2018-12-29,NA,-6479000,NA,-6501000,43439000,48304000,1741000,1741000,-8966000,22000,260926000,259185000,212622000,-8220000,NA,-6501000,-6987000,NA,income_statement,Staffing & Employment Services,"Staffing 360 Solutions, Inc.","Staffing 360 Solutions, Inc., a staffing company, engages in the acquisition of staffing companies in the United States and the United Kingdom. The company operates through three segments: Commercial Â US, Professional Â US, and Professional - UK. Its services primarily comprise the provision of temporary contractors; and the recruitment of candidates for permanent placement. It focuses primarily on the staffing companies supporting accounting and finance, information technology, engineering, administration, and commercial disciplines. The company was formerly known as Golden Fork Corporation and changed its name to Staffing 360 Solutions, Inc. in April 2012. Staffing 360 Solutions, Inc. was incorporated in 2009 and is headquartered in New York, New York."
STAF,2019-12-28,NA,-5229000,NA,-4894000,44327000,48309000,613000,613000,-8485000,-335000,278478000,277865000,230169000,-5842000,NA,-4894000,-7382000,NA,income_statement,Staffing & Employment Services,"Staffing 360 Solutions, Inc.","Staffing 360 Solutions, Inc., a staffing company, engages in the acquisition of staffing companies in the United States and the United Kingdom. The company operates through three segments: Commercial Â US, Professional Â US, and Professional - UK. Its services primarily comprise the provision of temporary contractors; and the recruitment of candidates for permanent placement. It focuses primarily on the staffing companies supporting accounting and finance, information technology, engineering, administration, and commercial disciplines. The company was formerly known as Golden Fork Corporation and changed its name to Staffing 360 Solutions, Inc. in April 2012. Staffing 360 Solutions, Inc. was incorporated in 2009 and is headquartered in New York, New York."
STAY,2016-12-31,NA,197703000,NA,163352000,119645000,711421000,370492000,370492000,-137515000,34351000,1270593000,900101000,559172000,-172789000,NA,163352000,163352000,-25000,income_statement,Lodging,"Extended Stay America, Inc. Pai","Extended Stay America, Inc., together with its subsidiaries, owns, operates, develops, and manages hotels in the United States. As of November 20, 2020, the company had a network of 646 hotels. It serves customers in the mid-priced extended stay segment. The company also licenses Extended Stay America brand to third party franchisees. Extended Stay America, Inc. was founded in 1995 and is headquartered in Charlotte, North Carolina."
STAY,2017-12-31,NA,231702000,NA,172188000,117652000,720180000,376271000,376271000,-126921000,59514000,1282725000,906454000,562545000,-144569000,NA,172188000,172188000,-2959000,income_statement,Lodging,"Extended Stay America, Inc. Pai","Extended Stay America, Inc., together with its subsidiaries, owns, operates, develops, and manages hotels in the United States. As of November 20, 2020, the company had a network of 646 hotels. It serves customers in the mid-priced extended stay segment. The company also licenses Extended Stay America brand to third party franchisees. Extended Stay America, Inc. was founded in 1995 and is headquartered in Charlotte, North Carolina."
STAY,2018-12-31,NA,253832000,NA,211756000,116994000,705363000,379059000,379059000,-124353000,42076000,1262492000,883433000,557129000,-125227000,NA,211756000,211756000,-19000,income_statement,Lodging,"Extended Stay America, Inc. Pai","Extended Stay America, Inc., together with its subsidiaries, owns, operates, develops, and manages hotels in the United States. As of November 20, 2020, the company had a network of 646 hotels. It serves customers in the mid-priced extended stay segment. The company also licenses Extended Stay America brand to third party franchisees. Extended Stay America, Inc. was founded in 1995 and is headquartered in Charlotte, North Carolina."
STAY,2019-12-31,NA,194453000,NA,165138000,124555000,648582000,324505000,324505000,-125126000,29315000,1201503000,876998000,552921000,-130052000,NA,165138000,165138000,2122000,income_statement,Lodging,"Extended Stay America, Inc. Pai","Extended Stay America, Inc., together with its subsidiaries, owns, operates, develops, and manages hotels in the United States. As of November 20, 2020, the company had a network of 646 hotels. It serves customers in the mid-priced extended stay segment. The company also licenses Extended Stay America brand to third party franchisees. Extended Stay America, Inc. was founded in 1995 and is headquartered in Charlotte, North Carolina."
STBA,2017-12-31,NA,119405000,NA,72968000,116272000,264264000,0,123948000,NA,46437000,264264000,140316000,0,-4543000,NA,72968000,72726000,24044000,income_statement,Banks—Regional,"S&T Bancorp, Inc.","S&T Bancorp, Inc. operates as the bank holding company for S&T Bank that provides retail and commercial banking products and services. The company operates through five segments: Commercial Real Estate, Commercial and Industrial, Commercial Construction, Consumer Real Estate, and Other Consumer. The company accepts time and demand deposits; and offers commercial and consumer loans, cash management services, and brokerage and trust services, as well as acts as guardian and custodian of employee benefits. It also manages private investment accounts for individuals and institutions. In addition, the company distributes life insurance and long-term disability income insurance products, as well as offers title insurance agency services to commercial customers. As of December 31, 2019, it operated 76 banking branches and 5 loan production offices located in Western Pennsylvania, Eastern Pennsylvania, Northeast Ohio, Central Ohio, and Upstate New York. S&T Bancorp, Inc. was founded in 1902 and is headquartered in Indiana, Pennsylvania."
STBA,2018-12-31,NA,123179000,NA,105334000,114245000,264050000,0,124544000,NA,17845000,264050000,139506000,0,-1365000,NA,105334000,105030000,25261000,income_statement,Banks—Regional,"S&T Bancorp, Inc.","S&T Bancorp, Inc. operates as the bank holding company for S&T Bank that provides retail and commercial banking products and services. The company operates through five segments: Commercial Real Estate, Commercial and Industrial, Commercial Construction, Consumer Real Estate, and Other Consumer. The company accepts time and demand deposits; and offers commercial and consumer loans, cash management services, and brokerage and trust services, as well as acts as guardian and custodian of employee benefits. It also manages private investment accounts for individuals and institutions. In addition, the company distributes life insurance and long-term disability income insurance products, as well as offers title insurance agency services to commercial customers. As of December 31, 2019, it operated 76 banking branches and 5 loan production offices located in Western Pennsylvania, Eastern Pennsylvania, Northeast Ohio, Central Ohio, and Upstate New York. S&T Bancorp, Inc. was founded in 1902 and is headquartered in Indiana, Pennsylvania."
STBA,2019-12-31,NA,117360000,NA,98234000,128390000,281828000,0,129468000,NA,19126000,281828000,152360000,0,-12108000,NA,98234000,97974000,23970000,income_statement,Banks—Regional,"S&T Bancorp, Inc.","S&T Bancorp, Inc. operates as the bank holding company for S&T Bank that provides retail and commercial banking products and services. The company operates through five segments: Commercial Real Estate, Commercial and Industrial, Commercial Construction, Consumer Real Estate, and Other Consumer. The company accepts time and demand deposits; and offers commercial and consumer loans, cash management services, and brokerage and trust services, as well as acts as guardian and custodian of employee benefits. It also manages private investment accounts for individuals and institutions. In addition, the company distributes life insurance and long-term disability income insurance products, as well as offers title insurance agency services to commercial customers. As of December 31, 2019, it operated 76 banking branches and 5 loan production offices located in Western Pennsylvania, Eastern Pennsylvania, Northeast Ohio, Central Ohio, and Upstate New York. S&T Bancorp, Inc. was founded in 1902 and is headquartered in Indiana, Pennsylvania."
STBA,2020-12-31,NA,21039000,NA,21040000,143583000,207683000,0,28470000,NA,-1000,207683000,179213000,0,-7431000,NA,21040000,21040000,35630000,income_statement,Banks—Regional,"S&T Bancorp, Inc.","S&T Bancorp, Inc. operates as the bank holding company for S&T Bank that provides retail and commercial banking products and services. The company operates through five segments: Commercial Real Estate, Commercial and Industrial, Commercial Construction, Consumer Real Estate, and Other Consumer. The company accepts time and demand deposits; and offers commercial and consumer loans, cash management services, and brokerage and trust services, as well as acts as guardian and custodian of employee benefits. It also manages private investment accounts for individuals and institutions. In addition, the company distributes life insurance and long-term disability income insurance products, as well as offers title insurance agency services to commercial customers. As of December 31, 2019, it operated 76 banking branches and 5 loan production offices located in Western Pennsylvania, Eastern Pennsylvania, Northeast Ohio, Central Ohio, and Upstate New York. S&T Bancorp, Inc. was founded in 1902 and is headquartered in Indiana, Pennsylvania."
STCN,2017-07-31,NA,-23131000,NA,-25827000,54159000,36365000,-17794000,-17794000,-8247000,2696000,436620000,454414000,400255000,-5337000,NA,-25827000,-25827000,NA,income_statement,Conglomerates,"Steel Connect, Inc. Common Stoc","Steel Connect, Inc., together with its subsidiaries, provides direct marketing and supply chain services in the United States, China, the Netherlands, and internationally. It offers data-driven marketing solutions, including strategy, data and analytics, response analysis, creative services, lithographic and digital printing, envelope printing and converting, component manufacturing, promotional cards, data processing and hygiene, content and asset management, personalization, lettershop and bindery, and postal optimization for paper-based direct marketing and omnichannel marketing campaigns, as well as provides business continuity and disaster recovery services. The company also offers product configuration and packaging, kitting, and assembly of components and parts into finished goods; and value-added processes, such as product testing, radio frequency identification tagging, product or service activation, language settings, personalization and engraving, multi-channel packaging, and packaging design services. In addition, it provides fulfillment services comprising order management, pick, pack and ship, retail compliance, and demand planning services; and reverse logistics services that simplifies the returns process for retailers and manufacturers, as well as operates a cloud-based e-commerce platform. Steel Connect, Inc. offers its supply chain services to customers in the consumer electronics, communications, computing, medical devices, software, storage, and retail markets. The company was formerly known as ModusLink Global Solutions, Inc. and changed its name to Steel Connect, Inc. in February 2018. Steel Connect, Inc. was incorporated in 1986 and is headquartered in Waltham, Massachusetts."
STCN,2018-07-31,NA,-34487000,NA,36715000,100472000,108470000,-12287000,-12287000,-29884000,-71202000,645258000,657545000,536788000,-22200000,NA,36715000,35380000,NA,income_statement,Conglomerates,"Steel Connect, Inc. Common Stoc","Steel Connect, Inc., together with its subsidiaries, provides direct marketing and supply chain services in the United States, China, the Netherlands, and internationally. It offers data-driven marketing solutions, including strategy, data and analytics, response analysis, creative services, lithographic and digital printing, envelope printing and converting, component manufacturing, promotional cards, data processing and hygiene, content and asset management, personalization, lettershop and bindery, and postal optimization for paper-based direct marketing and omnichannel marketing campaigns, as well as provides business continuity and disaster recovery services. The company also offers product configuration and packaging, kitting, and assembly of components and parts into finished goods; and value-added processes, such as product testing, radio frequency identification tagging, product or service activation, language settings, personalization and engraving, multi-channel packaging, and packaging design services. In addition, it provides fulfillment services comprising order management, pick, pack and ship, retail compliance, and demand planning services; and reverse logistics services that simplifies the returns process for retailers and manufacturers, as well as operates a cloud-based e-commerce platform. Steel Connect, Inc. offers its supply chain services to customers in the consumer electronics, communications, computing, medical devices, software, storage, and retail markets. The company was formerly known as ModusLink Global Solutions, Inc. and changed its name to Steel Connect, Inc. in February 2018. Steel Connect, Inc. was incorporated in 1986 and is headquartered in Waltham, Massachusetts."
STCN,2019-07-31,NA,-62057000,NA,-66727000,144078000,149730000,-24794000,-24794000,-41951000,4670000,819830000,844624000,670100000,-37263000,NA,-66727000,-68856000,NA,income_statement,Conglomerates,"Steel Connect, Inc. Common Stoc","Steel Connect, Inc., together with its subsidiaries, provides direct marketing and supply chain services in the United States, China, the Netherlands, and internationally. It offers data-driven marketing solutions, including strategy, data and analytics, response analysis, creative services, lithographic and digital printing, envelope printing and converting, component manufacturing, promotional cards, data processing and hygiene, content and asset management, personalization, lettershop and bindery, and postal optimization for paper-based direct marketing and omnichannel marketing campaigns, as well as provides business continuity and disaster recovery services. The company also offers product configuration and packaging, kitting, and assembly of components and parts into finished goods; and value-added processes, such as product testing, radio frequency identification tagging, product or service activation, language settings, personalization and engraving, multi-channel packaging, and packaging design services. In addition, it provides fulfillment services comprising order management, pick, pack and ship, retail compliance, and demand planning services; and reverse logistics services that simplifies the returns process for retailers and manufacturers, as well as operates a cloud-based e-commerce platform. Steel Connect, Inc. offers its supply chain services to customers in the consumer electronics, communications, computing, medical devices, software, storage, and retail markets. The company was formerly known as ModusLink Global Solutions, Inc. and changed its name to Steel Connect, Inc. in February 2018. Steel Connect, Inc. was incorporated in 1986 and is headquartered in Waltham, Massachusetts."
STCN,2020-07-31,NA,633000,NA,-5284000,103261000,162959000,32443000,32443000,-33969000,5917000,782813000,750370000,619854000,-31810000,NA,-5284000,-7413000,NA,income_statement,Conglomerates,"Steel Connect, Inc. Common Stoc","Steel Connect, Inc., together with its subsidiaries, provides direct marketing and supply chain services in the United States, China, the Netherlands, and internationally. It offers data-driven marketing solutions, including strategy, data and analytics, response analysis, creative services, lithographic and digital printing, envelope printing and converting, component manufacturing, promotional cards, data processing and hygiene, content and asset management, personalization, lettershop and bindery, and postal optimization for paper-based direct marketing and omnichannel marketing campaigns, as well as provides business continuity and disaster recovery services. The company also offers product configuration and packaging, kitting, and assembly of components and parts into finished goods; and value-added processes, such as product testing, radio frequency identification tagging, product or service activation, language settings, personalization and engraving, multi-channel packaging, and packaging design services. In addition, it provides fulfillment services comprising order management, pick, pack and ship, retail compliance, and demand planning services; and reverse logistics services that simplifies the returns process for retailers and manufacturers, as well as operates a cloud-based e-commerce platform. Steel Connect, Inc. offers its supply chain services to customers in the consumer electronics, communications, computing, medical devices, software, storage, and retail markets. The company was formerly known as ModusLink Global Solutions, Inc. and changed its name to Steel Connect, Inc. in February 2018. Steel Connect, Inc. was incorporated in 1986 and is headquartered in Waltham, Massachusetts."
STE,2017-03-31,59397000,184646000,11431000,109965000,651957000,1026213000,314859000,314859000,-44520000,74015000,2612756000,2297897000,1586543000,-130213000,NA,110631000,109965000,NA,income_statement,NA,NA,NA
STE,2018-03-31,60782000,354982000,11340000,290915000,615767000,1092746000,416197000,416197000,-50629000,63360000,2619996000,2203799000,1527250000,-61215000,NA,291622000,290915000,NA,income_statement,NA,NA,NA
STE,2019-03-31,63038000,369470000,7988000,304051000,644787000,1185148000,477323000,477323000,-45015000,64394000,2782170000,2304847000,1597022000,-107853000,NA,305076000,304051000,NA,income_statement,NA,NA,NA
STE,2020-03-31,65546000,498681000,12848000,407605000,708506000,1322393000,548341000,548341000,-40279000,90876000,3030895000,2482554000,1708502000,-49660000,NA,407805000,407605000,NA,income_statement,NA,NA,NA
STEP,2017-03-31,NA,43310000,15576000,40256000,23045000,101109000,44010000,44010000,-648000,454000,163059000,119049000,61950000,-700000,NA,42856000,40256000,33455000,income_statement,Asset Management,StepStone Group Inc.,"StepStone Group Inc. is an investment firm specializing in direct, fund of funds, secondary direct, and secondary indirect investments. For direct investment, it seeks to invest in venture debt, incubation, mezzanine, distressed/vulture, seed/startup, early venture, mid venture, late venture, emerging growth, later stage, turnaround, growth capital, industry consolidation, recapitalization, and buyout investments in mature and middle market companies. It prefers to invest in natural resources, technology, healthcare, services, materials, manufacturing, consumer durables, apparel, hotels, restaurants and leisure, media, retailing, consumer staples , financials, telecommunication services, energy, infrastructure, real estate, and real asset. The firm invests globally with a focus on United States, North America, Europe, Asia, Latin America, Middle East, Africa, Brazil, Mexico, Argentina, Colombia, New Zealand, China, India, Korea, Japan, Taiwan, and Australia region. It typically invests between $15 million and $200 million in firms with enterprise value between $150 million and $25000 million. The firm invests between 5% and 40% in emerging markets. For fund of fund investment, it seeks to invest in private equity funds, venture capital funds, Special situation funds, Real estate funds, Infrastructure funds, mezzanine funds, and turnaround/distressed funds. It considers investments in both domestic and International funds. It also seeks to make co-investments and follow on investments and considers partial interests in funds. StepStone Group LP was founded in 2007 and is based in New York, New York with additional offices across North America, Europe, Australia, and Asia."
STEP,2018-03-31,NA,85805000,15576000,81438000,35851000,177270000,81546000,81546000,-913000,1986000,264275000,182729000,87005000,4259000,NA,83819000,81438000,59684000,income_statement,Asset Management,StepStone Group Inc.,"StepStone Group Inc. is an investment firm specializing in direct, fund of funds, secondary direct, and secondary indirect investments. For direct investment, it seeks to invest in venture debt, incubation, mezzanine, distressed/vulture, seed/startup, early venture, mid venture, late venture, emerging growth, later stage, turnaround, growth capital, industry consolidation, recapitalization, and buyout investments in mature and middle market companies. It prefers to invest in natural resources, technology, healthcare, services, materials, manufacturing, consumer durables, apparel, hotels, restaurants and leisure, media, retailing, consumer staples , financials, telecommunication services, energy, infrastructure, real estate, and real asset. The firm invests globally with a focus on United States, North America, Europe, Asia, Latin America, Middle East, Africa, Brazil, Mexico, Argentina, Colombia, New Zealand, China, India, Korea, Japan, Taiwan, and Australia region. It typically invests between $15 million and $200 million in firms with enterprise value between $150 million and $25000 million. The firm invests between 5% and 40% in emerging markets. For fund of fund investment, it seeks to invest in private equity funds, venture capital funds, Special situation funds, Real estate funds, Infrastructure funds, mezzanine funds, and turnaround/distressed funds. It considers investments in both domestic and International funds. It also seeks to make co-investments and follow on investments and considers partial interests in funds. StepStone Group LP was founded in 2007 and is based in New York, New York with additional offices across North America, Europe, Australia, and Asia."
STEP,2019-03-31,NA,61599000,16953000,54196000,49160000,147928000,65565000,65565000,-10261000,1640000,256268000,190703000,108340000,-3966000,NA,59959000,54196000,31478000,income_statement,Asset Management,StepStone Group Inc.,"StepStone Group Inc. is an investment firm specializing in direct, fund of funds, secondary direct, and secondary indirect investments. For direct investment, it seeks to invest in venture debt, incubation, mezzanine, distressed/vulture, seed/startup, early venture, mid venture, late venture, emerging growth, later stage, turnaround, growth capital, industry consolidation, recapitalization, and buyout investments in mature and middle market companies. It prefers to invest in natural resources, technology, healthcare, services, materials, manufacturing, consumer durables, apparel, hotels, restaurants and leisure, media, retailing, consumer staples , financials, telecommunication services, energy, infrastructure, real estate, and real asset. The firm invests globally with a focus on United States, North America, Europe, Asia, Latin America, Middle East, Africa, Brazil, Mexico, Argentina, Colombia, New Zealand, China, India, Korea, Japan, Taiwan, and Australia region. It typically invests between $15 million and $200 million in firms with enterprise value between $150 million and $25000 million. The firm invests between 5% and 40% in emerging markets. For fund of fund investment, it seeks to invest in private equity funds, venture capital funds, Special situation funds, Real estate funds, Infrastructure funds, mezzanine funds, and turnaround/distressed funds. It considers investments in both domestic and International funds. It also seeks to make co-investments and follow on investments and considers partial interests in funds. StepStone Group LP was founded in 2007 and is based in New York, New York with additional offices across North America, Europe, Australia, and Asia."
STEP,2020-03-31,NA,148740000,20738000,131916000,53341000,315881000,150966000,150966000,-10211000,3955000,446611000,295645000,130730000,-2226000,NA,144785000,131916000,109659000,income_statement,Asset Management,StepStone Group Inc.,"StepStone Group Inc. is an investment firm specializing in direct, fund of funds, secondary direct, and secondary indirect investments. For direct investment, it seeks to invest in venture debt, incubation, mezzanine, distressed/vulture, seed/startup, early venture, mid venture, late venture, emerging growth, later stage, turnaround, growth capital, industry consolidation, recapitalization, and buyout investments in mature and middle market companies. It prefers to invest in natural resources, technology, healthcare, services, materials, manufacturing, consumer durables, apparel, hotels, restaurants and leisure, media, retailing, consumer staples , financials, telecommunication services, energy, infrastructure, real estate, and real asset. The firm invests globally with a focus on United States, North America, Europe, Asia, Latin America, Middle East, Africa, Brazil, Mexico, Argentina, Colombia, New Zealand, China, India, Korea, Japan, Taiwan, and Australia region. It typically invests between $15 million and $200 million in firms with enterprise value between $150 million and $25000 million. The firm invests between 5% and 40% in emerging markets. For fund of fund investment, it seeks to invest in private equity funds, venture capital funds, Special situation funds, Real estate funds, Infrastructure funds, mezzanine funds, and turnaround/distressed funds. It considers investments in both domestic and International funds. It also seeks to make co-investments and follow on investments and considers partial interests in funds. StepStone Group LP was founded in 2007 and is based in New York, New York with additional offices across North America, Europe, Australia, and Asia."
STFC,2017-12-31,NA,35000000,NA,-17800000,NA,48800000,40900000,40900000,-5900000,52800000,1422300000,1381400000,1373500000,-5900000,NA,-17800000,-17800000,7900000,income_statement,Insurance—Property & Casualty,State Auto Financial Corporatio,"State Auto Financial Corporation, through its subsidiaries, engages in writing personal and business insurance products in the United States. It operates through three segments: Personal Insurance, Commercial Insurance, and Investment Operations. The Personal Insurance segment primarily provides personal automobile, homeowners insurance, and other personal insurance products. The commercial insurance segment primarily provides commercial automobile, commercial multi-peril, fire and allied, general liability, and workers' compensation insurance covering small-to-medium sized commercial insurance market, as well as farm and ranch insurance. The Investment Operations segment provides investment management services to affiliated insurance companies. The company markets its products primarily through independent agencies, including retail agencies and wholesale brokers. The company was founded in 1950 and is headquartered in Columbus, Ohio. State Auto Financial Corporation operates as a subsidiary of State Automobile Mutual Insurance Company, Inc."
STFC,2018-12-31,NA,12900000,NA,12800000,NA,29600000,18600000,18600000,-5700000,100000,1275800000,1257200000,1246200000,-5700000,NA,12800000,12800000,11000000,income_statement,Insurance—Property & Casualty,State Auto Financial Corporatio,"State Auto Financial Corporation, through its subsidiaries, engages in writing personal and business insurance products in the United States. It operates through three segments: Personal Insurance, Commercial Insurance, and Investment Operations. The Personal Insurance segment primarily provides personal automobile, homeowners insurance, and other personal insurance products. The commercial insurance segment primarily provides commercial automobile, commercial multi-peril, fire and allied, general liability, and workers' compensation insurance covering small-to-medium sized commercial insurance market, as well as farm and ranch insurance. The Investment Operations segment provides investment management services to affiliated insurance companies. The company markets its products primarily through independent agencies, including retail agencies and wholesale brokers. The company was founded in 1950 and is headquartered in Columbus, Ohio. State Auto Financial Corporation operates as a subsidiary of State Automobile Mutual Insurance Company, Inc."
STFC,2019-12-31,NA,107000000,NA,87400000,NA,123200000,111900000,111900000,-4900000,19600000,1410000000,1298100000,1286800000,-4900000,NA,87400000,87400000,11300000,income_statement,Insurance—Property & Casualty,State Auto Financial Corporatio,"State Auto Financial Corporation, through its subsidiaries, engages in writing personal and business insurance products in the United States. It operates through three segments: Personal Insurance, Commercial Insurance, and Investment Operations. The Personal Insurance segment primarily provides personal automobile, homeowners insurance, and other personal insurance products. The commercial insurance segment primarily provides commercial automobile, commercial multi-peril, fire and allied, general liability, and workers' compensation insurance covering small-to-medium sized commercial insurance market, as well as farm and ranch insurance. The Investment Operations segment provides investment management services to affiliated insurance companies. The company markets its products primarily through independent agencies, including retail agencies and wholesale brokers. The company was founded in 1950 and is headquartered in Columbus, Ohio. State Auto Financial Corporation operates as a subsidiary of State Automobile Mutual Insurance Company, Inc."
STFC,2020-12-31,NA,14400000,NA,13100000,NA,28400000,19100000,19100000,-4700000,1300000,1482400000,1463300000,1454000000,-4700000,NA,13100000,13100000,9300000,income_statement,Insurance—Property & Casualty,State Auto Financial Corporatio,"State Auto Financial Corporation, through its subsidiaries, engages in writing personal and business insurance products in the United States. It operates through three segments: Personal Insurance, Commercial Insurance, and Investment Operations. The Personal Insurance segment primarily provides personal automobile, homeowners insurance, and other personal insurance products. The commercial insurance segment primarily provides commercial automobile, commercial multi-peril, fire and allied, general liability, and workers' compensation insurance covering small-to-medium sized commercial insurance market, as well as farm and ranch insurance. The Investment Operations segment provides investment management services to affiliated insurance companies. The company markets its products primarily through independent agencies, including retail agencies and wholesale brokers. The company was founded in 1950 and is headquartered in Columbus, Ohio. State Auto Financial Corporation operates as a subsidiary of State Automobile Mutual Insurance Company, Inc."
STIM,2016-12-31,8223000,-11234000,NA,-11234000,28720000,27606000,-9337000,-9337000,-1835000,0,34228000,43565000,6622000,-1897000,NA,-11234000,-11234000,NA,income_statement,Diagnostics & Research,"Neuronetics, Inc.","Neuronetics, Inc., a commercial stage medical technology company, designs, develops, and markets products for patients with psychiatric disorders in the United States and internationally. The company offers NeuroStar Advanced Therapy System, a non-invasive and non-systemic office-based treatment to treat adult patients with major depressive disorder. Its NeuroStar Advanced Therapy System uses transcranial magnetic stimulation to create a pulsed, MRI-strength magnetic field that induces electrical currents designed to stimulate specific areas of the brain associated with mood. The company sells its products through its sales and customer support team to psychiatrist customers. Neuronetics, Inc. was founded in 2003 and is headquartered in Malvern, Pennsylvania."
STIM,2017-12-31,7937000,-16059000,NA,-16059000,36472000,30801000,-13608000,-13608000,-2808000,0,40433000,54041000,9632000,-2451000,NA,-16059000,-16059000,NA,income_statement,Diagnostics & Research,"Neuronetics, Inc.","Neuronetics, Inc., a commercial stage medical technology company, designs, develops, and markets products for patients with psychiatric disorders in the United States and internationally. The company offers NeuroStar Advanced Therapy System, a non-invasive and non-systemic office-based treatment to treat adult patients with major depressive disorder. Its NeuroStar Advanced Therapy System uses transcranial magnetic stimulation to create a pulsed, MRI-strength magnetic field that induces electrical currents designed to stimulate specific areas of the brain associated with mood. The company sells its products through its sales and customer support team to psychiatrist customers. Neuronetics, Inc. was founded in 2003 and is headquartered in Malvern, Pennsylvania."
STIM,2018-12-31,8232000,-24097000,NA,-24097000,51931000,40329000,-19834000,-19834000,-3688000,0,52776000,72610000,12447000,-4263000,NA,-24097000,-24097000,NA,income_statement,Diagnostics & Research,"Neuronetics, Inc.","Neuronetics, Inc., a commercial stage medical technology company, designs, develops, and markets products for patients with psychiatric disorders in the United States and internationally. The company offers NeuroStar Advanced Therapy System, a non-invasive and non-systemic office-based treatment to treat adult patients with major depressive disorder. Its NeuroStar Advanced Therapy System uses transcranial magnetic stimulation to create a pulsed, MRI-strength magnetic field that induces electrical currents designed to stimulate specific areas of the brain associated with mood. The company sells its products through its sales and customer support team to psychiatrist customers. Neuronetics, Inc. was founded in 2003 and is headquartered in Malvern, Pennsylvania."
STIM,2019-12-31,13747000,-29044000,NA,-29044000,60450000,47267000,-26930000,-26930000,-3685000,0,62656000,89586000,15389000,-2114000,NA,-29044000,-29044000,NA,income_statement,Diagnostics & Research,"Neuronetics, Inc.","Neuronetics, Inc., a commercial stage medical technology company, designs, develops, and markets products for patients with psychiatric disorders in the United States and internationally. The company offers NeuroStar Advanced Therapy System, a non-invasive and non-systemic office-based treatment to treat adult patients with major depressive disorder. Its NeuroStar Advanced Therapy System uses transcranial magnetic stimulation to create a pulsed, MRI-strength magnetic field that induces electrical currents designed to stimulate specific areas of the brain associated with mood. The company sells its products through its sales and customer support team to psychiatrist customers. Neuronetics, Inc. was founded in 2003 and is headquartered in Malvern, Pennsylvania."
STKL,2016-12-31,NA,-74361000,2731000,-51188000,92740000,139195000,35173000,35173000,-32991000,-23797000,1346731000,1311558000,1207536000,-109534000,-570000,-50564000,-53000000,NA,income_statement,Packaged Foods,"SunOpta, Inc.","SunOpta Inc. manufactures and sells plant-based and fruit-based food and beverage products to retail customers, foodservice distributors, branded food companies, and food manufacturers; and sources and produces organic and non-genetically modified (non-GMO) ingredients for food industry worldwide. The company operates through three segments: Global Ingredients, Plant-Based Foods and Beverages, and Fruit-Based Foods and Beverages. The Global Ingredients segment offers organic and non-GMO ingredients that includes fruits, vegetables, oils, fats, coffee, nuts, dried fruits, sugars, liquid sweeteners, seeds, grains, rice, and pulses. This segment also processes value-added ingredients, such as cocoa liquor, butter and powder, sunflower kernel, oil and cakes, sesame seeds, and avocado oil; and produces consumer-packaged juice products, including private label orange juices, lemonades, and functional waters through third-party manufacturers. The Plant-Based Foods and Beverages segment provides plant-based beverages, and liquid and dry ingredients that utilizes almond, soy, coconut, oat, hemp, and other bases, as well as broths, teas, and nutritional beverages. This segment also packages dry- and oil-roasted in-shell sunflower and sunflower kernels, as well as corn-, soy-, and legume-based roasted snacks; and processes and sells raw sunflower inshell and kernel for food and feed applications. The Fruit-Based Foods and Beverages segment offers individually quick frozen (IQF) fruits, such as strawberries, blueberries, mangos, pineapples, blends, and other berries for retail; and IQF and bulk frozen fruits, including purÃ©es, fruit cups, and smoothies for foodservice, and custom fruit preparations for industrial use. This segment also provides fruit snacks comprising bars, twists, ropes, and bite-sized products. The company was formerly known as Stake Technology Ltd. and changed its name to SunOpta Inc. in October 2003. SunOpta Inc. was founded in 1973 and is headquartered in Mississauga, Canada."
STKL,2017-12-30,NA,-170397000,1575000,-135320000,104613000,145676000,29868000,29868000,-32596000,-35829000,1279593000,1249725000,1133917000,-200265000,NA,-134568000,-143129000,NA,income_statement,Packaged Foods,"SunOpta, Inc.","SunOpta Inc. manufactures and sells plant-based and fruit-based food and beverage products to retail customers, foodservice distributors, branded food companies, and food manufacturers; and sources and produces organic and non-genetically modified (non-GMO) ingredients for food industry worldwide. The company operates through three segments: Global Ingredients, Plant-Based Foods and Beverages, and Fruit-Based Foods and Beverages. The Global Ingredients segment offers organic and non-GMO ingredients that includes fruits, vegetables, oils, fats, coffee, nuts, dried fruits, sugars, liquid sweeteners, seeds, grains, rice, and pulses. This segment also processes value-added ingredients, such as cocoa liquor, butter and powder, sunflower kernel, oil and cakes, sesame seeds, and avocado oil; and produces consumer-packaged juice products, including private label orange juices, lemonades, and functional waters through third-party manufacturers. The Plant-Based Foods and Beverages segment provides plant-based beverages, and liquid and dry ingredients that utilizes almond, soy, coconut, oat, hemp, and other bases, as well as broths, teas, and nutritional beverages. This segment also packages dry- and oil-roasted in-shell sunflower and sunflower kernels, as well as corn-, soy-, and legume-based roasted snacks; and processes and sells raw sunflower inshell and kernel for food and feed applications. The Fruit-Based Foods and Beverages segment offers individually quick frozen (IQF) fruits, such as strawberries, blueberries, mangos, pineapples, blends, and other berries for retail; and IQF and bulk frozen fruits, including purÃ©es, fruit cups, and smoothies for foodservice, and custom fruit preparations for industrial use. This segment also provides fruit snacks comprising bars, twists, ropes, and bite-sized products. The company was formerly known as Stake Technology Ltd. and changed its name to SunOpta Inc. in October 2003. SunOpta Inc. was founded in 1973 and is headquartered in Mississauga, Canada."
STKL,2018-12-29,NA,-114521000,1504000,-109205000,107235000,130684000,12411000,12411000,-34691000,-5378000,1260852000,1248441000,1130168000,-126932000,NA,-109143000,-117114000,NA,income_statement,Packaged Foods,"SunOpta, Inc.","SunOpta Inc. manufactures and sells plant-based and fruit-based food and beverage products to retail customers, foodservice distributors, branded food companies, and food manufacturers; and sources and produces organic and non-genetically modified (non-GMO) ingredients for food industry worldwide. The company operates through three segments: Global Ingredients, Plant-Based Foods and Beverages, and Fruit-Based Foods and Beverages. The Global Ingredients segment offers organic and non-GMO ingredients that includes fruits, vegetables, oils, fats, coffee, nuts, dried fruits, sugars, liquid sweeteners, seeds, grains, rice, and pulses. This segment also processes value-added ingredients, such as cocoa liquor, butter and powder, sunflower kernel, oil and cakes, sesame seeds, and avocado oil; and produces consumer-packaged juice products, including private label orange juices, lemonades, and functional waters through third-party manufacturers. The Plant-Based Foods and Beverages segment provides plant-based beverages, and liquid and dry ingredients that utilizes almond, soy, coconut, oat, hemp, and other bases, as well as broths, teas, and nutritional beverages. This segment also packages dry- and oil-roasted in-shell sunflower and sunflower kernels, as well as corn-, soy-, and legume-based roasted snacks; and processes and sells raw sunflower inshell and kernel for food and feed applications. The Fruit-Based Foods and Beverages segment offers individually quick frozen (IQF) fruits, such as strawberries, blueberries, mangos, pineapples, blends, and other berries for retail; and IQF and bulk frozen fruits, including purÃ©es, fruit cups, and smoothies for foodservice, and custom fruit preparations for industrial use. This segment also provides fruit snacks comprising bars, twists, ropes, and bite-sized products. The company was formerly known as Stake Technology Ltd. and changed its name to SunOpta Inc. in October 2003. SunOpta Inc. was founded in 1973 and is headquartered in Mississauga, Canada."
STKL,2019-12-28,NA,2617000,1888000,-758000,104784000,116151000,396000,396000,-35583000,3221000,1190022000,1189626000,1073871000,2221000,NA,-604000,-8780000,NA,income_statement,Packaged Foods,"SunOpta, Inc.","SunOpta Inc. manufactures and sells plant-based and fruit-based food and beverage products to retail customers, foodservice distributors, branded food companies, and food manufacturers; and sources and produces organic and non-genetically modified (non-GMO) ingredients for food industry worldwide. The company operates through three segments: Global Ingredients, Plant-Based Foods and Beverages, and Fruit-Based Foods and Beverages. The Global Ingredients segment offers organic and non-GMO ingredients that includes fruits, vegetables, oils, fats, coffee, nuts, dried fruits, sugars, liquid sweeteners, seeds, grains, rice, and pulses. This segment also processes value-added ingredients, such as cocoa liquor, butter and powder, sunflower kernel, oil and cakes, sesame seeds, and avocado oil; and produces consumer-packaged juice products, including private label orange juices, lemonades, and functional waters through third-party manufacturers. The Plant-Based Foods and Beverages segment provides plant-based beverages, and liquid and dry ingredients that utilizes almond, soy, coconut, oat, hemp, and other bases, as well as broths, teas, and nutritional beverages. This segment also packages dry- and oil-roasted in-shell sunflower and sunflower kernels, as well as corn-, soy-, and legume-based roasted snacks; and processes and sells raw sunflower inshell and kernel for food and feed applications. The Fruit-Based Foods and Beverages segment offers individually quick frozen (IQF) fruits, such as strawberries, blueberries, mangos, pineapples, blends, and other berries for retail; and IQF and bulk frozen fruits, including purÃ©es, fruit cups, and smoothies for foodservice, and custom fruit preparations for industrial use. This segment also provides fruit snacks comprising bars, twists, ropes, and bite-sized products. The company was formerly known as Stake Technology Ltd. and changed its name to SunOpta Inc. in October 2003. SunOpta Inc. was founded in 1973 and is headquartered in Mississauga, Canada."
STLD,2017-12-31,NA,935235000,-45266000,812741000,485940000,1582014000,1066881000,1066881000,-134399000,129439000,9538797000,8471916000,7956783000,-146246000,NA,805796000,812741000,NA,income_statement,Steel,"Steel Dynamics, Inc.","Steel Dynamics, Inc., together with its subsidiaries, operates as a steel producer and metal recycler in the United States. It operates through three segments: Steel Operations, Metals Recycling Operations, and Steel Fabrication Operations. The Steel Operations segment offers hot roll, cold roll, and coated steel products; structural steel beams, pilings, and standard and premium grade rail products; engineered special-bar-quality products; and merchant-bar-quality products, including rounds, angles, flats, reinforcing bars, and channels and specialty steel sections. This segment is also involved in the turning, polishing, straightening, chamfering, threading, precision saw-cutting, cold drawing, and heat treating of bar products; and cutting to length, straightening, hole punching, shot blasting, welding, and coating of beams, channels, and specialty steel sections. Its products are used in construction, automotive, manufacturing, transportation, heavy and agriculture equipment, and pipe and tube industry sectors. This segment sells its products directly to end-users, steel fabricators, and service centers. The Metals Recycling Operations segment engages in the purchase, process, and resale of ferrous and nonferrous scrap metals into reusable forms and grades. Its ferrous products include heavy melting steel, busheling, bundled scrap, shredded scrap, steel turnings, and cast iron products; and nonferrous products comprise aluminum, brass, copper, stainless steel, and other nonferrous metals. This segment also provides transportation logistics, marketing, brokerage, and scrap management services. The Steel Fabrication Operations segment produces steel building components comprising steel joists, girders, trusses, and steel deck products for non-residential steel fabricators. The company also exports its products. Steel Dynamics, Inc. was founded in 1993 and is headquartered in Fort Wayne, Indiana."
STLD,2018-12-31,NA,1619774000,-47842000,1258379000,572625000,2322814000,1722409000,1722409000,-126620000,363969000,11821839000,10099430000,9499025000,-102635000,NA,1255805000,1258379000,NA,income_statement,Steel,"Steel Dynamics, Inc.","Steel Dynamics, Inc., together with its subsidiaries, operates as a steel producer and metal recycler in the United States. It operates through three segments: Steel Operations, Metals Recycling Operations, and Steel Fabrication Operations. The Steel Operations segment offers hot roll, cold roll, and coated steel products; structural steel beams, pilings, and standard and premium grade rail products; engineered special-bar-quality products; and merchant-bar-quality products, including rounds, angles, flats, reinforcing bars, and channels and specialty steel sections. This segment is also involved in the turning, polishing, straightening, chamfering, threading, precision saw-cutting, cold drawing, and heat treating of bar products; and cutting to length, straightening, hole punching, shot blasting, welding, and coating of beams, channels, and specialty steel sections. Its products are used in construction, automotive, manufacturing, transportation, heavy and agriculture equipment, and pipe and tube industry sectors. This segment sells its products directly to end-users, steel fabricators, and service centers. The Metals Recycling Operations segment engages in the purchase, process, and resale of ferrous and nonferrous scrap metals into reusable forms and grades. Its ferrous products include heavy melting steel, busheling, bundled scrap, shredded scrap, steel turnings, and cast iron products; and nonferrous products comprise aluminum, brass, copper, stainless steel, and other nonferrous metals. This segment also provides transportation logistics, marketing, brokerage, and scrap management services. The Steel Fabrication Operations segment produces steel building components comprising steel joists, girders, trusses, and steel deck products for non-residential steel fabricators. The company also exports its products. Steel Dynamics, Inc. was founded in 1993 and is headquartered in Fort Wayne, Indiana."
STLD,2019-12-31,NA,875337000,-10979000,671103000,514527000,1530984000,986880000,986880000,-127104000,197437000,10464991000,9478111000,8934007000,-111543000,NA,677900000,671103000,NA,income_statement,Steel,"Steel Dynamics, Inc.","Steel Dynamics, Inc., together with its subsidiaries, operates as a steel producer and metal recycler in the United States. It operates through three segments: Steel Operations, Metals Recycling Operations, and Steel Fabrication Operations. The Steel Operations segment offers hot roll, cold roll, and coated steel products; structural steel beams, pilings, and standard and premium grade rail products; engineered special-bar-quality products; and merchant-bar-quality products, including rounds, angles, flats, reinforcing bars, and channels and specialty steel sections. This segment is also involved in the turning, polishing, straightening, chamfering, threading, precision saw-cutting, cold drawing, and heat treating of bar products; and cutting to length, straightening, hole punching, shot blasting, welding, and coating of beams, channels, and specialty steel sections. Its products are used in construction, automotive, manufacturing, transportation, heavy and agriculture equipment, and pipe and tube industry sectors. This segment sells its products directly to end-users, steel fabricators, and service centers. The Metals Recycling Operations segment engages in the purchase, process, and resale of ferrous and nonferrous scrap metals into reusable forms and grades. Its ferrous products include heavy melting steel, busheling, bundled scrap, shredded scrap, steel turnings, and cast iron products; and nonferrous products comprise aluminum, brass, copper, stainless steel, and other nonferrous metals. This segment also provides transportation logistics, marketing, brokerage, and scrap management services. The Steel Fabrication Operations segment produces steel building components comprising steel joists, girders, trusses, and steel deck products for non-residential steel fabricators. The company also exports its products. Steel Dynamics, Inc. was founded in 1993 and is headquartered in Fort Wayne, Indiana."
STLD,2020-12-31,NA,705478000,3062000,550822000,539178000,1434728000,866551000,866551000,-94877000,134650000,9601482000,8734931000,8166754000,-161073000,NA,570828000,550822000,NA,income_statement,Steel,"Steel Dynamics, Inc.","Steel Dynamics, Inc., together with its subsidiaries, operates as a steel producer and metal recycler in the United States. It operates through three segments: Steel Operations, Metals Recycling Operations, and Steel Fabrication Operations. The Steel Operations segment offers hot roll, cold roll, and coated steel products; structural steel beams, pilings, and standard and premium grade rail products; engineered special-bar-quality products; and merchant-bar-quality products, including rounds, angles, flats, reinforcing bars, and channels and specialty steel sections. This segment is also involved in the turning, polishing, straightening, chamfering, threading, precision saw-cutting, cold drawing, and heat treating of bar products; and cutting to length, straightening, hole punching, shot blasting, welding, and coating of beams, channels, and specialty steel sections. Its products are used in construction, automotive, manufacturing, transportation, heavy and agriculture equipment, and pipe and tube industry sectors. This segment sells its products directly to end-users, steel fabricators, and service centers. The Metals Recycling Operations segment engages in the purchase, process, and resale of ferrous and nonferrous scrap metals into reusable forms and grades. Its ferrous products include heavy melting steel, busheling, bundled scrap, shredded scrap, steel turnings, and cast iron products; and nonferrous products comprise aluminum, brass, copper, stainless steel, and other nonferrous metals. This segment also provides transportation logistics, marketing, brokerage, and scrap management services. The Steel Fabrication Operations segment produces steel building components comprising steel joists, girders, trusses, and steel deck products for non-residential steel fabricators. The company also exports its products. Steel Dynamics, Inc. was founded in 1993 and is headquartered in Fort Wayne, Indiana."
STMP,2017-12-31,46208000,160248000,NA,150603000,179772000,389483000,163503000,163503000,-3669000,9645000,468709000,305206000,79226000,-3255000,NA,150603000,150603000,NA,income_statement,Software—Application,Stamps.com Inc.,"Stamps.com Inc. provides Internet-based mailing and shipping solutions in the United States and Europe. It operates through Stamps.com and MetaPack segments. The company offers mailing and shipping solutions to mail and ship various mail pieces and packages through the United States Postal Service (USPS) under the Stamps.com, Endicia, ShipEngine, ShipStation, ShipWorks, and ShippingEasy brands. Its solutions support various USPS mail classes, including First Class Mail, Priority Mail, Priority Mail Express, Media Mail, Parcel Select, and others. The company's USPS mailing and shipping solutions enable users to print electronic postage directly onto envelopes, postcards, or labels using personal computing device, printer, and Internet connection. It also provides multi carrier shipping solutions under the MetaPack brand; mailing and shipping integration solutions comprising electronic postage for transactions to partners who manage the front-end process; branded insurance to insure mails or packages; and international postage solutions. In addition, the company offers customized postage solutions under the PhotoStamps brand, which allow consumers to turn digital photos, designs, or images into USPS-approved postage; and sells NetStamps labels, shipping labels, mailing labels, postage printers, scales, and other mailing and shipping-focused office supplies through its mailing and shipping supplies stores, as well as domestic and international shipping services. It serves individuals, small businesses, home offices, medium-size businesses, large enterprises, e-commerce merchants, large retailers, and warehouse shippers. The company was formerly known as StampMaster, Inc. and changed its name to Stamps.com Inc. in December 1998. Stamps.com Inc. was founded in 1996 and is headquartered in El Segundo, California."
STMP,2018-12-31,56591000,190914000,NA,168642000,206531000,460021000,196899000,196899000,-2595000,22272000,586930000,390031000,126909000,-5985000,NA,168642000,168642000,NA,income_statement,Software—Application,Stamps.com Inc.,"Stamps.com Inc. provides Internet-based mailing and shipping solutions in the United States and Europe. It operates through Stamps.com and MetaPack segments. The company offers mailing and shipping solutions to mail and ship various mail pieces and packages through the United States Postal Service (USPS) under the Stamps.com, Endicia, ShipEngine, ShipStation, ShipWorks, and ShippingEasy brands. Its solutions support various USPS mail classes, including First Class Mail, Priority Mail, Priority Mail Express, Media Mail, Parcel Select, and others. The company's USPS mailing and shipping solutions enable users to print electronic postage directly onto envelopes, postcards, or labels using personal computing device, printer, and Internet connection. It also provides multi carrier shipping solutions under the MetaPack brand; mailing and shipping integration solutions comprising electronic postage for transactions to partners who manage the front-end process; branded insurance to insure mails or packages; and international postage solutions. In addition, the company offers customized postage solutions under the PhotoStamps brand, which allow consumers to turn digital photos, designs, or images into USPS-approved postage; and sells NetStamps labels, shipping labels, mailing labels, postage printers, scales, and other mailing and shipping-focused office supplies through its mailing and shipping supplies stores, as well as domestic and international shipping services. It serves individuals, small businesses, home offices, medium-size businesses, large enterprises, e-commerce merchants, large retailers, and warehouse shippers. The company was formerly known as StampMaster, Inc. and changed its name to Stamps.com Inc. in December 1998. Stamps.com Inc. was founded in 1996 and is headquartered in El Segundo, California."
STMP,2019-12-31,78041000,90749000,NA,59229000,245030000,416634000,93563000,93563000,-2513000,31520000,571850000,478287000,155216000,-2814000,NA,59229000,59229000,NA,income_statement,Software—Application,Stamps.com Inc.,"Stamps.com Inc. provides Internet-based mailing and shipping solutions in the United States and Europe. It operates through Stamps.com and MetaPack segments. The company offers mailing and shipping solutions to mail and ship various mail pieces and packages through the United States Postal Service (USPS) under the Stamps.com, Endicia, ShipEngine, ShipStation, ShipWorks, and ShippingEasy brands. Its solutions support various USPS mail classes, including First Class Mail, Priority Mail, Priority Mail Express, Media Mail, Parcel Select, and others. The company's USPS mailing and shipping solutions enable users to print electronic postage directly onto envelopes, postcards, or labels using personal computing device, printer, and Internet connection. It also provides multi carrier shipping solutions under the MetaPack brand; mailing and shipping integration solutions comprising electronic postage for transactions to partners who manage the front-end process; branded insurance to insure mails or packages; and international postage solutions. In addition, the company offers customized postage solutions under the PhotoStamps brand, which allow consumers to turn digital photos, designs, or images into USPS-approved postage; and sells NetStamps labels, shipping labels, mailing labels, postage printers, scales, and other mailing and shipping-focused office supplies through its mailing and shipping supplies stores, as well as domestic and international shipping services. It serves individuals, small businesses, home offices, medium-size businesses, large enterprises, e-commerce merchants, large retailers, and warehouse shippers. The company was formerly known as StampMaster, Inc. and changed its name to Stamps.com Inc. in December 1998. Stamps.com Inc. was founded in 1996 and is headquartered in El Segundo, California."
STMP,2020-12-31,95600000,196636000,NA,178665000,285412000,579164000,198152000,198152000,-1114000,17971000,757980000,559828000,178816000,-1516000,NA,178665000,178665000,NA,income_statement,Software—Application,Stamps.com Inc.,"Stamps.com Inc. provides Internet-based mailing and shipping solutions in the United States and Europe. It operates through Stamps.com and MetaPack segments. The company offers mailing and shipping solutions to mail and ship various mail pieces and packages through the United States Postal Service (USPS) under the Stamps.com, Endicia, ShipEngine, ShipStation, ShipWorks, and ShippingEasy brands. Its solutions support various USPS mail classes, including First Class Mail, Priority Mail, Priority Mail Express, Media Mail, Parcel Select, and others. The company's USPS mailing and shipping solutions enable users to print electronic postage directly onto envelopes, postcards, or labels using personal computing device, printer, and Internet connection. It also provides multi carrier shipping solutions under the MetaPack brand; mailing and shipping integration solutions comprising electronic postage for transactions to partners who manage the front-end process; branded insurance to insure mails or packages; and international postage solutions. In addition, the company offers customized postage solutions under the PhotoStamps brand, which allow consumers to turn digital photos, designs, or images into USPS-approved postage; and sells NetStamps labels, shipping labels, mailing labels, postage printers, scales, and other mailing and shipping-focused office supplies through its mailing and shipping supplies stores, as well as domestic and international shipping services. It serves individuals, small businesses, home offices, medium-size businesses, large enterprises, e-commerce merchants, large retailers, and warehouse shippers. The company was formerly known as StampMaster, Inc. and changed its name to Stamps.com Inc. in December 1998. Stamps.com Inc. was founded in 1996 and is headquartered in El Segundo, California."
STND,2017-12-31,NA,6787000,NA,4325000,13324000,28506000,0,10927000,NA,2462000,28506000,17579000,0,-4140000,NA,4325000,4325000,4255000,income_statement,Banks—Regional,Standard AVB Financial Corp.,"Standard AVB Financial Corp. operates as a bank holding company for Standard Bank PaSB that provides financial services to individuals, families, and businesses. The company offers various deposit accounts, including savings accounts, certificates of deposit, money market accounts, commercial and regular checking accounts, and individual retirement accounts. It also provides commercial real estate loans, commercial business loans, one- to four-family residential mortgage loans, home equity loans, lines of credit, construction loans, and consumer loans and overdraft lines of credit; and investment securities. It operates through a network of 17 banking offices located in the Allegheny, Westmoreland, and Bedford counties, Pennsylvania; and Allegany County, Maryland. The company was formerly known as Standard Financial Corp. and changed its name to Standard AVB Financial Corp. in April 2017. Standard AVB Financial Corp. was founded in 1913 and is based in Monroeville, Pennsylvania."
STND,2018-12-31,NA,11049000,NA,8801000,15988000,33116000,0,12178000,NA,2248000,33116000,20938000,0,-1639000,NA,8801000,8801000,4950000,income_statement,Banks—Regional,Standard AVB Financial Corp.,"Standard AVB Financial Corp. operates as a bank holding company for Standard Bank PaSB that provides financial services to individuals, families, and businesses. The company offers various deposit accounts, including savings accounts, certificates of deposit, money market accounts, commercial and regular checking accounts, and individual retirement accounts. It also provides commercial real estate loans, commercial business loans, one- to four-family residential mortgage loans, home equity loans, lines of credit, construction loans, and consumer loans and overdraft lines of credit; and investment securities. It operates through a network of 17 banking offices located in the Allegheny, Westmoreland, and Bedford counties, Pennsylvania; and Allegany County, Maryland. The company was formerly known as Standard Financial Corp. and changed its name to Standard AVB Financial Corp. in April 2017. Standard AVB Financial Corp. was founded in 1913 and is based in Monroeville, Pennsylvania."
STND,2019-12-31,NA,11144000,NA,8806000,16218000,32769000,0,11876000,NA,2338000,32769000,20893000,0,-732000,NA,8806000,8806000,4675000,income_statement,Banks—Regional,Standard AVB Financial Corp.,"Standard AVB Financial Corp. operates as a bank holding company for Standard Bank PaSB that provides financial services to individuals, families, and businesses. The company offers various deposit accounts, including savings accounts, certificates of deposit, money market accounts, commercial and regular checking accounts, and individual retirement accounts. It also provides commercial real estate loans, commercial business loans, one- to four-family residential mortgage loans, home equity loans, lines of credit, construction loans, and consumer loans and overdraft lines of credit; and investment securities. It operates through a network of 17 banking offices located in the Allegheny, Westmoreland, and Bedford counties, Pennsylvania; and Allegany County, Maryland. The company was formerly known as Standard Financial Corp. and changed its name to Standard AVB Financial Corp. in April 2017. Standard AVB Financial Corp. was founded in 1913 and is based in Monroeville, Pennsylvania."
STND,2020-12-31,NA,7877000,NA,6518000,NA,30481000,0,8952000,NA,1359000,30481000,21529000,0,-1075000,NA,6518000,6518000,21529000,income_statement,Banks—Regional,Standard AVB Financial Corp.,"Standard AVB Financial Corp. operates as a bank holding company for Standard Bank PaSB that provides financial services to individuals, families, and businesses. The company offers various deposit accounts, including savings accounts, certificates of deposit, money market accounts, commercial and regular checking accounts, and individual retirement accounts. It also provides commercial real estate loans, commercial business loans, one- to four-family residential mortgage loans, home equity loans, lines of credit, construction loans, and consumer loans and overdraft lines of credit; and investment securities. It operates through a network of 17 banking offices located in the Allegheny, Westmoreland, and Bedford counties, Pennsylvania; and Allegany County, Maryland. The company was formerly known as Standard Financial Corp. and changed its name to Standard AVB Financial Corp. in April 2017. Standard AVB Financial Corp. was founded in 1913 and is based in Monroeville, Pennsylvania."
STNE,2016-12-31,NA,-149221000,58118000,-119827000,155631000,42618000,-166892000,-166892000,-244676000,-27030000,175805000,342697000,133187000,17671000,NA,-122191000,-116889000,53879000,income_statement,Software—Application,StoneCo Ltd.,"StoneCo Ltd. provides financial technology solutions to clients and integrated partners to conduct electronic commerce across in-store, online, and mobile channels in Brazil. It distributes its solutions, principally through proprietary Stone Hubs, which offer hyper-local sales and services; and technology and solutions to digital merchants through sales and technical personnel and software vendors, as well as sells solutions to brick-and-mortar and digital merchants through sales team. As of December 31, 2019, the company served approximately 495,100 clients primarily small-and-medium-sized businesses; and 116 integrated partners, such as global payment service providers, digital marketplaces, and integrated software vendors. The company was founded in 2012 and is headquartered in George Town, Cayman Islands."
STNE,2017-12-31,NA,-95665000,15205000,-108731000,266619000,105058000,-295712000,-295712000,-237094000,9304000,329167000,624879000,224109000,200047000,NA,-104969000,-106686000,134151000,income_statement,Software—Application,StoneCo Ltd.,"StoneCo Ltd. provides financial technology solutions to clients and integrated partners to conduct electronic commerce across in-store, online, and mobile channels in Brazil. It distributes its solutions, principally through proprietary Stone Hubs, which offer hyper-local sales and services; and technology and solutions to digital merchants through sales and technical personnel and software vendors, as well as sells solutions to brick-and-mortar and digital merchants through sales team. As of December 31, 2019, the company served approximately 495,100 clients primarily small-and-medium-sized businesses; and 116 integrated partners, such as global payment service providers, digital marketplaces, and integrated software vendors. The company was founded in 2012 and is headquartered in George Town, Cayman Islands."
STNE,2018-12-31,NA,442339000,-334000,301232000,443029000,405242000,-128492000,-128492000,-301065000,137112000,728281000,856773000,323039000,570831000,NA,305227000,301358000,90705000,income_statement,Software—Application,StoneCo Ltd.,"StoneCo Ltd. provides financial technology solutions to clients and integrated partners to conduct electronic commerce across in-store, online, and mobile channels in Brazil. It distributes its solutions, principally through proprietary Stone Hubs, which offer hyper-local sales and services; and technology and solutions to digital merchants through sales and technical personnel and software vendors, as well as sells solutions to brick-and-mortar and digital merchants through sales team. As of December 31, 2019, the company served approximately 495,100 clients primarily small-and-medium-sized businesses; and 116 integrated partners, such as global payment service providers, digital marketplaces, and integrated software vendors. The company was founded in 2012 and is headquartered in George Town, Cayman Islands."
STNE,2019-12-31,NA,1090655000,626000,803232000,646400000,674880000,-29211000,-29211000,-353451000,286460000,1101841000,1131052000,426961000,1119866000,NA,804195000,803232000,57691000,income_statement,Software—Application,StoneCo Ltd.,"StoneCo Ltd. provides financial technology solutions to clients and integrated partners to conduct electronic commerce across in-store, online, and mobile channels in Brazil. It distributes its solutions, principally through proprietary Stone Hubs, which offer hyper-local sales and services; and technology and solutions to digital merchants through sales and technical personnel and software vendors, as well as sells solutions to brick-and-mortar and digital merchants through sales team. As of December 31, 2019, the company served approximately 495,100 clients primarily small-and-medium-sized businesses; and 116 integrated partners, such as global payment service providers, digital marketplaces, and integrated software vendors. The company was founded in 2012 and is headquartered in George Town, Cayman Islands."
STOK,2017-12-31,3598000,-5558000,NA,-5558000,1956000,0,-5554000,-5554000,NA,0,0,5554000,0,-4000,NA,-5558000,-5558000,NA,income_statement,Biotechnology,"Stoke Therapeutics, Inc.","Stoke Therapeutics, Inc., an early-stage biopharmaceutical company, develops novel antisense oligonucleotide medicines to treat the underlying causes of severe genetic diseases. Its lead product candidate, STK-001 used to treat Dravet syndrome, a severe and progressive genetic epilepsy. Stoke Therapeutics, Inc. has a partnership with Invitae Corporation to offer genetic testing. The company was formerly known as ASOthera Pharmaceuticals, Inc. and changed its name to Stoke Therapeutics, Inc. in May 2016. Stoke Therapeutics, Inc. was founded in 2014 and is headquartered in Bedford, Massachusetts."
STOK,2018-12-31,8371000,-12521000,NA,-12521000,4410000,0,-12781000,-12781000,NA,0,0,12781000,0,260000,NA,-12521000,-12521000,NA,income_statement,Biotechnology,"Stoke Therapeutics, Inc.","Stoke Therapeutics, Inc., an early-stage biopharmaceutical company, develops novel antisense oligonucleotide medicines to treat the underlying causes of severe genetic diseases. Its lead product candidate, STK-001 used to treat Dravet syndrome, a severe and progressive genetic epilepsy. Stoke Therapeutics, Inc. has a partnership with Invitae Corporation to offer genetic testing. The company was formerly known as ASOthera Pharmaceuticals, Inc. and changed its name to Stoke Therapeutics, Inc. in May 2016. Stoke Therapeutics, Inc. was founded in 2014 and is headquartered in Bedford, Massachusetts."
STOK,2019-12-31,23764000,-32325000,NA,-32325000,11914000,0,-35678000,-35678000,NA,0,0,35678000,0,3353000,NA,-32325000,-32325000,NA,income_statement,Biotechnology,"Stoke Therapeutics, Inc.","Stoke Therapeutics, Inc., an early-stage biopharmaceutical company, develops novel antisense oligonucleotide medicines to treat the underlying causes of severe genetic diseases. Its lead product candidate, STK-001 used to treat Dravet syndrome, a severe and progressive genetic epilepsy. Stoke Therapeutics, Inc. has a partnership with Invitae Corporation to offer genetic testing. The company was formerly known as ASOthera Pharmaceuticals, Inc. and changed its name to Stoke Therapeutics, Inc. in May 2016. Stoke Therapeutics, Inc. was founded in 2014 and is headquartered in Bedford, Massachusetts."
STRA,2016-12-31,NA,57292000,NA,34802000,144530000,198989000,54459000,54459000,-600000,22490000,441088000,386629000,242099000,2833000,NA,34802000,34802000,NA,income_statement,Education & Training Services,"Strategic Education, Inc.","Strategic Education, Inc., through its subsidiaries, provides a range of post-secondary education and non-degree programs in the United States. The company operates through three segments: Strayer University, Capella University, and Non-Degree Programs. It operates Strayer University that provides undergraduate and graduate degree programs in business administration, accounting, information technology, education, health services administration, public administration, and criminal justice for working adult students through its 77 physical campuses located in the eastern United States, as well as through online; and an executive MBA online through its Jack Welch Management Institute. The company also operates Capella University, an online post-secondary education company, which offers various bachelor's, master's, and doctoral degree programs in public service leadership, nursing and health sciences, psychology, business and technology, counseling and human services, and education primarily for working adults. In addition, it is involved in the operation of a software development school that provides Web Development, iOS development, and UX design programs in person at classrooms in Lehi, Utah, Dallas, Texas; and Phoenix, Arizona, as well as through online. Further, the company operates a software engineering school for women, which offers software development programs in person through classrooms in the San Francisco Bay area; and provides non-degree Web and application software development courses, as well as self-paced online learning courses. It offers its non-degree programs primarily for workers and their employers. Strategic Education, Inc. was founded in 1892 and is headquartered in Herndon, Virginia."
STRA,2017-12-31,NA,52646000,NA,20612000,129332000,185908000,56576000,56576000,-600000,32034000,454851000,398275000,268943000,-3930000,NA,20612000,20612000,NA,income_statement,Education & Training Services,"Strategic Education, Inc.","Strategic Education, Inc., through its subsidiaries, provides a range of post-secondary education and non-degree programs in the United States. The company operates through three segments: Strayer University, Capella University, and Non-Degree Programs. It operates Strayer University that provides undergraduate and graduate degree programs in business administration, accounting, information technology, education, health services administration, public administration, and criminal justice for working adult students through its 77 physical campuses located in the eastern United States, as well as through online; and an executive MBA online through its Jack Welch Management Institute. The company also operates Capella University, an online post-secondary education company, which offers various bachelor's, master's, and doctoral degree programs in public service leadership, nursing and health sciences, psychology, business and technology, counseling and human services, and education primarily for working adults. In addition, it is involved in the operation of a software development school that provides Web Development, iOS development, and UX design programs in person at classrooms in Lehi, Utah, Dallas, Texas; and Phoenix, Arizona, as well as through online. Further, the company operates a software engineering school for women, which offers software development programs in person through classrooms in the San Francisco Bay area; and provides non-degree Web and application software development courses, as well as self-paced online learning courses. It offers its non-degree programs primarily for workers and their employers. Strategic Education, Inc. was founded in 1892 and is headquartered in Herndon, Virginia."
STRA,2018-12-31,NA,-19139000,NA,-15671000,194035000,262643000,42914000,42914000,-700000,-3468000,634185000,591271000,371542000,-62053000,NA,-15671000,-15671000,NA,income_statement,Education & Training Services,"Strategic Education, Inc.","Strategic Education, Inc., through its subsidiaries, provides a range of post-secondary education and non-degree programs in the United States. The company operates through three segments: Strayer University, Capella University, and Non-Degree Programs. It operates Strayer University that provides undergraduate and graduate degree programs in business administration, accounting, information technology, education, health services administration, public administration, and criminal justice for working adult students through its 77 physical campuses located in the eastern United States, as well as through online; and an executive MBA online through its Jack Welch Management Institute. The company also operates Capella University, an online post-secondary education company, which offers various bachelor's, master's, and doctoral degree programs in public service leadership, nursing and health sciences, psychology, business and technology, counseling and human services, and education primarily for working adults. In addition, it is involved in the operation of a software development school that provides Web Development, iOS development, and UX design programs in person at classrooms in Lehi, Utah, Dallas, Texas; and Phoenix, Arizona, as well as through online. Further, the company operates a software engineering school for women, which offers software development programs in person through classrooms in the San Francisco Bay area; and provides non-degree Web and application software development courses, as well as self-paced online learning courses. It offers its non-degree programs primarily for workers and their employers. Strategic Education, Inc. was founded in 1892 and is headquartered in Herndon, Virginia."
STRA,2019-12-31,NA,123724000,NA,81138000,272411000,466533000,132455000,132455000,-800000,42586000,997137000,864682000,530604000,-8731000,NA,81138000,81138000,NA,income_statement,Education & Training Services,"Strategic Education, Inc.","Strategic Education, Inc., through its subsidiaries, provides a range of post-secondary education and non-degree programs in the United States. The company operates through three segments: Strayer University, Capella University, and Non-Degree Programs. It operates Strayer University that provides undergraduate and graduate degree programs in business administration, accounting, information technology, education, health services administration, public administration, and criminal justice for working adult students through its 77 physical campuses located in the eastern United States, as well as through online; and an executive MBA online through its Jack Welch Management Institute. The company also operates Capella University, an online post-secondary education company, which offers various bachelor's, master's, and doctoral degree programs in public service leadership, nursing and health sciences, psychology, business and technology, counseling and human services, and education primarily for working adults. In addition, it is involved in the operation of a software development school that provides Web Development, iOS development, and UX design programs in person at classrooms in Lehi, Utah, Dallas, Texas; and Phoenix, Arizona, as well as through online. Further, the company operates a software engineering school for women, which offers software development programs in person through classrooms in the San Francisco Bay area; and provides non-degree Web and application software development courses, as well as self-paced online learning courses. It offers its non-degree programs primarily for workers and their employers. Strategic Education, Inc. was founded in 1892 and is headquartered in Herndon, Virginia."
STRL,2016-12-31,NA,-7324000,656000,-9238000,36844000,42058000,-3529000,-3529000,-2628000,88000,690123000,693652000,648065000,-3795000,NA,-7412000,-9238000,8743000,income_statement,Engineering & Construction,Sterling Construction Company I,"Sterling Construction Company, Inc., a construction company, engages in the heavy civil construction, specialty services, and residential construction activities primarily in the southern United States, the Rocky Mountain states, California, and Hawaii. The company undertakes various heavy civil construction projects, including highways, roads, bridges, airfields, ports, light rail, water, wastewater and storm drainage systems, foundations for multi-family homes, commercial concrete projects, and parking structures for the departments of transportation in various states, regional transit authorities, airport authorities, port authorities, water authorities, and railroads, as well as commercial construction customers. It offers specialty services for blue-chip end users in the e-commerce, data center, distribution center and warehousing, energy, mixed use, and multi-family sectors. In addition, the company undertakes concrete foundations for single-family homes. Further, it provides surveying, clearing and grubbing, erosion control, grading, grassing, site excavation, storm drainage, sanitary sewer and water main installation, drilling and blasting, curb and gutter, paving, concrete work, and landfill services. The company was formerly known as Oakhurst Company, Inc. and changed its name to Sterling Construction Company, Inc. in November 2001. Sterling Construction Company, Inc. was founded in 1955 and is headquartered in The Woodlands, Texas."
STRL,2017-12-31,NA,15935000,4856000,11617000,46552000,89092000,27876000,27876000,-9800000,118000,957958000,930082000,868866000,-11941000,NA,15817000,11617000,12865000,income_statement,Engineering & Construction,Sterling Construction Company I,"Sterling Construction Company, Inc., a construction company, engages in the heavy civil construction, specialty services, and residential construction activities primarily in the southern United States, the Rocky Mountain states, California, and Hawaii. The company undertakes various heavy civil construction projects, including highways, roads, bridges, airfields, ports, light rail, water, wastewater and storm drainage systems, foundations for multi-family homes, commercial concrete projects, and parking structures for the departments of transportation in various states, regional transit authorities, airport authorities, port authorities, water authorities, and railroads, as well as commercial construction customers. It offers specialty services for blue-chip end users in the e-commerce, data center, distribution center and warehousing, energy, mixed use, and multi-family sectors. In addition, the company undertakes concrete foundations for single-family homes. Further, it provides surveying, clearing and grubbing, erosion control, grading, grassing, site excavation, storm drainage, sanitary sewer and water main installation, drilling and blasting, curb and gutter, paving, concrete work, and landfill services. The company was formerly known as Oakhurst Company, Inc. and changed its name to Sterling Construction Company, Inc. in November 2001. Sterling Construction Company, Inc. was founded in 1955 and is headquartered in The Woodlands, Texas."
STRL,2018-12-31,NA,31278000,7859000,25187000,48220000,110332000,44511000,44511000,-12350000,1738000,1037667000,993156000,927335000,-13233000,NA,29540000,25187000,15201000,income_statement,Engineering & Construction,Sterling Construction Company I,"Sterling Construction Company, Inc., a construction company, engages in the heavy civil construction, specialty services, and residential construction activities primarily in the southern United States, the Rocky Mountain states, California, and Hawaii. The company undertakes various heavy civil construction projects, including highways, roads, bridges, airfields, ports, light rail, water, wastewater and storm drainage systems, foundations for multi-family homes, commercial concrete projects, and parking structures for the departments of transportation in various states, regional transit authorities, airport authorities, port authorities, water authorities, and railroads, as well as commercial construction customers. It offers specialty services for blue-chip end users in the e-commerce, data center, distribution center and warehousing, energy, mixed use, and multi-family sectors. In addition, the company undertakes concrete foundations for single-family homes. Further, it provides surveying, clearing and grubbing, erosion control, grading, grassing, site excavation, storm drainage, sanitary sewer and water main installation, drilling and blasting, curb and gutter, paving, concrete work, and landfill services. The company was formerly known as Oakhurst Company, Inc. and changed its name to Sterling Construction Company, Inc. in November 2001. Sterling Construction Company, Inc. was founded in 1955 and is headquartered in The Woodlands, Texas."
STRL,2019-12-31,NA,14479000,1293000,39901000,49200000,107794000,44062000,44062000,-16686000,-26216000,1126278000,1082216000,1018484000,-29583000,NA,40695000,39901000,9837000,income_statement,Engineering & Construction,Sterling Construction Company I,"Sterling Construction Company, Inc., a construction company, engages in the heavy civil construction, specialty services, and residential construction activities primarily in the southern United States, the Rocky Mountain states, California, and Hawaii. The company undertakes various heavy civil construction projects, including highways, roads, bridges, airfields, ports, light rail, water, wastewater and storm drainage systems, foundations for multi-family homes, commercial concrete projects, and parking structures for the departments of transportation in various states, regional transit authorities, airport authorities, port authorities, water authorities, and railroads, as well as commercial construction customers. It offers specialty services for blue-chip end users in the e-commerce, data center, distribution center and warehousing, energy, mixed use, and multi-family sectors. In addition, the company undertakes concrete foundations for single-family homes. Further, it provides surveying, clearing and grubbing, erosion control, grading, grassing, site excavation, storm drainage, sanitary sewer and water main installation, drilling and blasting, curb and gutter, paving, concrete work, and landfill services. The company was formerly known as Oakhurst Company, Inc. and changed its name to Sterling Construction Company, Inc. in November 2001. Sterling Construction Company, Inc. was founded in 1955 and is headquartered in The Woodlands, Texas."
STRM,2017-01-31,7453638,-5173590,NA,-5161566,12728074,15532794,-4648918,-4648918,-508859,-12024,27059905,31708823,11527111,-524672,NA,-5161566,-6037501,NA,income_statement,Health Information Services,"Streamline Health Solutions, In","Streamline Health Solutions, Inc. provides health information technology solutions and associated services for hospitals and health systems in the United States and Canada. It provides computer software-based solutions and auditing services, which captures, aggregates, and translates structured and unstructured data to deliver predictive insights. The company also offers health information management; coding and clinical documentation improvement (CDI) solutions, which includes integrated cloud-based software suite, such as computer-assisted coding, CDI, and abstracting and physician query; and eValuator, a cloud-based pre- and post-bill coding analysis platform. In addition, it provides financial management solutions, including accounts receivable management, denials management, claims processing, spend management, and audit management; patient care solutions; and custom integration, training, electronic image conversion, audit, and database monitoring services. The company sells its solutions and services through direct sales force and reseller partnerships. Streamline Health Solutions, Inc. was founded in 1989 and is headquartered in Alpharetta, Georgia."
STRM,2018-01-31,5352000,-3183000,NA,-3099000,11434000,14164000,-2622000,-2622000,-474000,-84000,24338000,26960000,10174000,-561000,NA,-3099000,-3099000,NA,income_statement,Health Information Services,"Streamline Health Solutions, In","Streamline Health Solutions, Inc. provides health information technology solutions and associated services for hospitals and health systems in the United States and Canada. It provides computer software-based solutions and auditing services, which captures, aggregates, and translates structured and unstructured data to deliver predictive insights. The company also offers health information management; coding and clinical documentation improvement (CDI) solutions, which includes integrated cloud-based software suite, such as computer-assisted coding, CDI, and abstracting and physician query; and eValuator, a cloud-based pre- and post-bill coding analysis platform. In addition, it provides financial management solutions, including accounts receivable management, denials management, claims processing, spend management, and audit management; patient care solutions; and custom integration, training, electronic image conversion, audit, and database monitoring services. The company sells its solutions and services through direct sales force and reseller partnerships. Streamline Health Solutions, Inc. was founded in 1989 and is headquartered in Alpharetta, Georgia."
STRM,2019-01-31,4261000,-5865000,NA,-5865000,10554000,14228000,-587000,-587000,-384000,0,22365000,22952000,8137000,-5278000,NA,-5865000,-5865000,NA,income_statement,Health Information Services,"Streamline Health Solutions, In","Streamline Health Solutions, Inc. provides health information technology solutions and associated services for hospitals and health systems in the United States and Canada. It provides computer software-based solutions and auditing services, which captures, aggregates, and translates structured and unstructured data to deliver predictive insights. The company also offers health information management; coding and clinical documentation improvement (CDI) solutions, which includes integrated cloud-based software suite, such as computer-assisted coding, CDI, and abstracting and physician query; and eValuator, a cloud-based pre- and post-bill coding analysis platform. In addition, it provides financial management solutions, including accounts receivable management, denials management, claims processing, spend management, and audit management; patient care solutions; and custom integration, training, electronic image conversion, audit, and database monitoring services. The company sells its solutions and services through direct sales force and reseller partnerships. Streamline Health Solutions, Inc. was founded in 1989 and is headquartered in Alpharetta, Georgia."
STRM,2020-01-31,3555000,-2841000,NA,-2863000,9811000,13263000,-103000,-103000,-309000,22000,20743000,20846000,7480000,-2738000,NA,-2863000,2031000,NA,income_statement,Health Information Services,"Streamline Health Solutions, In","Streamline Health Solutions, Inc. provides health information technology solutions and associated services for hospitals and health systems in the United States and Canada. It provides computer software-based solutions and auditing services, which captures, aggregates, and translates structured and unstructured data to deliver predictive insights. The company also offers health information management; coding and clinical documentation improvement (CDI) solutions, which includes integrated cloud-based software suite, such as computer-assisted coding, CDI, and abstracting and physician query; and eValuator, a cloud-based pre- and post-bill coding analysis platform. In addition, it provides financial management solutions, including accounts receivable management, denials management, claims processing, spend management, and audit management; patient care solutions; and custom integration, training, electronic image conversion, audit, and database monitoring services. The company sells its solutions and services through direct sales force and reseller partnerships. Streamline Health Solutions, Inc. was founded in 1989 and is headquartered in Alpharetta, Georgia."
STRO,2016-12-31,NA,1702000,NA,1702000,14817000,16181000,1364000,1364000,-700000,0,59731000,58367000,43550000,338000,NA,-19688000,-19688000,NA,income_statement,Biotechnology,"Sutro Biopharma, Inc.","Sutro Biopharma, Inc. operates as clinical stage drug discovery, development, and manufacturing company. It focuses on creating protein therapeutics for cancer and autoimmune disorders through integrated cell-free protein synthesis and site-specific conjugation platform, XpressCF. The company's product candidates include STRO-001, an antibody-drug conjugate (ADC) directed against the cancer target CD74 for patients with multiple myeloma and non-Hodgkin lymphoma; and STRO-002, an ADC directed against folate receptor-alpha for patients with ovarian and endometrial cancers. It has collaboration and license agreement with Celgene Corporation to discover and develop bispecific antibodies and/or ADCs focused primarily on the field of immuno-oncology. The company was formerly known as Fundamental Applied Biology, Inc. Sutro Biopharma, Inc. was incorporated in 2003 and is headquartered in South San Francisco, California."
STRO,2017-12-31,NA,-19688000,NA,-19688000,16374000,-156000,-16639000,-16639000,-700000,0,51741000,68380000,51897000,-3049000,NA,-19688000,-19688000,NA,income_statement,Biotechnology,"Sutro Biopharma, Inc.","Sutro Biopharma, Inc. operates as clinical stage drug discovery, development, and manufacturing company. It focuses on creating protein therapeutics for cancer and autoimmune disorders through integrated cell-free protein synthesis and site-specific conjugation platform, XpressCF. The company's product candidates include STRO-001, an antibody-drug conjugate (ADC) directed against the cancer target CD74 for patients with multiple myeloma and non-Hodgkin lymphoma; and STRO-002, an ADC directed against folate receptor-alpha for patients with ovarian and endometrial cancers. It has collaboration and license agreement with Celgene Corporation to discover and develop bispecific antibodies and/or ADCs focused primarily on the field of immuno-oncology. The company was formerly known as Fundamental Applied Biology, Inc. Sutro Biopharma, Inc. was incorporated in 2003 and is headquartered in South San Francisco, California."
STRO,2018-12-31,NA,-35317000,NA,-35317000,21380000,-15843000,-37356000,-37356000,-1800000,0,38419000,75775000,54262000,2039000,NA,-35317000,-35317000,NA,income_statement,Biotechnology,"Sutro Biopharma, Inc.","Sutro Biopharma, Inc. operates as clinical stage drug discovery, development, and manufacturing company. It focuses on creating protein therapeutics for cancer and autoimmune disorders through integrated cell-free protein synthesis and site-specific conjugation platform, XpressCF. The company's product candidates include STRO-001, an antibody-drug conjugate (ADC) directed against the cancer target CD74 for patients with multiple myeloma and non-Hodgkin lymphoma; and STRO-002, an ADC directed against folate receptor-alpha for patients with ovarian and endometrial cancers. It has collaboration and license agreement with Celgene Corporation to discover and develop bispecific antibodies and/or ADCs focused primarily on the field of immuno-oncology. The company was formerly known as Fundamental Applied Biology, Inc. Sutro Biopharma, Inc. was incorporated in 2003 and is headquartered in South San Francisco, California."
STRO,2019-12-31,NA,-55744000,NA,-55744000,32592000,-22876000,-55621000,-55621000,-4400000,0,42736000,98357000,65612000,-123000,NA,-55744000,-55744000,NA,income_statement,Biotechnology,"Sutro Biopharma, Inc.","Sutro Biopharma, Inc. operates as clinical stage drug discovery, development, and manufacturing company. It focuses on creating protein therapeutics for cancer and autoimmune disorders through integrated cell-free protein synthesis and site-specific conjugation platform, XpressCF. The company's product candidates include STRO-001, an antibody-drug conjugate (ADC) directed against the cancer target CD74 for patients with multiple myeloma and non-Hodgkin lymphoma; and STRO-002, an ADC directed against folate receptor-alpha for patients with ovarian and endometrial cancers. It has collaboration and license agreement with Celgene Corporation to discover and develop bispecific antibodies and/or ADCs focused primarily on the field of immuno-oncology. The company was formerly known as Fundamental Applied Biology, Inc. Sutro Biopharma, Inc. was incorporated in 2003 and is headquartered in South San Francisco, California."
STRR,2016-12-31,NA,1885000,NA,14302000,28180000,35773000,5280000,5280000,-1412000,-12417000,125467000,120187000,89694000,-3395000,-694000,14302000,14302000,NA,income_statement,Medical Devices,"Star Equity Holdings, Inc.","Star Equity Holdings, Inc. provides healthcare solutions in the United States and internationally. The company offers imaging and monitoring services to healthcare providers; and contract diagnostic imaging, including computerized tomography (CT), magnetic resonance imaging, positron emission tomography (PET), PET/CT, and nuclear medicine and healthcare services to hospitals, integrated delivery networks, and federal institutions on a long-term contract basis, as well as provisional services to institutions that are in transition. It also develops, sells, and maintains solid-state gamma cameras, such as nuclear cardiac imaging systems and general purpose nuclear imaging systems to physician offices and hospitals; and offers camera maintenance contract services. In addition, it manufactures modular housing units, structural wall panels, permanent wood foundation systems, and other engineered wood products; supplies general contractors with building materials; and manages real estate assets and investments. Digirad Corporation was formerly known as Digirad Corporation and changed its name to Star Equity Holdings, Inc. in December 2020. Star Equity Holdings, Inc. was founded in 1985 and is headquartered in Suwanee, Georgia."
STRR,2017-12-31,NA,-7049000,NA,-35730000,23496000,21196000,-3794000,-3794000,-730000,27987000,104632000,108426000,83436000,-3255000,-694000,-35036000,-35730000,NA,income_statement,Medical Devices,"Star Equity Holdings, Inc.","Star Equity Holdings, Inc. provides healthcare solutions in the United States and internationally. The company offers imaging and monitoring services to healthcare providers; and contract diagnostic imaging, including computerized tomography (CT), magnetic resonance imaging, positron emission tomography (PET), PET/CT, and nuclear medicine and healthcare services to hospitals, integrated delivery networks, and federal institutions on a long-term contract basis, as well as provisional services to institutions that are in transition. It also develops, sells, and maintains solid-state gamma cameras, such as nuclear cardiac imaging systems and general purpose nuclear imaging systems to physician offices and hospitals; and offers camera maintenance contract services. In addition, it manufactures modular housing units, structural wall panels, permanent wood foundation systems, and other engineered wood products; supplies general contractors with building materials; and manages real estate assets and investments. Digirad Corporation was formerly known as Digirad Corporation and changed its name to Star Equity Holdings, Inc. in December 2020. Star Equity Holdings, Inc. was founded in 1985 and is headquartered in Suwanee, Georgia."
STRR,2018-12-31,NA,-5400000,NA,736000,20456000,18271000,-3562000,-3562000,-751000,-1561000,104180000,107742000,85909000,-1838000,4575000,-3839000,736000,NA,income_statement,Medical Devices,"Star Equity Holdings, Inc.","Star Equity Holdings, Inc. provides healthcare solutions in the United States and internationally. The company offers imaging and monitoring services to healthcare providers; and contract diagnostic imaging, including computerized tomography (CT), magnetic resonance imaging, positron emission tomography (PET), PET/CT, and nuclear medicine and healthcare services to hospitals, integrated delivery networks, and federal institutions on a long-term contract basis, as well as provisional services to institutions that are in transition. It also develops, sells, and maintains solid-state gamma cameras, such as nuclear cardiac imaging systems and general purpose nuclear imaging systems to physician offices and hospitals; and offers camera maintenance contract services. In addition, it manufactures modular housing units, structural wall panels, permanent wood foundation systems, and other engineered wood products; supplies general contractors with building materials; and manages real estate assets and investments. Digirad Corporation was formerly known as Digirad Corporation and changed its name to Star Equity Holdings, Inc. in December 2020. Star Equity Holdings, Inc. was founded in 1985 and is headquartered in Suwanee, Georgia."
STRR,2019-12-31,NA,-5268000,NA,-4627000,21575000,22115000,-1254000,-1254000,-1156000,-375000,114185000,115439000,92070000,-4014000,266000,-4893000,-5223000,NA,income_statement,Medical Devices,"Star Equity Holdings, Inc.","Star Equity Holdings, Inc. provides healthcare solutions in the United States and internationally. The company offers imaging and monitoring services to healthcare providers; and contract diagnostic imaging, including computerized tomography (CT), magnetic resonance imaging, positron emission tomography (PET), PET/CT, and nuclear medicine and healthcare services to hospitals, integrated delivery networks, and federal institutions on a long-term contract basis, as well as provisional services to institutions that are in transition. It also develops, sells, and maintains solid-state gamma cameras, such as nuclear cardiac imaging systems and general purpose nuclear imaging systems to physician offices and hospitals; and offers camera maintenance contract services. In addition, it manufactures modular housing units, structural wall panels, permanent wood foundation systems, and other engineered wood products; supplies general contractors with building materials; and manages real estate assets and investments. Digirad Corporation was formerly known as Digirad Corporation and changed its name to Star Equity Holdings, Inc. in December 2020. Star Equity Holdings, Inc. was founded in 1985 and is headquartered in Suwanee, Georgia."
STRRP,2016-12-31,NA,1885000,NA,14302000,28180000,35773000,5280000,5280000,-1412000,-12417000,125467000,120187000,89694000,-3395000,-694000,14302000,14302000,NA,income_statement,Medical Devices,"Star Equity Holdings, Inc. - Se","Star Equity Holdings, Inc. provides healthcare solutions in the United States and internationally. The company offers imaging and monitoring services to healthcare providers; and contract diagnostic imaging, including computerized tomography (CT), magnetic resonance imaging, positron emission tomography (PET), PET/CT, and nuclear medicine and healthcare services to hospitals, integrated delivery networks, and federal institutions on a long-term contract basis, as well as provisional services to institutions that are in transition. It also develops, sells, and maintains solid-state gamma cameras, such as nuclear cardiac imaging systems and general purpose nuclear imaging systems to physician offices and hospitals; and offers camera maintenance contract services. In addition, it manufactures modular housing units, structural wall panels, permanent wood foundation systems, and other engineered wood products; supplies general contractors with building materials; and manages real estate assets and investments. Digirad Corporation was formerly known as Digirad Corporation and changed its name to Star Equity Holdings, Inc. in December 2020. Star Equity Holdings, Inc. was founded in 1985 and is headquartered in Suwanee, Georgia."
STRRP,2017-12-31,NA,-7049000,NA,-35730000,23496000,21196000,-3794000,-3794000,-730000,27987000,104632000,108426000,83436000,-3255000,-694000,-35036000,-35730000,NA,income_statement,Medical Devices,"Star Equity Holdings, Inc. - Se","Star Equity Holdings, Inc. provides healthcare solutions in the United States and internationally. The company offers imaging and monitoring services to healthcare providers; and contract diagnostic imaging, including computerized tomography (CT), magnetic resonance imaging, positron emission tomography (PET), PET/CT, and nuclear medicine and healthcare services to hospitals, integrated delivery networks, and federal institutions on a long-term contract basis, as well as provisional services to institutions that are in transition. It also develops, sells, and maintains solid-state gamma cameras, such as nuclear cardiac imaging systems and general purpose nuclear imaging systems to physician offices and hospitals; and offers camera maintenance contract services. In addition, it manufactures modular housing units, structural wall panels, permanent wood foundation systems, and other engineered wood products; supplies general contractors with building materials; and manages real estate assets and investments. Digirad Corporation was formerly known as Digirad Corporation and changed its name to Star Equity Holdings, Inc. in December 2020. Star Equity Holdings, Inc. was founded in 1985 and is headquartered in Suwanee, Georgia."
STRRP,2018-12-31,NA,-5400000,NA,736000,20456000,18271000,-3562000,-3562000,-751000,-1561000,104180000,107742000,85909000,-1838000,4575000,-3839000,736000,NA,income_statement,Medical Devices,"Star Equity Holdings, Inc. - Se","Star Equity Holdings, Inc. provides healthcare solutions in the United States and internationally. The company offers imaging and monitoring services to healthcare providers; and contract diagnostic imaging, including computerized tomography (CT), magnetic resonance imaging, positron emission tomography (PET), PET/CT, and nuclear medicine and healthcare services to hospitals, integrated delivery networks, and federal institutions on a long-term contract basis, as well as provisional services to institutions that are in transition. It also develops, sells, and maintains solid-state gamma cameras, such as nuclear cardiac imaging systems and general purpose nuclear imaging systems to physician offices and hospitals; and offers camera maintenance contract services. In addition, it manufactures modular housing units, structural wall panels, permanent wood foundation systems, and other engineered wood products; supplies general contractors with building materials; and manages real estate assets and investments. Digirad Corporation was formerly known as Digirad Corporation and changed its name to Star Equity Holdings, Inc. in December 2020. Star Equity Holdings, Inc. was founded in 1985 and is headquartered in Suwanee, Georgia."
STRRP,2019-12-31,NA,-5268000,NA,-4627000,21575000,22115000,-1254000,-1254000,-1156000,-375000,114185000,115439000,92070000,-4014000,266000,-4893000,-5223000,NA,income_statement,Medical Devices,"Star Equity Holdings, Inc. - Se","Star Equity Holdings, Inc. provides healthcare solutions in the United States and internationally. The company offers imaging and monitoring services to healthcare providers; and contract diagnostic imaging, including computerized tomography (CT), magnetic resonance imaging, positron emission tomography (PET), PET/CT, and nuclear medicine and healthcare services to hospitals, integrated delivery networks, and federal institutions on a long-term contract basis, as well as provisional services to institutions that are in transition. It also develops, sells, and maintains solid-state gamma cameras, such as nuclear cardiac imaging systems and general purpose nuclear imaging systems to physician offices and hospitals; and offers camera maintenance contract services. In addition, it manufactures modular housing units, structural wall panels, permanent wood foundation systems, and other engineered wood products; supplies general contractors with building materials; and manages real estate assets and investments. Digirad Corporation was formerly known as Digirad Corporation and changed its name to Star Equity Holdings, Inc. in December 2020. Star Equity Holdings, Inc. was founded in 1985 and is headquartered in Suwanee, Georgia."
STRS,2016-12-31,NA,-8778000,75000,-5999000,12164000,21423000,1177000,1177000,-9190000,-2779000,80341000,79164000,58918000,-9955000,1361000,-5999000,-5999000,NA,income_statement,Real Estate—Diversified,Stratus Properties Inc.,"Stratus Properties Inc., a real estate company, engages in the acquisition, entitlement, development, management, operation, and sale of commercial, and multi-and single-family residential real estate properties primarily in Austin, Texas. The company operates through two segments, Real Estate Operations and Leasing Operations. Its leasing operations cover lease of space at retail and mixed-use properties; and residences in multi-family apartment complexes. Stratus Properties Inc. was founded in 1992 and is headquartered in Austin, Texas."
STRS,2017-12-31,NA,17788000,80000,3879000,11401000,19566000,312000,312000,-6449000,13904000,80340000,80028000,60774000,17476000,1361000,3884000,3879000,NA,income_statement,Real Estate—Diversified,Stratus Properties Inc.,"Stratus Properties Inc., a real estate company, engages in the acquisition, entitlement, development, management, operation, and sale of commercial, and multi-and single-family residential real estate properties primarily in Austin, Texas. The company operates through two segments, Real Estate Operations and Leasing Operations. Its leasing operations cover lease of space at retail and mixed-use properties; and residences in multi-family apartment complexes. Stratus Properties Inc. was founded in 1992 and is headquartered in Austin, Texas."
STRS,2018-12-31,NA,-6042000,22665000,-3982000,10314000,5901000,-7237000,-7237000,-11000,-695000,24989000,32226000,19088000,1195000,1361000,-5347000,-3982000,NA,income_statement,Real Estate—Diversified,Stratus Properties Inc.,"Stratus Properties Inc., a real estate company, engages in the acquisition, entitlement, development, management, operation, and sale of commercial, and multi-and single-family residential real estate properties primarily in Austin, Texas. The company operates through two segments, Real Estate Operations and Leasing Operations. Its leasing operations cover lease of space at retail and mixed-use properties; and residences in multi-family apartment complexes. Stratus Properties Inc. was founded in 1992 and is headquartered in Austin, Texas."
STRS,2019-12-31,NA,-3062000,12983000,-2464000,11344000,12468000,-4467000,-4467000,-4436000,-275000,30003000,34470000,17535000,1405000,320000,-2787000,-2464000,NA,income_statement,Real Estate—Diversified,Stratus Properties Inc.,"Stratus Properties Inc., a real estate company, engages in the acquisition, entitlement, development, management, operation, and sale of commercial, and multi-and single-family residential real estate properties primarily in Austin, Texas. The company operates through two segments, Real Estate Operations and Leasing Operations. Its leasing operations cover lease of space at retail and mixed-use properties; and residences in multi-family apartment complexes. Stratus Properties Inc. was founded in 1992 and is headquartered in Austin, Texas."
STRT,2017-07-02,NA,16394000,21626000,7197000,47253000,60955000,13702000,13702000,-417000,4284000,417325000,403623000,356370000,2692000,NA,12110000,7196000,NA,income_statement,Auto Parts,STRATTEC SECURITY CORPORATION,"Strattec Security Corporation designs, develops, manufactures, and markets automotive access control products under the VAST Automotive Group brand primarily in North America. The company offers mechanical and electronically enhanced locks and keys, passive entry passive start systems, steering column and instrument panel ignition lock housings, latches, power sliding side door systems, power tailgate and lift gate systems, power deck lid systems, door handles, and related products. It also provides full service and aftermarket support services for its products. The company markets its products to automotive and light truck original equipment manufacturers, as well as other transportation-related manufacturers; and through wholesale distributors, other marketers, and users of component parts, as well as certain products to non-automotive commercial customers. It also exports its products to Europe, Asia, and South America. Strattec Security Corporation was founded in 1908 and is headquartered in Milwaukee, Wisconsin."
STRT,2018-07-01,NA,17698000,21088000,12283000,40721000,54443000,13722000,13722000,-1137000,2070000,439195000,425473000,384752000,3976000,NA,15628000,12283000,NA,income_statement,Auto Parts,STRATTEC SECURITY CORPORATION,"Strattec Security Corporation designs, develops, manufactures, and markets automotive access control products under the VAST Automotive Group brand primarily in North America. The company offers mechanical and electronically enhanced locks and keys, passive entry passive start systems, steering column and instrument panel ignition lock housings, latches, power sliding side door systems, power tailgate and lift gate systems, power deck lid systems, door handles, and related products. It also provides full service and aftermarket support services for its products. The company markets its products to automotive and light truck original equipment manufacturers, as well as other transportation-related manufacturers; and through wholesale distributors, other marketers, and users of component parts, as well as certain products to non-automotive commercial customers. It also exports its products to Europe, Asia, and South America. Strattec Security Corporation was founded in 1908 and is headquartered in Milwaukee, Wisconsin."
STRT,2019-06-30,NA,-20433000,24428000,-17029000,47875000,57800000,9925000,9925000,-1615000,-7740000,487006000,477081000,429206000,-30358000,NA,-12693000,-17029000,NA,income_statement,Auto Parts,STRATTEC SECURITY CORPORATION,"Strattec Security Corporation designs, develops, manufactures, and markets automotive access control products under the VAST Automotive Group brand primarily in North America. The company offers mechanical and electronically enhanced locks and keys, passive entry passive start systems, steering column and instrument panel ignition lock housings, latches, power sliding side door systems, power tailgate and lift gate systems, power deck lid systems, door handles, and related products. It also provides full service and aftermarket support services for its products. The company markets its products to automotive and light truck original equipment manufacturers, as well as other transportation-related manufacturers; and through wholesale distributors, other marketers, and users of component parts, as well as certain products to non-automotive commercial customers. It also exports its products to Europe, Asia, and South America. Strattec Security Corporation was founded in 1908 and is headquartered in Milwaukee, Wisconsin."
STRT,2020-06-28,NA,-8123000,23219000,-7605000,44577000,35446000,-9131000,-9131000,-920000,-2266000,385300000,394431000,349854000,1008000,NA,-5857000,-7605000,NA,income_statement,Auto Parts,STRATTEC SECURITY CORPORATION,"Strattec Security Corporation designs, develops, manufactures, and markets automotive access control products under the VAST Automotive Group brand primarily in North America. The company offers mechanical and electronically enhanced locks and keys, passive entry passive start systems, steering column and instrument panel ignition lock housings, latches, power sliding side door systems, power tailgate and lift gate systems, power deck lid systems, door handles, and related products. It also provides full service and aftermarket support services for its products. The company markets its products to automotive and light truck original equipment manufacturers, as well as other transportation-related manufacturers; and through wholesale distributors, other marketers, and users of component parts, as well as certain products to non-automotive commercial customers. It also exports its products to Europe, Asia, and South America. Strattec Security Corporation was founded in 1908 and is headquartered in Milwaukee, Wisconsin."
STSA,2017-12-31,4193000,-5172000,NA,-5172000,754000,0,-4947000,-4947000,-15000,0,0,4947000,0,-225000,NA,-5172000,-5172000,NA,income_statement,Biotechnology,"Satsuma Pharmaceuticals, Inc.","Satsuma Pharmaceuticals, Inc., a clinical-stage biopharmaceutical company, develops a novel therapeutic product for the acute treatment of migraine. Its lead product candidate is STS101, a drug-device combination of a proprietary dry-powder formulation of dihydroergotamine mesylate, which is in Phase III clinical trials and can be self-administered with a proprietary pre-filled, single-use, and nasal delivery device. The company was founded in 2016 and is headquartered in South San Francisco, California."
STSA,2018-12-31,6433000,-7346000,NA,-7346000,1082000,0,-7515000,-7515000,-90000,0,0,7515000,0,169000,NA,-7346000,-7346000,NA,income_statement,Biotechnology,"Satsuma Pharmaceuticals, Inc.","Satsuma Pharmaceuticals, Inc., a clinical-stage biopharmaceutical company, develops a novel therapeutic product for the acute treatment of migraine. Its lead product candidate is STS101, a drug-device combination of a proprietary dry-powder formulation of dihydroergotamine mesylate, which is in Phase III clinical trials and can be self-administered with a proprietary pre-filled, single-use, and nasal delivery device. The company was founded in 2016 and is headquartered in South San Francisco, California."
STSA,2019-12-31,24196000,-28175000,NA,-28175000,4685000,0,-28881000,-28881000,-482000,0,0,28881000,0,706000,NA,-28175000,-28175000,NA,income_statement,Biotechnology,"Satsuma Pharmaceuticals, Inc.","Satsuma Pharmaceuticals, Inc., a clinical-stage biopharmaceutical company, develops a novel therapeutic product for the acute treatment of migraine. Its lead product candidate is STS101, a drug-device combination of a proprietary dry-powder formulation of dihydroergotamine mesylate, which is in Phase III clinical trials and can be self-administered with a proprietary pre-filled, single-use, and nasal delivery device. The company was founded in 2016 and is headquartered in South San Francisco, California."
STT,2017-12-31,NA,2995000000,NA,2156000000,6089000000,11264000000,0,3475000000,NA,839000000,11264000000,7789000000,0,-480000000,NA,2156000000,1972000000,1700000000,income_statement,NA,NA,NA
STT,2018-12-31,NA,3101000000,NA,2593000000,6419000000,12116000000,0,3651000000,NA,508000000,12116000000,8465000000,0,-550000000,NA,2593000000,2404000000,2046000000,income_statement,NA,NA,NA
STT,2019-12-31,NA,2712000000,NA,2242000000,6480000000,11702000000,0,3091000000,NA,470000000,11702000000,8611000000,0,-379000000,NA,2242000000,2009000000,2131000000,income_statement,NA,NA,NA
STT,2020-12-31,NA,2899000000,NA,2420000000,6356000000,11615000000,0,3316000000,NA,479000000,11615000000,8299000000,0,-417000000,NA,2420000000,2257000000,1943000000,income_statement,NA,NA,NA
STTK,2018-12-31,NA,-7388000,NA,-7388000,3783000,-2365000,-6148000,-6148000,-2631000,0,22442000,28590000,24807000,-1240000,NA,-7388000,-7388000,NA,income_statement,Biotechnology,"Shattuck Labs, Inc.","Shattuck Labs, Inc., a clinical-stage biotechnology company, develops therapeutics for the treatment of cancer and autoimmune disease in the United States. The company's lead product candidate is SL-172154, which is in Phase 1 clinical trial for the treatment of ovarian cancer. It also holds a collaboration agreement with Takeda Pharmaceuticals to develop SL-279252 that is in Phase 1 clinical trial in patients with advanced solid tumors and lymphoma. The company was founded in 2016 and is headquartered in Austin, Texas."
STTK,2019-12-31,NA,-23982000,NA,-23982000,5736000,-19331000,-25067000,-25067000,NA,0,9887000,34954000,29218000,1085000,NA,-23982000,-23982000,NA,income_statement,Biotechnology,"Shattuck Labs, Inc.","Shattuck Labs, Inc., a clinical-stage biotechnology company, develops therapeutics for the treatment of cancer and autoimmune disease in the United States. The company's lead product candidate is SL-172154, which is in Phase 1 clinical trial for the treatment of ovarian cancer. It also holds a collaboration agreement with Takeda Pharmaceuticals to develop SL-279252 that is in Phase 1 clinical trial in patients with advanced solid tumors and lymphoma. The company was founded in 2016 and is headquartered in Austin, Texas."
STX,2017-06-30,1232000000,815000000,NA,772000000,606000000,3174000000,1232000000,1232000000,-222000000,43000000,10771000000,9539000000,7597000000,-417000000,NA,772000000,772000000,NA,income_statement,NA,NA,NA
STX,2018-06-29,1022000000,1418000000,NA,1182000000,560000000,3365000000,1730000000,1730000000,-236000000,236000000,11184000000,9454000000,7819000000,-312000000,NA,1182000000,1182000000,NA,income_statement,NA,NA,NA
STX,2019-06-28,991000000,1372000000,NA,2012000000,453000000,2932000000,1465000000,1465000000,-224000000,-640000000,10390000000,8925000000,7458000000,-93000000,NA,2012000000,2012000000,NA,income_statement,NA,NA,NA
STX,2020-07-03,973000000,1032000000,NA,1004000000,473000000,2845000000,1385000000,1385000000,-201000000,28000000,10509000000,9124000000,7664000000,-353000000,NA,1004000000,1004000000,NA,income_statement,NA,NA,NA
STXB,2016-12-31,NA,5324000,NA,3715000,30636000,40205000,0,6737000,NA,1609000,40205000,33468000,0,-1413000,NA,3715000,3628000,2832000,income_statement,Banks—Regional,"Spirit of Texas Bancshares, Inc","Spirit of Texas Bancshares, Inc. operates as the holding company for Spirit of Texas Bank SSB that provides various commercial and retail banking services. It offers checking, money market, savings, and individual retirement accounts, as well as various certificates of deposit. The company also provides commercial and industrial loans; 1-4 single family residential real estate loans; construction, land, and development loans; commercial real estate loans, such as owner and nonowner-occupied commercial real estate loans, other commercial real estate loans, and multifamily loans and farmland; consumer loans and leases; and municipal and other loans. In addition, it offers a range of ancillary banking services, including treasury management, wire transfer, ATM access, and co-branded credit card services; consumer and commercial online banking services; merchant services, including credit card processing; and mobile applications, safe deposit boxes, and debit and credit cards. Further, the company invests in U.S. Treasury bills and notes, as well as in securities of federally sponsored agencies, such as Federal Home Loan Bank bonds. As of April 16, 2020, it operated through a network of 41 full-service branches located in the Houston, Dallas/Fort Worth, Austin, Bryan/College Station, San Antonio-New Braunfels, Corpus Christi, and Tyler metropolitan areas, as well as offices in North Central Texas. The company serves individuals, professionals, small and medium-sized businesses, and commercial companies. Spirit of Texas Bancshares, Inc. was founded in 2008 and is headquartered in Conroe, Texas."
STXB,2017-12-31,NA,8340000,NA,4753000,33111000,45742000,0,9967000,NA,3587000,45742000,35775000,0,-1627000,NA,4753000,4730000,2664000,income_statement,Banks—Regional,"Spirit of Texas Bancshares, Inc","Spirit of Texas Bancshares, Inc. operates as the holding company for Spirit of Texas Bank SSB that provides various commercial and retail banking services. It offers checking, money market, savings, and individual retirement accounts, as well as various certificates of deposit. The company also provides commercial and industrial loans; 1-4 single family residential real estate loans; construction, land, and development loans; commercial real estate loans, such as owner and nonowner-occupied commercial real estate loans, other commercial real estate loans, and multifamily loans and farmland; consumer loans and leases; and municipal and other loans. In addition, it offers a range of ancillary banking services, including treasury management, wire transfer, ATM access, and co-branded credit card services; consumer and commercial online banking services; merchant services, including credit card processing; and mobile applications, safe deposit boxes, and debit and credit cards. Further, the company invests in U.S. Treasury bills and notes, as well as in securities of federally sponsored agencies, such as Federal Home Loan Bank bonds. As of April 16, 2020, it operated through a network of 41 full-service branches located in the Houston, Dallas/Fort Worth, Austin, Bryan/College Station, San Antonio-New Braunfels, Corpus Christi, and Tyler metropolitan areas, as well as offices in North Central Texas. The company serves individuals, professionals, small and medium-sized businesses, and commercial companies. Spirit of Texas Bancshares, Inc. was founded in 2008 and is headquartered in Conroe, Texas."
STXB,2018-12-31,NA,11980000,NA,9978000,38361000,55344000,0,13991000,NA,2002000,55344000,41353000,0,-2011000,NA,9978000,9978000,2992000,income_statement,Banks—Regional,"Spirit of Texas Bancshares, Inc","Spirit of Texas Bancshares, Inc. operates as the holding company for Spirit of Texas Bank SSB that provides various commercial and retail banking services. It offers checking, money market, savings, and individual retirement accounts, as well as various certificates of deposit. The company also provides commercial and industrial loans; 1-4 single family residential real estate loans; construction, land, and development loans; commercial real estate loans, such as owner and nonowner-occupied commercial real estate loans, other commercial real estate loans, and multifamily loans and farmland; consumer loans and leases; and municipal and other loans. In addition, it offers a range of ancillary banking services, including treasury management, wire transfer, ATM access, and co-branded credit card services; consumer and commercial online banking services; merchant services, including credit card processing; and mobile applications, safe deposit boxes, and debit and credit cards. Further, the company invests in U.S. Treasury bills and notes, as well as in securities of federally sponsored agencies, such as Federal Home Loan Bank bonds. As of April 16, 2020, it operated through a network of 41 full-service branches located in the Houston, Dallas/Fort Worth, Austin, Bryan/College Station, San Antonio-New Braunfels, Corpus Christi, and Tyler metropolitan areas, as well as offices in North Central Texas. The company serves individuals, professionals, small and medium-sized businesses, and commercial companies. Spirit of Texas Bancshares, Inc. was founded in 2008 and is headquartered in Conroe, Texas."
STXB,2019-12-31,NA,26557000,NA,21136000,52303000,89601000,0,30609000,NA,5421000,89601000,58992000,0,-4052000,NA,21136000,21136000,6689000,income_statement,Banks—Regional,"Spirit of Texas Bancshares, Inc","Spirit of Texas Bancshares, Inc. operates as the holding company for Spirit of Texas Bank SSB that provides various commercial and retail banking services. It offers checking, money market, savings, and individual retirement accounts, as well as various certificates of deposit. The company also provides commercial and industrial loans; 1-4 single family residential real estate loans; construction, land, and development loans; commercial real estate loans, such as owner and nonowner-occupied commercial real estate loans, other commercial real estate loans, and multifamily loans and farmland; consumer loans and leases; and municipal and other loans. In addition, it offers a range of ancillary banking services, including treasury management, wire transfer, ATM access, and co-branded credit card services; consumer and commercial online banking services; merchant services, including credit card processing; and mobile applications, safe deposit boxes, and debit and credit cards. Further, the company invests in U.S. Treasury bills and notes, as well as in securities of federally sponsored agencies, such as Federal Home Loan Bank bonds. As of April 16, 2020, it operated through a network of 41 full-service branches located in the Houston, Dallas/Fort Worth, Austin, Bryan/College Station, San Antonio-New Braunfels, Corpus Christi, and Tyler metropolitan areas, as well as offices in North Central Texas. The company serves individuals, professionals, small and medium-sized businesses, and commercial companies. Spirit of Texas Bancshares, Inc. was founded in 2008 and is headquartered in Conroe, Texas."
STZ,2017-02-28,NA,2083000000,-6400000,1528600000,1284800000,3539100000,2254300000,2254300000,-333300000,550300000,7321100000,5066800000,3782000000,-171300000,NA,1532700000,1528600000,-10500000,income_statement,NA,NA,NA
STZ,2018-02-28,NA,2338000000,16600000,2303400000,1370800000,3850300000,2490000000,2490000000,-332000000,22700000,7580300000,5090300000,3730000000,-152000000,NA,2315300000,2303400000,-10500000,income_statement,NA,NA,NA
STZ,2019-02-28,NA,4145000000,286200000,3435900000,1482100000,4103400000,2623300000,2623300000,-367100000,685900000,8116000000,5492700000,4012600000,1521700000,NA,3459100000,3435900000,-2000000,income_statement,NA,NA,NA
STZ,2020-02-29,NA,-945200000,342500000,-11800000,1585800000,4285500000,2716600000,2716600000,-428700000,-966600000,8343500000,5626900000,4058000000,-3661800000,NA,21400000,-11800000,-16900000,income_statement,NA,NA,NA
SUMO,2018-01-31,25261000,-32010000,NA,-32435000,52688000,45390000,-32559000,-32559000,-19000,425000,67828000,100387000,22438000,549000,NA,-32435000,-32435000,NA,income_statement,Software—Application,"Sumo Logic, Inc.","Sumo Logic, Inc. provides cloud-native software-as-a-service platform that enables organizations to address the challenges and opportunities presented by digital transformation, modern applications, and cloud computing. Its platform enables organizations to automate the collection, ingestion, and analysis of application, infrastructure, security, and IoT data to derive actionable insights. The company offer a suite of solutions to address areas, such as operational intelligence, security intelligence, business intelligence, and global intelligence. Sumo Logic, Inc. was founded in 2010 and is headquartered in Redwood City, California."
SUMO,2019-01-31,36240000,-47182000,NA,-47789000,86565000,74632000,-48173000,-48173000,-105000,607000,103642000,151815000,29010000,991000,NA,-47789000,-47789000,NA,income_statement,Software—Application,"Sumo Logic, Inc.","Sumo Logic, Inc. provides cloud-native software-as-a-service platform that enables organizations to address the challenges and opportunities presented by digital transformation, modern applications, and cloud computing. Its platform enables organizations to automate the collection, ingestion, and analysis of application, infrastructure, security, and IoT data to derive actionable insights. The company offer a suite of solutions to address areas, such as operational intelligence, security intelligence, business intelligence, and global intelligence. Sumo Logic, Inc. was founded in 2010 and is headquartered in Redwood City, California."
SUMO,2020-01-31,52462000,-91236000,NA,-92137000,141497000,110558000,-83401000,-83401000,-123000,901000,155056000,238457000,44498000,-7835000,NA,-92137000,-92137000,NA,income_statement,Software—Application,"Sumo Logic, Inc.","Sumo Logic, Inc. provides cloud-native software-as-a-service platform that enables organizations to address the challenges and opportunities presented by digital transformation, modern applications, and cloud computing. Its platform enables organizations to automate the collection, ingestion, and analysis of application, infrastructure, security, and IoT data to derive actionable insights. The company offer a suite of solutions to address areas, such as operational intelligence, security intelligence, business intelligence, and global intelligence. Sumo Logic, Inc. was founded in 2010 and is headquartered in Redwood City, California."
SUMR,2016-12-31,NA,-5496000,NA,-4322000,54164000,61751000,2917000,2917000,-2682000,-1174000,194328000,191411000,132577000,-8413000,NA,-4322000,-4322000,NA,income_statement,Household & Personal Products,"Summer Infant, Inc.","Summer Infant, Inc., together with its subsidiaries, designs, markets, and distributes branded juvenile health, safety, and wellness products worldwide. It offers audio and video monitors; and gates, potties, entertainers, baby monitors, bath products, specialty blankets, strollers, car seats, and travel systems, as well as baby gear products under the Summer, SwaddleMe, and born free brand names. The company sells its products directly to retailers through own direct sales force and a network of independent manufacturers' representatives and distributors; and through partner's Websites and its summerinfant.com Website, as well as indirectly through international distributors, representatives, and retail customers. Summer Infant, Inc. was founded in 1985 and is headquartered in Woonsocket, Rhode Island."
SUMR,2017-12-30,NA,-77000,NA,-2249000,53107000,60195000,2891000,2891000,-2968000,2172000,189869000,186978000,129674000,-2968000,NA,-2249000,-2249000,NA,income_statement,Household & Personal Products,"Summer Infant, Inc.","Summer Infant, Inc., together with its subsidiaries, designs, markets, and distributes branded juvenile health, safety, and wellness products worldwide. It offers audio and video monitors; and gates, potties, entertainers, baby monitors, bath products, specialty blankets, strollers, car seats, and travel systems, as well as baby gear products under the Summer, SwaddleMe, and born free brand names. The company sells its products directly to retailers through own direct sales force and a network of independent manufacturers' representatives and distributors; and through partner's Websites and its summerinfant.com Website, as well as indirectly through international distributors, representatives, and retail customers. Summer Infant, Inc. was founded in 1985 and is headquartered in Woonsocket, Rhode Island."
SUMR,2018-12-29,NA,-4815000,NA,-4251000,51310000,55119000,-373000,-373000,-3924000,-564000,173619000,173992000,118500000,-4442000,NA,-4251000,-4251000,NA,income_statement,Household & Personal Products,"Summer Infant, Inc.","Summer Infant, Inc., together with its subsidiaries, designs, markets, and distributes branded juvenile health, safety, and wellness products worldwide. It offers audio and video monitors; and gates, potties, entertainers, baby monitors, bath products, specialty blankets, strollers, car seats, and travel systems, as well as baby gear products under the Summer, SwaddleMe, and born free brand names. The company sells its products directly to retailers through own direct sales force and a network of independent manufacturers' representatives and distributors; and through partner's Websites and its summerinfant.com Website, as well as indirectly through international distributors, representatives, and retail customers. Summer Infant, Inc. was founded in 1985 and is headquartered in Woonsocket, Rhode Island."
SUMR,2019-12-28,NA,-3069000,NA,-4164000,49363000,54885000,1802000,1802000,-4871000,1095000,173181000,171379000,118296000,-4871000,NA,-4164000,-4164000,NA,income_statement,Household & Personal Products,"Summer Infant, Inc.","Summer Infant, Inc., together with its subsidiaries, designs, markets, and distributes branded juvenile health, safety, and wellness products worldwide. It offers audio and video monitors; and gates, potties, entertainers, baby monitors, bath products, specialty blankets, strollers, car seats, and travel systems, as well as baby gear products under the Summer, SwaddleMe, and born free brand names. The company sells its products directly to retailers through own direct sales force and a network of independent manufacturers' representatives and distributors; and through partner's Websites and its summerinfant.com Website, as well as indirectly through international distributors, representatives, and retail customers. Summer Infant, Inc. was founded in 1985 and is headquartered in Woonsocket, Rhode Island."
SUNS,2016-12-31,NA,24252000,NA,24252000,5599000,27196000,21597000,21597000,-3281000,0,27196000,5599000,0,2655000,NA,24252000,24252000,NA,income_statement,Asset Management,Solar Senior Capital Ltd.,"Solar Senior Capital Ltd. is a business development company specializing in investments in leveraged, middle-market companies in the United States. The fund invests in the form of senior secured loans, including first lien, unitranche, and second lien debt instruments. It does not invest in start-up companies or companies having speculative business plans. The fund prefers debt investments between $5 million and $30 million in companies with EBITDA between $20 million and $60 million."
SUNS,2017-12-31,NA,23386000,NA,23386000,5715000,32167000,26452000,26452000,-3848000,0,32167000,5715000,0,-3066000,NA,23386000,23386000,NA,income_statement,Asset Management,Solar Senior Capital Ltd.,"Solar Senior Capital Ltd. is a business development company specializing in investments in leveraged, middle-market companies in the United States. The fund invests in the form of senior secured loans, including first lien, unitranche, and second lien debt instruments. It does not invest in start-up companies or companies having speculative business plans. The fund prefers debt investments between $5 million and $30 million in companies with EBITDA between $20 million and $60 million."
SUNS,2018-12-31,NA,13813000,NA,13813000,9381000,39809000,30428000,30428000,-7808000,0,39809000,9381000,0,-16615000,NA,13813000,13813000,NA,income_statement,Asset Management,Solar Senior Capital Ltd.,"Solar Senior Capital Ltd. is a business development company specializing in investments in leveraged, middle-market companies in the United States. The fund invests in the form of senior secured loans, including first lien, unitranche, and second lien debt instruments. It does not invest in start-up companies or companies having speculative business plans. The fund prefers debt investments between $5 million and $30 million in companies with EBITDA between $20 million and $60 million."
SUNS,2019-12-31,NA,22944000,NA,22944000,6732000,40091000,33359000,33359000,-10738000,0,40091000,6732000,0,-10415000,NA,22944000,22944000,NA,income_statement,Asset Management,Solar Senior Capital Ltd.,"Solar Senior Capital Ltd. is a business development company specializing in investments in leveraged, middle-market companies in the United States. The fund invests in the form of senior secured loans, including first lien, unitranche, and second lien debt instruments. It does not invest in start-up companies or companies having speculative business plans. The fund prefers debt investments between $5 million and $30 million in companies with EBITDA between $20 million and $60 million."
SUNW,2016-12-31,NA,-9380000,NA,-9380000,23764000,22110000,-8018000,-8018000,-1033000,0,86421000,94439000,64311000,-1362000,NA,-9380000,-9380000,NA,income_statement,Solar,"Sunworks, Inc.","Sunworks, Inc., through its subsidiaries, provides photovoltaic based power systems for the agricultural, commercial, industrial, public works, and residential markets in California, Massachusetts, Nevada, Oregon, New Jersey, and Washington. The company also designs, finances, integrates, installs, and manages systems ranging in size from 2 kilowatt for residential loads to multi megawatt systems for larger projects. In addition, it offers a range of installation services, including design, system engineering, procurement, permitting, construction, grid connection, warranty, system monitoring, and maintenance services to its solar energy customers. The company was formerly known as Solar3D, Inc. and changed its name to Sunworks, Inc. in March 2016. Sunworks, Inc. was founded in 2002 and is headquartered in Roseville, California."
SUNW,2017-12-31,NA,-7222000,NA,-7222000,18408000,13663000,-6314000,-6314000,-924000,0,77448000,83762000,63785000,-908000,NA,-7222000,-7222000,NA,income_statement,Solar,"Sunworks, Inc.","Sunworks, Inc., through its subsidiaries, provides photovoltaic based power systems for the agricultural, commercial, industrial, public works, and residential markets in California, Massachusetts, Nevada, Oregon, New Jersey, and Washington. The company also designs, finances, integrates, installs, and manages systems ranging in size from 2 kilowatt for residential loads to multi megawatt systems for larger projects. In addition, it offers a range of installation services, including design, system engineering, procurement, permitting, construction, grid connection, warranty, system monitoring, and maintenance services to its solar energy customers. The company was formerly known as Solar3D, Inc. and changed its name to Sunworks, Inc. in March 2016. Sunworks, Inc. was founded in 2002 and is headquartered in Roseville, California."
SUNW,2018-12-31,NA,-5740000,NA,-5740000,13825000,12264000,-3258000,-3258000,-544000,0,70965000,74223000,58701000,-2482000,NA,-5740000,-5740000,NA,income_statement,Solar,"Sunworks, Inc.","Sunworks, Inc., through its subsidiaries, provides photovoltaic based power systems for the agricultural, commercial, industrial, public works, and residential markets in California, Massachusetts, Nevada, Oregon, New Jersey, and Washington. The company also designs, finances, integrates, installs, and manages systems ranging in size from 2 kilowatt for residential loads to multi megawatt systems for larger projects. In addition, it offers a range of installation services, including design, system engineering, procurement, permitting, construction, grid connection, warranty, system monitoring, and maintenance services to its solar energy customers. The company was formerly known as Solar3D, Inc. and changed its name to Sunworks, Inc. in March 2016. Sunworks, Inc. was founded in 2002 and is headquartered in Roseville, California."
SUNW,2019-12-31,NA,-9186000,NA,-9186000,14205000,6663000,-8329000,-8329000,-863000,0,59830000,68159000,53167000,-857000,NA,-9186000,-9186000,NA,income_statement,Solar,"Sunworks, Inc.","Sunworks, Inc., through its subsidiaries, provides photovoltaic based power systems for the agricultural, commercial, industrial, public works, and residential markets in California, Massachusetts, Nevada, Oregon, New Jersey, and Washington. The company also designs, finances, integrates, installs, and manages systems ranging in size from 2 kilowatt for residential loads to multi megawatt systems for larger projects. In addition, it offers a range of installation services, including design, system engineering, procurement, permitting, construction, grid connection, warranty, system monitoring, and maintenance services to its solar energy customers. The company was formerly known as Solar3D, Inc. and changed its name to Sunworks, Inc. in March 2016. Sunworks, Inc. was founded in 2002 and is headquartered in Roseville, California."
SUPN,2016-12-31,42791000,50369000,NA,91221000,106010000,203017000,54216000,54216000,-5091000,-40852000,215003000,160787000,11986000,-3847000,NA,91221000,91221000,NA,income_statement,Drug Manufacturers—Specialty & Generic,"Supernus Pharmaceuticals, Inc.","Supernus Pharmaceuticals, Inc., a pharmaceutical company, focuses on the development and commercialization of products for the treatment of central nervous system diseases in neurology and psychiatry in the United States. The company offers Oxtellar XR, an extended release oxcarbazepine for the monotherapy treatment of partial onset epilepsy seizures in adults and in children 6 to 17 years of age; and Trokendi XR, an extended release topiramate, which is used for the prophylaxis of migraine headache, as well as for the treatment of epilepsy. Its product candidates comprise SPN-812, a viloxazine hydrochloride, which has completed phase III clinical trial that is used for the treatment of attention deficit hyperactivity disorder (ADHD); SPN-809, a viloxazine hydrochloride, which is in phase II ready clinical trial for the treatment of depression; SPN-604 extended release oxcarbazepine, which is in phase III clinical trial for the treatment of bipolar disorder; and SPN-817 that is in phase I clinical trial to treat severe pediatric epilepsy disorders. The company markets its products through pharmaceutical wholesalers and distributors. It has a development and option agreement with Navitor Pharmaceuticals, Inc. to conduct a phase II clinical program for NV-5138 in treatment-resistant depression. Supernus Pharmaceuticals, Inc. was founded in 2005 and is headquartered in Rockville, Maryland."
SUPN,2017-12-31,49577000,100618000,NA,57284000,137905000,287023000,99541000,99541000,-1568000,43334000,302238000,202697000,15215000,1077000,NA,57284000,57284000,NA,income_statement,Drug Manufacturers—Specialty & Generic,"Supernus Pharmaceuticals, Inc.","Supernus Pharmaceuticals, Inc., a pharmaceutical company, focuses on the development and commercialization of products for the treatment of central nervous system diseases in neurology and psychiatry in the United States. The company offers Oxtellar XR, an extended release oxcarbazepine for the monotherapy treatment of partial onset epilepsy seizures in adults and in children 6 to 17 years of age; and Trokendi XR, an extended release topiramate, which is used for the prophylaxis of migraine headache, as well as for the treatment of epilepsy. Its product candidates comprise SPN-812, a viloxazine hydrochloride, which has completed phase III clinical trial that is used for the treatment of attention deficit hyperactivity disorder (ADHD); SPN-809, a viloxazine hydrochloride, which is in phase II ready clinical trial for the treatment of depression; SPN-604 extended release oxcarbazepine, which is in phase III clinical trial for the treatment of bipolar disorder; and SPN-817 that is in phase I clinical trial to treat severe pediatric epilepsy disorders. The company markets its products through pharmaceutical wholesalers and distributors. It has a development and option agreement with Navitor Pharmaceuticals, Inc. to conduct a phase II clinical program for NV-5138 in treatment-resistant depression. Supernus Pharmaceuticals, Inc. was founded in 2005 and is headquartered in Rockville, Maryland."
SUPN,2018-12-31,75209000,140176000,NA,110993000,159888000,393541000,158444000,158444000,-18111000,29183000,408897000,250453000,15356000,-18268000,NA,110993000,110993000,NA,income_statement,Drug Manufacturers—Specialty & Generic,"Supernus Pharmaceuticals, Inc.","Supernus Pharmaceuticals, Inc., a pharmaceutical company, focuses on the development and commercialization of products for the treatment of central nervous system diseases in neurology and psychiatry in the United States. The company offers Oxtellar XR, an extended release oxcarbazepine for the monotherapy treatment of partial onset epilepsy seizures in adults and in children 6 to 17 years of age; and Trokendi XR, an extended release topiramate, which is used for the prophylaxis of migraine headache, as well as for the treatment of epilepsy. Its product candidates comprise SPN-812, a viloxazine hydrochloride, which has completed phase III clinical trial that is used for the treatment of attention deficit hyperactivity disorder (ADHD); SPN-809, a viloxazine hydrochloride, which is in phase II ready clinical trial for the treatment of depression; SPN-604 extended release oxcarbazepine, which is in phase III clinical trial for the treatment of bipolar disorder; and SPN-817 that is in phase I clinical trial to treat severe pediatric epilepsy disorders. The company markets its products through pharmaceutical wholesalers and distributors. It has a development and option agreement with Navitor Pharmaceuticals, Inc. to conduct a phase II clinical program for NV-5138 in treatment-resistant depression. Supernus Pharmaceuticals, Inc. was founded in 2005 and is headquartered in Rockville, Maryland."
SUPN,2019-12-31,69099000,147487000,NA,113056000,158425000,376095000,148571000,148571000,-22707000,34431000,392755000,244184000,16660000,-1084000,NA,113056000,113056000,NA,income_statement,Drug Manufacturers—Specialty & Generic,"Supernus Pharmaceuticals, Inc.","Supernus Pharmaceuticals, Inc., a pharmaceutical company, focuses on the development and commercialization of products for the treatment of central nervous system diseases in neurology and psychiatry in the United States. The company offers Oxtellar XR, an extended release oxcarbazepine for the monotherapy treatment of partial onset epilepsy seizures in adults and in children 6 to 17 years of age; and Trokendi XR, an extended release topiramate, which is used for the prophylaxis of migraine headache, as well as for the treatment of epilepsy. Its product candidates comprise SPN-812, a viloxazine hydrochloride, which has completed phase III clinical trial that is used for the treatment of attention deficit hyperactivity disorder (ADHD); SPN-809, a viloxazine hydrochloride, which is in phase II ready clinical trial for the treatment of depression; SPN-604 extended release oxcarbazepine, which is in phase III clinical trial for the treatment of bipolar disorder; and SPN-817 that is in phase I clinical trial to treat severe pediatric epilepsy disorders. The company markets its products through pharmaceutical wholesalers and distributors. It has a development and option agreement with Navitor Pharmaceuticals, Inc. to conduct a phase II clinical program for NV-5138 in treatment-resistant depression. Supernus Pharmaceuticals, Inc. was founded in 2005 and is headquartered in Rockville, Maryland."
SURF,2016-12-31,NA,-17453000,NA,-17453000,4144000,-13860000,-18004000,-18004000,NA,0,6632000,24636000,20492000,551000,NA,-17453000,-17494000,NA,income_statement,Biotechnology,"Surface Oncology, Inc.","Surface Oncology, Inc., a clinical-stage immuno-oncology company, engages in the development of cancer therapies. The company develops human immunoglobulin isotype G4 monoclonal antibodies, including SRF231 inhibiting CD47; NZV930 inhibiting CD73; SRF617 inhibiting CD39; SRF388 targeting interleukin 27; and SRF813 targeting CD112R. It also develops various earlier stage programs that targets other critical components of the tumor microenvironment, including regulatory T cells and natural killer cells. The company has a strategic collaboration agreement with Novartis Institutes for Biomedical Research, Inc. for the development of cancer therapies; and the Merck Sharp & Dohme Corp. to evaluate the safety and efficacy of combining Surface's SRF617, an investigational antibody therapy targeting CD39, with Merck's KEYTRUDAÃ (pembrolizumab), the first anti-PD-1 therapy approved in the United States. Surface Oncology, Inc. was founded in 2014 and is headquartered in Cambridge, Massachusetts."
SURF,2017-12-31,NA,-45377000,NA,-45377000,11033000,-34957000,-45990000,-45990000,NA,0,12826000,58816000,47783000,613000,NA,-45377000,-45417000,NA,income_statement,Biotechnology,"Surface Oncology, Inc.","Surface Oncology, Inc., a clinical-stage immuno-oncology company, engages in the development of cancer therapies. The company develops human immunoglobulin isotype G4 monoclonal antibodies, including SRF231 inhibiting CD47; NZV930 inhibiting CD73; SRF617 inhibiting CD39; SRF388 targeting interleukin 27; and SRF813 targeting CD112R. It also develops various earlier stage programs that targets other critical components of the tumor microenvironment, including regulatory T cells and natural killer cells. The company has a strategic collaboration agreement with Novartis Institutes for Biomedical Research, Inc. for the development of cancer therapies; and the Merck Sharp & Dohme Corp. to evaluate the safety and efficacy of combining Surface's SRF617, an investigational antibody therapy targeting CD39, with Merck's KEYTRUDAÃ (pembrolizumab), the first anti-PD-1 therapy approved in the United States. Surface Oncology, Inc. was founded in 2014 and is headquartered in Cambridge, Massachusetts."
SURF,2018-12-31,NA,-6597000,NA,-6597000,16076000,6925000,-9151000,-9151000,NA,0,59417000,68568000,52492000,2554000,NA,-6597000,-6608000,NA,income_statement,Biotechnology,"Surface Oncology, Inc.","Surface Oncology, Inc., a clinical-stage immuno-oncology company, engages in the development of cancer therapies. The company develops human immunoglobulin isotype G4 monoclonal antibodies, including SRF231 inhibiting CD47; NZV930 inhibiting CD73; SRF617 inhibiting CD39; SRF388 targeting interleukin 27; and SRF813 targeting CD112R. It also develops various earlier stage programs that targets other critical components of the tumor microenvironment, including regulatory T cells and natural killer cells. The company has a strategic collaboration agreement with Novartis Institutes for Biomedical Research, Inc. for the development of cancer therapies; and the Merck Sharp & Dohme Corp. to evaluate the safety and efficacy of combining Surface's SRF617, an investigational antibody therapy targeting CD39, with Merck's KEYTRUDAÃ (pembrolizumab), the first anti-PD-1 therapy approved in the United States. Surface Oncology, Inc. was founded in 2014 and is headquartered in Cambridge, Massachusetts."
SURF,2019-12-31,NA,-54789000,NA,-54789000,20608000,-36758000,-57366000,-57366000,NA,0,15360000,72726000,52118000,2577000,NA,-54789000,-54789000,NA,income_statement,Biotechnology,"Surface Oncology, Inc.","Surface Oncology, Inc., a clinical-stage immuno-oncology company, engages in the development of cancer therapies. The company develops human immunoglobulin isotype G4 monoclonal antibodies, including SRF231 inhibiting CD47; NZV930 inhibiting CD73; SRF617 inhibiting CD39; SRF388 targeting interleukin 27; and SRF813 targeting CD112R. It also develops various earlier stage programs that targets other critical components of the tumor microenvironment, including regulatory T cells and natural killer cells. The company has a strategic collaboration agreement with Novartis Institutes for Biomedical Research, Inc. for the development of cancer therapies; and the Merck Sharp & Dohme Corp. to evaluate the safety and efficacy of combining Surface's SRF617, an investigational antibody therapy targeting CD39, with Merck's KEYTRUDAÃ (pembrolizumab), the first anti-PD-1 therapy approved in the United States. Surface Oncology, Inc. was founded in 2014 and is headquartered in Cambridge, Massachusetts."
SV,2014-12-31,NA,-1212,NA,-1212,1212,0,-1212,-1212,NA,0,0,1212,0,0,NA,-1212,-1212,NA,income_statement,Shell Companies,Spring Valley Acquisition Corp.,"Spring Valley Acquisition Corp., a blank check company, intends to effect a merger, share exchange, asset acquisition, share purchase, reorganization, or related business combination with one or more businesses or entities. The company was founded in 2020 and is based in Dallas, Texas."
SVA,2016-12-31,12648000,-394000,13899000,-596000,41980000,50038000,982000,982000,-1766000,2664000,72431000,71449000,22393000,-1376000,2338000,-3058000,-596000,-6984000,income_statement,Biotechnology,NA,"Sinovac Biotech Ltd., a biopharmaceutical company, engages in the research, development, manufacture, and commercialization of vaccines against human infectious diseases in the People's Republic of China. The company's product portfolio includes vaccines against hepatitis A and B, enterovirus 71 (EV71), seasonal influenza, H5N1 and H1N1 pandemic influenza, and mumps, as well as hand, foot, and mouth diseases. Its marketed products include Healive, an inactivated hepatitis A vaccine; Bilive, a combined inactivated hepatitis A and B vaccine; Anflu, a split viron influenza vaccine; Panflu, a vaccine against the H5N1 influenza virus; Panflu.1, a vaccine against the influenza A H1N1 virus; mumps vaccine; split viron pandemic influenza vaccine; and Inlive, an EV71 vaccine. The company also completed phase III clinical trials for varicella, pneumococcal polysaccharide, and Sabin inactivated polio vaccines. Further, it is developing rubella vaccine; Sabin-strain inactivated polio vaccine; Sars-coVv-2 (COVID-19) vaccine; and quadrivalent influenza vaccine. Sinovac Biotech Ltd. has collaboration agreements with GlaxoSmithKline Biologicals SA to develop combination vaccines containing measles for the China market; Tianjin CanSino Biotechnology Inc. to develop a pneumococcal vaccine; Dynavax Technologies Corporation to develop a vaccine to prevent COVID-19; and Instituto Butantan to advance the clinical trials of CoronaVac, an inactivated vaccine candidate against COVID-19 to Phase III. The company was founded in 1999 and is based in Beijing, the People's Republic of China."
SVA,2017-12-31,20489000,45044000,25988000,25807000,87365000,154106000,45459000,45459000,-1869000,8339000,174346000,128887000,20240000,-415000,NA,36705000,25807000,-141000,income_statement,Biotechnology,NA,"Sinovac Biotech Ltd., a biopharmaceutical company, engages in the research, development, manufacture, and commercialization of vaccines against human infectious diseases in the People's Republic of China. The company's product portfolio includes vaccines against hepatitis A and B, enterovirus 71 (EV71), seasonal influenza, H5N1 and H1N1 pandemic influenza, and mumps, as well as hand, foot, and mouth diseases. Its marketed products include Healive, an inactivated hepatitis A vaccine; Bilive, a combined inactivated hepatitis A and B vaccine; Anflu, a split viron influenza vaccine; Panflu, a vaccine against the H5N1 influenza virus; Panflu.1, a vaccine against the influenza A H1N1 virus; mumps vaccine; split viron pandemic influenza vaccine; and Inlive, an EV71 vaccine. The company also completed phase III clinical trials for varicella, pneumococcal polysaccharide, and Sabin inactivated polio vaccines. Further, it is developing rubella vaccine; Sabin-strain inactivated polio vaccine; Sars-coVv-2 (COVID-19) vaccine; and quadrivalent influenza vaccine. Sinovac Biotech Ltd. has collaboration agreements with GlaxoSmithKline Biologicals SA to develop combination vaccines containing measles for the China market; Tianjin CanSino Biotechnology Inc. to develop a pneumococcal vaccine; Dynavax Technologies Corporation to develop a vaccine to prevent COVID-19; and Instituto Butantan to advance the clinical trials of CoronaVac, an inactivated vaccine candidate against COVID-19 to Phase III. The company was founded in 1999 and is based in Beijing, the People's Republic of China."
SVA,2018-12-31,21910000,46583000,38495000,21782000,137003000,204927000,45391000,45391000,-1070000,10472000,229650000,184259000,24723000,1192000,NA,36111000,21782000,-197000,income_statement,Biotechnology,NA,"Sinovac Biotech Ltd., a biopharmaceutical company, engages in the research, development, manufacture, and commercialization of vaccines against human infectious diseases in the People's Republic of China. The company's product portfolio includes vaccines against hepatitis A and B, enterovirus 71 (EV71), seasonal influenza, H5N1 and H1N1 pandemic influenza, and mumps, as well as hand, foot, and mouth diseases. Its marketed products include Healive, an inactivated hepatitis A vaccine; Bilive, a combined inactivated hepatitis A and B vaccine; Anflu, a split viron influenza vaccine; Panflu, a vaccine against the H5N1 influenza virus; Panflu.1, a vaccine against the influenza A H1N1 virus; mumps vaccine; split viron pandemic influenza vaccine; and Inlive, an EV71 vaccine. The company also completed phase III clinical trials for varicella, pneumococcal polysaccharide, and Sabin inactivated polio vaccines. Further, it is developing rubella vaccine; Sabin-strain inactivated polio vaccine; Sars-coVv-2 (COVID-19) vaccine; and quadrivalent influenza vaccine. Sinovac Biotech Ltd. has collaboration agreements with GlaxoSmithKline Biologicals SA to develop combination vaccines containing measles for the China market; Tianjin CanSino Biotechnology Inc. to develop a pneumococcal vaccine; Dynavax Technologies Corporation to develop a vaccine to prevent COVID-19; and Instituto Butantan to advance the clinical trials of CoronaVac, an inactivated vaccine candidate against COVID-19 to Phase III. The company was founded in 1999 and is based in Beijing, the People's Republic of China."
SVA,2019-12-31,24254000,70820000,58176000,44929000,121468000,213584000,68856000,68856000,-650000,5605000,246053000,177197000,32469000,1964000,NA,65215000,39801000,-688000,income_statement,Biotechnology,NA,"Sinovac Biotech Ltd., a biopharmaceutical company, engages in the research, development, manufacture, and commercialization of vaccines against human infectious diseases in the People's Republic of China. The company's product portfolio includes vaccines against hepatitis A and B, enterovirus 71 (EV71), seasonal influenza, H5N1 and H1N1 pandemic influenza, and mumps, as well as hand, foot, and mouth diseases. Its marketed products include Healive, an inactivated hepatitis A vaccine; Bilive, a combined inactivated hepatitis A and B vaccine; Anflu, a split viron influenza vaccine; Panflu, a vaccine against the H5N1 influenza virus; Panflu.1, a vaccine against the influenza A H1N1 virus; mumps vaccine; split viron pandemic influenza vaccine; and Inlive, an EV71 vaccine. The company also completed phase III clinical trials for varicella, pneumococcal polysaccharide, and Sabin inactivated polio vaccines. Further, it is developing rubella vaccine; Sabin-strain inactivated polio vaccine; Sars-coVv-2 (COVID-19) vaccine; and quadrivalent influenza vaccine. Sinovac Biotech Ltd. has collaboration agreements with GlaxoSmithKline Biologicals SA to develop combination vaccines containing measles for the China market; Tianjin CanSino Biotechnology Inc. to develop a pneumococcal vaccine; Dynavax Technologies Corporation to develop a vaccine to prevent COVID-19; and Instituto Butantan to advance the clinical trials of CoronaVac, an inactivated vaccine candidate against COVID-19 to Phase III. The company was founded in 1999 and is based in Beijing, the People's Republic of China."
SVAC,2019-12-31,NA,-7944,NA,-7944,4554,0,-7944,-7944,NA,0,0,7944,0,0,NA,-7944,-7944,3390,income_statement,Shell Companies,Starboard Value Acquisition Cor,"Starboard Value Acquisition Corp. intends to acquire assets and businesses through a merger, capital stock exchange, stock purchase, reorganization, or similar business combination. The company was founded in 2019 and is based in New York, New York."
SVBI,2017-12-31,NA,7840000,NA,2818000,18392000,30482000,0,8087000,NA,5022000,30482000,22395000,0,-247000,NA,2818000,2538000,4003000,income_statement,Banks—Regional,Severn Bancorp Inc,"Severn Bancorp, Inc., together with its subsidiaries, operates as a savings and loan holding company. The company provides various personal banking products and services comprising mortgage and other lending services, and Internet and mobile banking, as well as checking, savings, money market, time deposit, and individual retirement accounts; commercial banking products and services, including commercial secured and unsecured lending services, as well as business Internet banking, corporate cash management services, and deposit services to commercial customers comprising the medical-use cannabis industry; and safe deposit boxes, ATMs, debit cards, and credit cards. Its loan portfolio comprises residential mortgage loans; commercial real estate loans; construction and land acquisition, and development loans for the construction of one-to-four family dwellings; commercial construction loans; land loans; residential lot loans; business and commercial loans; and home equity loans, home equity lines of credit, and other consumer loans. In addition, the company provides commercial real estate brokerage and property management services; acquires real estate for syndication and investment purposes; leases space; engages in title work related to real estate transactions; and provides various insurance products. Severn Bancorp, Inc. provides its products and services in Maryland, Delaware, and Virginia. As of October 22, 2020, the company operated through 7 branches located in Annapolis, Edgewater, Severna Park, Lothian/Wayson's Corner, Crofton, and Glen Burnie. Severn Bancorp, Inc. was founded in 1946 and is headquartered in Annapolis, Maryland."
SVBI,2018-12-31,NA,11546000,NA,8569000,23128000,37786000,0,11858000,NA,2977000,37786000,25928000,0,-312000,NA,8569000,8499000,2800000,income_statement,Banks—Regional,Severn Bancorp Inc,"Severn Bancorp, Inc., together with its subsidiaries, operates as a savings and loan holding company. The company provides various personal banking products and services comprising mortgage and other lending services, and Internet and mobile banking, as well as checking, savings, money market, time deposit, and individual retirement accounts; commercial banking products and services, including commercial secured and unsecured lending services, as well as business Internet banking, corporate cash management services, and deposit services to commercial customers comprising the medical-use cannabis industry; and safe deposit boxes, ATMs, debit cards, and credit cards. Its loan portfolio comprises residential mortgage loans; commercial real estate loans; construction and land acquisition, and development loans for the construction of one-to-four family dwellings; commercial construction loans; land loans; residential lot loans; business and commercial loans; and home equity loans, home equity lines of credit, and other consumer loans. In addition, the company provides commercial real estate brokerage and property management services; acquires real estate for syndication and investment purposes; leases space; engages in title work related to real estate transactions; and provides various insurance products. Severn Bancorp, Inc. provides its products and services in Maryland, Delaware, and Virginia. As of October 22, 2020, the company operated through 7 branches located in Annapolis, Edgewater, Severna Park, Lothian/Wayson's Corner, Crofton, and Glen Burnie. Severn Bancorp, Inc. was founded in 1946 and is headquartered in Annapolis, Maryland."
SVBI,2019-12-31,NA,11610000,NA,8374000,26261000,41271000,0,11898000,NA,3236000,41271000,29373000,0,-288000,NA,8374000,8374000,3112000,income_statement,Banks—Regional,Severn Bancorp Inc,"Severn Bancorp, Inc., together with its subsidiaries, operates as a savings and loan holding company. The company provides various personal banking products and services comprising mortgage and other lending services, and Internet and mobile banking, as well as checking, savings, money market, time deposit, and individual retirement accounts; commercial banking products and services, including commercial secured and unsecured lending services, as well as business Internet banking, corporate cash management services, and deposit services to commercial customers comprising the medical-use cannabis industry; and safe deposit boxes, ATMs, debit cards, and credit cards. Its loan portfolio comprises residential mortgage loans; commercial real estate loans; construction and land acquisition, and development loans for the construction of one-to-four family dwellings; commercial construction loans; land loans; residential lot loans; business and commercial loans; and home equity loans, home equity lines of credit, and other consumer loans. In addition, the company provides commercial real estate brokerage and property management services; acquires real estate for syndication and investment purposes; leases space; engages in title work related to real estate transactions; and provides various insurance products. Severn Bancorp, Inc. provides its products and services in Maryland, Delaware, and Virginia. As of October 22, 2020, the company operated through 7 branches located in Annapolis, Edgewater, Severna Park, Lothian/Wayson's Corner, Crofton, and Glen Burnie. Severn Bancorp, Inc. was founded in 1946 and is headquartered in Annapolis, Maryland."
SVBI,2020-12-31,NA,9382000,NA,6706000,24963000,42434000,0,9359000,NA,2676000,42434000,33075000,0,23000,NA,6706000,6706000,8112000,income_statement,Banks—Regional,Severn Bancorp Inc,"Severn Bancorp, Inc., together with its subsidiaries, operates as a savings and loan holding company. The company provides various personal banking products and services comprising mortgage and other lending services, and Internet and mobile banking, as well as checking, savings, money market, time deposit, and individual retirement accounts; commercial banking products and services, including commercial secured and unsecured lending services, as well as business Internet banking, corporate cash management services, and deposit services to commercial customers comprising the medical-use cannabis industry; and safe deposit boxes, ATMs, debit cards, and credit cards. Its loan portfolio comprises residential mortgage loans; commercial real estate loans; construction and land acquisition, and development loans for the construction of one-to-four family dwellings; commercial construction loans; land loans; residential lot loans; business and commercial loans; and home equity loans, home equity lines of credit, and other consumer loans. In addition, the company provides commercial real estate brokerage and property management services; acquires real estate for syndication and investment purposes; leases space; engages in title work related to real estate transactions; and provides various insurance products. Severn Bancorp, Inc. provides its products and services in Maryland, Delaware, and Virginia. As of October 22, 2020, the company operated through 7 branches located in Annapolis, Edgewater, Severna Park, Lothian/Wayson's Corner, Crofton, and Glen Burnie. Severn Bancorp, Inc. was founded in 1946 and is headquartered in Annapolis, Maryland."
SVC,2016-12-31,NA,227130000,NA,223110000,99105000,843306000,386859000,386859000,-161913000,4020000,2047211000,1660352000,1203905000,-159729000,NA,223110000,202446000,4905000,income_statement,REIT—Hotel & Motel,Service Properties Trust - Shar,"Service Properties Trust is a real estate investment trust, or REIT, which owns a diverse portfolio of hotels and net lease service and necessity-based retail properties across the United States and in Puerto Rico and Canada with 149 distinct brands across 23 industries. SVC's properties are primarily operated under long-term management or lease agreements. SVC is managed by the operating subsidiary of The RMR Group Inc. (Nasdaq: RMR), or RMR Inc., an alternative asset management company that is headquartered in Newton, Massachusetts."
SVC,2017-12-31,NA,211859000,NA,215143000,125402000,897293000,380327000,380327000,-181579000,-3284000,2171935000,1791608000,1274642000,-168468000,NA,215143000,203815000,4905000,income_statement,REIT—Hotel & Motel,Service Properties Trust - Shar,"Service Properties Trust is a real estate investment trust, or REIT, which owns a diverse portfolio of hotels and net lease service and necessity-based retail properties across the United States and in Puerto Rico and Canada with 149 distinct brands across 23 industries. SVC's properties are primarily operated under long-term management or lease agreements. SVC is managed by the operating subsidiary of The RMR Group Inc. (Nasdaq: RMR), or RMR Inc., an alternative asset management company that is headquartered in Newton, Massachusetts."
SVC,2018-12-31,NA,186929000,NA,185734000,104862000,907471000,394242000,394242000,-195213000,1195000,2294536000,1900294000,1387065000,-207313000,NA,185734000,185734000,5290000,income_statement,REIT—Hotel & Motel,Service Properties Trust - Shar,"Service Properties Trust is a real estate investment trust, or REIT, which owns a diverse portfolio of hotels and net lease service and necessity-based retail properties across the United States and in Puerto Rico and Canada with 149 distinct brands across 23 industries. SVC's properties are primarily operated under long-term management or lease agreements. SVC is managed by the operating subsidiary of The RMR Group Inc. (Nasdaq: RMR), or RMR Inc., an alternative asset management company that is headquartered in Newton, Massachusetts."
SVC,2019-12-31,NA,262543000,NA,259750000,54639000,903426000,411982000,411982000,-225126000,2793000,2316148000,1904166000,1412722000,-149439000,NA,259750000,259750000,8357000,income_statement,REIT—Hotel & Motel,Service Properties Trust - Shar,"Service Properties Trust is a real estate investment trust, or REIT, which owns a diverse portfolio of hotels and net lease service and necessity-based retail properties across the United States and in Puerto Rico and Canada with 149 distinct brands across 23 industries. SVC's properties are primarily operated under long-term management or lease agreements. SVC is managed by the operating subsidiary of The RMR Group Inc. (Nasdaq: RMR), or RMR Inc., an alternative asset management company that is headquartered in Newton, Massachusetts."
SVMK,2017-12-31,53660000,-40057000,NA,-24010000,121451000,156094000,-19017000,-19017000,-26865000,-16047000,218773000,237790000,62679000,-21040000,NA,-24010000,-24010000,NA,income_statement,Software—Application,SVMK Inc.,"SVMK Inc. provides survey software products and purpose-built solutions that enable organizations to engage with their customers, employees, and the markets they research and serve in the United States and internationally. The company's cloud-based SaaS platform helps individuals and organizations to design and distribute surveys approximately 190 countries and territories. Its offers SurveyMonkey CX, a customer experience (CX) and feedback solution that transforms customer feedback into actionable insights; TechValidate, a marketing content automation solution; and SurveyMonkey Engage, an employee engagement solution, which measures employee experiences within an organization. The company also provides SurveyMonkey Audience, a market research solution that enables organizations to gain real-time actionable data from targeted panelists; SurveyMonkey Apply, an application management solution that is primarily used by educational institutions and non-profits seeking to allocate scholarships and grants; and Wufoo, an easy-to-use form builder that helps users create Web and mobile forms, collect file uploads, and receive online payments. In addition, it offers GetFeedback, a CX solution designed for the salesforce ecosystem; and Usabilla, which provides voice of customer technology. The company was formerly known as SurveyMonkey Inc. and changed its name to SVMK Inc. in March 2013. SVMK Inc. was founded in 1999 and is headquartered in San Mateo, California."
SVMK,2018-12-31,106188000,-154592000,NA,-154740000,193122000,176342000,-122968000,-122968000,-27801000,148000,254324000,377292000,77982000,-31624000,NA,-154740000,-154740000,NA,income_statement,Software—Application,SVMK Inc.,"SVMK Inc. provides survey software products and purpose-built solutions that enable organizations to engage with their customers, employees, and the markets they research and serve in the United States and internationally. The company's cloud-based SaaS platform helps individuals and organizations to design and distribute surveys approximately 190 countries and territories. Its offers SurveyMonkey CX, a customer experience (CX) and feedback solution that transforms customer feedback into actionable insights; TechValidate, a marketing content automation solution; and SurveyMonkey Engage, an employee engagement solution, which measures employee experiences within an organization. The company also provides SurveyMonkey Audience, a market research solution that enables organizations to gain real-time actionable data from targeted panelists; SurveyMonkey Apply, an application management solution that is primarily used by educational institutions and non-profits seeking to allocate scholarships and grants; and Wufoo, an easy-to-use form builder that helps users create Web and mobile forms, collect file uploads, and receive online payments. In addition, it offers GetFeedback, a CX solution designed for the salesforce ecosystem; and Usabilla, which provides voice of customer technology. The company was formerly known as SurveyMonkey Inc. and changed its name to SVMK Inc. in March 2013. SVMK Inc. was founded in 1999 and is headquartered in San Mateo, California."
SVMK,2019-12-31,90545000,-76638000,NA,-73859000,205161000,230897000,-64809000,-64809000,-14157000,-2779000,307421000,372230000,76524000,-11829000,NA,-73859000,-73859000,NA,income_statement,Software—Application,SVMK Inc.,"SVMK Inc. provides survey software products and purpose-built solutions that enable organizations to engage with their customers, employees, and the markets they research and serve in the United States and internationally. The company's cloud-based SaaS platform helps individuals and organizations to design and distribute surveys approximately 190 countries and territories. Its offers SurveyMonkey CX, a customer experience (CX) and feedback solution that transforms customer feedback into actionable insights; TechValidate, a marketing content automation solution; and SurveyMonkey Engage, an employee engagement solution, which measures employee experiences within an organization. The company also provides SurveyMonkey Audience, a market research solution that enables organizations to gain real-time actionable data from targeted panelists; SurveyMonkey Apply, an application management solution that is primarily used by educational institutions and non-profits seeking to allocate scholarships and grants; and Wufoo, an easy-to-use form builder that helps users create Web and mobile forms, collect file uploads, and receive online payments. In addition, it offers GetFeedback, a CX solution designed for the salesforce ecosystem; and Usabilla, which provides voice of customer technology. The company was formerly known as SurveyMonkey Inc. and changed its name to SVMK Inc. in March 2013. SVMK Inc. was founded in 1999 and is headquartered in San Mateo, California."
SVMK,2020-12-31,112989000,-90402000,NA,-91581000,260285000,291693000,-81581000,-81581000,-10257000,1179000,375610000,457191000,83917000,-8821000,NA,-91581000,-91581000,NA,income_statement,Software—Application,SVMK Inc.,"SVMK Inc. provides survey software products and purpose-built solutions that enable organizations to engage with their customers, employees, and the markets they research and serve in the United States and internationally. The company's cloud-based SaaS platform helps individuals and organizations to design and distribute surveys approximately 190 countries and territories. Its offers SurveyMonkey CX, a customer experience (CX) and feedback solution that transforms customer feedback into actionable insights; TechValidate, a marketing content automation solution; and SurveyMonkey Engage, an employee engagement solution, which measures employee experiences within an organization. The company also provides SurveyMonkey Audience, a market research solution that enables organizations to gain real-time actionable data from targeted panelists; SurveyMonkey Apply, an application management solution that is primarily used by educational institutions and non-profits seeking to allocate scholarships and grants; and Wufoo, an easy-to-use form builder that helps users create Web and mobile forms, collect file uploads, and receive online payments. In addition, it offers GetFeedback, a CX solution designed for the salesforce ecosystem; and Usabilla, which provides voice of customer technology. The company was formerly known as SurveyMonkey Inc. and changed its name to SVMK Inc. in March 2013. SVMK Inc. was founded in 1999 and is headquartered in San Mateo, California."
SVRA,2016-12-31,8182000,-11280000,NA,-10923000,2820000,400000,-10948000,-10948000,-452000,-357000,400000,11348000,8182000,-332000,NA,-10923000,-11017000,-1454000,income_statement,Biotechnology,"Savara, Inc.","Savara Inc. operates as an orphan lung disease company. Its lead product candidate includes Molgradex, an inhaled granulocyte-macrophage colony-stimulating factor, which is in Phase III development stage for the treatment of autoimmune pulmonary alveolar proteinosis; Phase IIa development stage for treating nontuberculous mycobacterial (NTM) lung infection; and in Phase IIa development stage for the treatment of NTM lung infection in people living with cystic fibrosis. The company is also developing AeroVanc, an inhaled vancomycin that is in Phase III development stage for the treatment of methicillin-resistant Staphylococcus aureus lung infection in individuals living with cystic fibrosis. Savara Inc. is headquartered in Austin, Texas."
SVRA,2017-12-31,18512000,-33431000,NA,-29797000,6641000,-18512000,-25516000,-25516000,-1161000,-3634000,0,25516000,18512000,-7915000,NA,-29797000,-30779000,-1454000,income_statement,Biotechnology,"Savara, Inc.","Savara Inc. operates as an orphan lung disease company. Its lead product candidate includes Molgradex, an inhaled granulocyte-macrophage colony-stimulating factor, which is in Phase III development stage for the treatment of autoimmune pulmonary alveolar proteinosis; Phase IIa development stage for treating nontuberculous mycobacterial (NTM) lung infection; and in Phase IIa development stage for the treatment of NTM lung infection in people living with cystic fibrosis. The company is also developing AeroVanc, an inhaled vancomycin that is in Phase III development stage for the treatment of methicillin-resistant Staphylococcus aureus lung infection in individuals living with cystic fibrosis. Savara Inc. is headquartered in Austin, Texas."
SVRA,2018-12-31,37173000,-68573000,NA,-61516000,10388000,0,-46633000,-46633000,-70000,-7057000,0,46633000,0,-21940000,NA,-61516000,-61516000,-1454000,income_statement,Biotechnology,"Savara, Inc.","Savara Inc. operates as an orphan lung disease company. Its lead product candidate includes Molgradex, an inhaled granulocyte-macrophage colony-stimulating factor, which is in Phase III development stage for the treatment of autoimmune pulmonary alveolar proteinosis; Phase IIa development stage for treating nontuberculous mycobacterial (NTM) lung infection; and in Phase IIa development stage for the treatment of NTM lung infection in people living with cystic fibrosis. The company is also developing AeroVanc, an inhaled vancomycin that is in Phase III development stage for the treatment of methicillin-resistant Staphylococcus aureus lung infection in individuals living with cystic fibrosis. Savara Inc. is headquartered in Austin, Texas."
SVRA,2019-12-31,38781000,-78173000,NA,-78173000,12862000,0,-50741000,-50741000,-70000,0,0,50741000,0,-27432000,NA,-78173000,-78173000,-1213000,income_statement,Biotechnology,"Savara, Inc.","Savara Inc. operates as an orphan lung disease company. Its lead product candidate includes Molgradex, an inhaled granulocyte-macrophage colony-stimulating factor, which is in Phase III development stage for the treatment of autoimmune pulmonary alveolar proteinosis; Phase IIa development stage for treating nontuberculous mycobacterial (NTM) lung infection; and in Phase IIa development stage for the treatment of NTM lung infection in people living with cystic fibrosis. The company is also developing AeroVanc, an inhaled vancomycin that is in Phase III development stage for the treatment of methicillin-resistant Staphylococcus aureus lung infection in individuals living with cystic fibrosis. Savara Inc. is headquartered in Austin, Texas."
SVVC,2016-12-31,NA,-24661554,NA,-24661554,4713526,878023,-3835503,-3835503,NA,0,878023,4713526,0,-20826051,NA,-24661554,-24661554,NA,income_statement,Asset Management,Firsthand Technology Value Fund,"Firsthand Technology Value Fund, Inc. is a business development company specializes in investments in start-up, late, development stage, and PIPEs. It seeks to invest in pre-IPO companies. The fund also seeks to make investments in companies with operating histories that are unprofitable or marginally profitable, that have negative net worth, or that are involved in bankruptcy or reorganization proceedings. In addition, it also makes investments in connection with the acquisition or divestiture of companies or divisions of companies. The fund seeks to invest through direct investments in private companies, negotiations with selling shareholders, and in organized secondary marketplaces for private securities. It may also invest in micro-cap publicly traded companies and also make investments in securities of public companies. The fund seeks to invest in private technology, information technology, cleantech sector, and companies that possess patents and other defensible intellectual property rights with a focus on Internet, consumer electronics, computer hardware, computer software, social networking, computer peripherals, solar photovoltaic, energy efficiency, solid-state lighting, water purification, wind-generated electricity, fuel cells, bio-fuels, electronic components, semiconductors, telecommunications, and advanced materials. Cleantech companies include those engaged in the sale of goods and services designed to harness renewable energy and materials, eliminate emissions and waste, and reduce the use of natural resources. It invests primarily in equity securities of private companies in the United States. However the fund also invests in securities of public companies located outside of the United States. It seeks to invest between $1 million and $10 million each in its investee companies. The fund structures its equity investments as preferred stock, common stock, warrants, limited partnership interests, options, other beneficial ownership interests, convertible debt, short term debt investments, high-yield bonds, and distressed debt. It prefers to control, be represented on, or have observer rights on the board of directors of a portfolio company. The fund seeks to exit its investments through strategic acquisition by other industry participants, initial public offering of common stock, or other capital market transaction."
SVVC,2017-12-31,NA,26179569,NA,26179569,6084132,1565791,-4518341,-4518341,NA,0,1565791,6084132,0,30697910,NA,26179569,26179569,NA,income_statement,Asset Management,Firsthand Technology Value Fund,"Firsthand Technology Value Fund, Inc. is a business development company specializes in investments in start-up, late, development stage, and PIPEs. It seeks to invest in pre-IPO companies. The fund also seeks to make investments in companies with operating histories that are unprofitable or marginally profitable, that have negative net worth, or that are involved in bankruptcy or reorganization proceedings. In addition, it also makes investments in connection with the acquisition or divestiture of companies or divisions of companies. The fund seeks to invest through direct investments in private companies, negotiations with selling shareholders, and in organized secondary marketplaces for private securities. It may also invest in micro-cap publicly traded companies and also make investments in securities of public companies. The fund seeks to invest in private technology, information technology, cleantech sector, and companies that possess patents and other defensible intellectual property rights with a focus on Internet, consumer electronics, computer hardware, computer software, social networking, computer peripherals, solar photovoltaic, energy efficiency, solid-state lighting, water purification, wind-generated electricity, fuel cells, bio-fuels, electronic components, semiconductors, telecommunications, and advanced materials. Cleantech companies include those engaged in the sale of goods and services designed to harness renewable energy and materials, eliminate emissions and waste, and reduce the use of natural resources. It invests primarily in equity securities of private companies in the United States. However the fund also invests in securities of public companies located outside of the United States. It seeks to invest between $1 million and $10 million each in its investee companies. The fund structures its equity investments as preferred stock, common stock, warrants, limited partnership interests, options, other beneficial ownership interests, convertible debt, short term debt investments, high-yield bonds, and distressed debt. It prefers to control, be represented on, or have observer rights on the board of directors of a portfolio company. The fund seeks to exit its investments through strategic acquisition by other industry participants, initial public offering of common stock, or other capital market transaction."
SVVC,2018-12-31,NA,28305087,NA,19872529,12844659,3467838,-9376821,-9376821,NA,8432558,3467838,12844659,0,37681908,NA,19872529,19872529,NA,income_statement,Asset Management,Firsthand Technology Value Fund,"Firsthand Technology Value Fund, Inc. is a business development company specializes in investments in start-up, late, development stage, and PIPEs. It seeks to invest in pre-IPO companies. The fund also seeks to make investments in companies with operating histories that are unprofitable or marginally profitable, that have negative net worth, or that are involved in bankruptcy or reorganization proceedings. In addition, it also makes investments in connection with the acquisition or divestiture of companies or divisions of companies. The fund seeks to invest through direct investments in private companies, negotiations with selling shareholders, and in organized secondary marketplaces for private securities. It may also invest in micro-cap publicly traded companies and also make investments in securities of public companies. The fund seeks to invest in private technology, information technology, cleantech sector, and companies that possess patents and other defensible intellectual property rights with a focus on Internet, consumer electronics, computer hardware, computer software, social networking, computer peripherals, solar photovoltaic, energy efficiency, solid-state lighting, water purification, wind-generated electricity, fuel cells, bio-fuels, electronic components, semiconductors, telecommunications, and advanced materials. Cleantech companies include those engaged in the sale of goods and services designed to harness renewable energy and materials, eliminate emissions and waste, and reduce the use of natural resources. It invests primarily in equity securities of private companies in the United States. However the fund also invests in securities of public companies located outside of the United States. It seeks to invest between $1 million and $10 million each in its investee companies. The fund structures its equity investments as preferred stock, common stock, warrants, limited partnership interests, options, other beneficial ownership interests, convertible debt, short term debt investments, high-yield bonds, and distressed debt. It prefers to control, be represented on, or have observer rights on the board of directors of a portfolio company. The fund seeks to exit its investments through strategic acquisition by other industry participants, initial public offering of common stock, or other capital market transaction."
SVVC,2019-12-31,NA,-80803710,NA,-64528568,-4657825,1789651,6447476,6447476,NA,-16275142,1789651,-4657825,0,-87251186,NA,-64528568,-64528568,NA,income_statement,Asset Management,Firsthand Technology Value Fund,"Firsthand Technology Value Fund, Inc. is a business development company specializes in investments in start-up, late, development stage, and PIPEs. It seeks to invest in pre-IPO companies. The fund also seeks to make investments in companies with operating histories that are unprofitable or marginally profitable, that have negative net worth, or that are involved in bankruptcy or reorganization proceedings. In addition, it also makes investments in connection with the acquisition or divestiture of companies or divisions of companies. The fund seeks to invest through direct investments in private companies, negotiations with selling shareholders, and in organized secondary marketplaces for private securities. It may also invest in micro-cap publicly traded companies and also make investments in securities of public companies. The fund seeks to invest in private technology, information technology, cleantech sector, and companies that possess patents and other defensible intellectual property rights with a focus on Internet, consumer electronics, computer hardware, computer software, social networking, computer peripherals, solar photovoltaic, energy efficiency, solid-state lighting, water purification, wind-generated electricity, fuel cells, bio-fuels, electronic components, semiconductors, telecommunications, and advanced materials. Cleantech companies include those engaged in the sale of goods and services designed to harness renewable energy and materials, eliminate emissions and waste, and reduce the use of natural resources. It invests primarily in equity securities of private companies in the United States. However the fund also invests in securities of public companies located outside of the United States. It seeks to invest between $1 million and $10 million each in its investee companies. The fund structures its equity investments as preferred stock, common stock, warrants, limited partnership interests, options, other beneficial ownership interests, convertible debt, short term debt investments, high-yield bonds, and distressed debt. It prefers to control, be represented on, or have observer rights on the board of directors of a portfolio company. The fund seeks to exit its investments through strategic acquisition by other industry participants, initial public offering of common stock, or other capital market transaction."
SWAV,2017-12-31,17963000,-30589000,NA,-30615000,11785000,-1117000,-30865000,-30865000,-58000,26000,1719000,32584000,2836000,276000,NA,-30615000,-30615000,NA,income_statement,Medical Devices,"ShockWave Medical, Inc.","ShockWave Medical, Inc., a medical device company, develops and commercializes intravascular lithotripsy technology to treat calcified plaque in patients with peripheral vascular, coronary vascular, and heart valve diseases. The company offers M5 catheters for treating above-the-knee peripheral artery disease; C2 catheters for treating coronary artery disease; and S4 catheters for treating below-the-knee peripheral artery disease. It serves interventional cardiologists, vascular surgeons, and interventional radiologists through sales representatives and sales managers, and distributors. The company operates in the United States, Germany, rest of Europe, and internationally. ShockWave Medical, Inc. was incorporated in 2009 and is headquartered in Santa Clara, California."
SWAV,2018-12-31,22698000,-41064000,NA,-41102000,23515000,5013000,-41200000,-41200000,-401000,38000,12263000,53463000,7250000,136000,NA,-41102000,-41102000,NA,income_statement,Medical Devices,"ShockWave Medical, Inc.","ShockWave Medical, Inc., a medical device company, develops and commercializes intravascular lithotripsy technology to treat calcified plaque in patients with peripheral vascular, coronary vascular, and heart valve diseases. The company offers M5 catheters for treating above-the-knee peripheral artery disease; C2 catheters for treating coronary artery disease; and S4 catheters for treating below-the-knee peripheral artery disease. It serves interventional cardiologists, vascular surgeons, and interventional radiologists through sales representatives and sales managers, and distributors. The company operates in the United States, Germany, rest of Europe, and internationally. ShockWave Medical, Inc. was incorporated in 2009 and is headquartered in Santa Clara, California."
SWAV,2019-12-31,32853000,-51047000,NA,-51109000,44754000,25768000,-51839000,-51839000,-944000,62000,42927000,94766000,17159000,792000,NA,-51109000,-51109000,NA,income_statement,Medical Devices,"ShockWave Medical, Inc.","ShockWave Medical, Inc., a medical device company, develops and commercializes intravascular lithotripsy technology to treat calcified plaque in patients with peripheral vascular, coronary vascular, and heart valve diseases. The company offers M5 catheters for treating above-the-knee peripheral artery disease; C2 catheters for treating coronary artery disease; and S4 catheters for treating below-the-knee peripheral artery disease. It serves interventional cardiologists, vascular surgeons, and interventional radiologists through sales representatives and sales managers, and distributors. The company operates in the United States, Germany, rest of Europe, and internationally. ShockWave Medical, Inc. was incorporated in 2009 and is headquartered in Santa Clara, California."
SWAV,2020-12-31,36926000,-65619000,NA,-65699000,75535000,46798000,-65663000,-65663000,-1212000,80000,67789000,133452000,20991000,44000,NA,-65699000,-65699000,NA,income_statement,Medical Devices,"ShockWave Medical, Inc.","ShockWave Medical, Inc., a medical device company, develops and commercializes intravascular lithotripsy technology to treat calcified plaque in patients with peripheral vascular, coronary vascular, and heart valve diseases. The company offers M5 catheters for treating above-the-knee peripheral artery disease; C2 catheters for treating coronary artery disease; and S4 catheters for treating below-the-knee peripheral artery disease. It serves interventional cardiologists, vascular surgeons, and interventional radiologists through sales representatives and sales managers, and distributors. The company operates in the United States, Germany, rest of Europe, and internationally. ShockWave Medical, Inc. was incorporated in 2009 and is headquartered in Santa Clara, California."
SWBI,2017-04-30,10238000,191306000,NA,127854000,161295000,379972000,208439000,208439000,-8581000,63452000,903188000,694749000,523216000,-17133000,NA,127854000,127854000,NA,income_statement,Aerospace & Defense,"Smith & Wesson Brands, Inc.","Smith & Wesson Brands, Inc. designs, manufactures, and sells firearms worldwide. The company offers firearms products, such as revolvers and pistols; modern sporting rifles, bolt action rifles, and muzzleloaders; handcuffs; suppressors; and other firearm-related products under the Smith & Wesson, M&P, Performance Center, Thompson/Center Arms, and Gemtech brands. It also provides manufacturing services, which include forging, heat treating, rapid prototyping, tooling, finishing, plating, machining, and custom plastic injection molding to other businesses under the Smith & Wesson and Smith & Wesson Precision Components brands; and sells parts purchased through third parties. The company sells its products to gun enthusiasts, collectors, sportsmen, competitive shooters, hunters, individuals desiring home and personal protection, law enforcement, security agencies, officers, and military agencies. Smith & Wesson Brands, Inc. markets its products through independent dealers, retailers, in-store retails, and direct to consumers; print, broadcast, and digital advertising campaigns; social and electronic media; and in-store retail merchandising strategies. The company was formerly known as American Outdoor Brands Corporation and changed its name to Smith & Wesson Brands, Inc. in June 2020. Smith & Wesson Brands, Inc. was founded in 1852 and is based in Springfield, Massachusetts."
SWBI,2018-04-30,11361000,17617000,NA,20128000,157343000,196252000,27548000,27548000,-11168000,-2511000,606850000,579302000,410598000,-9931000,NA,20128000,20128000,NA,income_statement,Aerospace & Defense,"Smith & Wesson Brands, Inc.","Smith & Wesson Brands, Inc. designs, manufactures, and sells firearms worldwide. The company offers firearms products, such as revolvers and pistols; modern sporting rifles, bolt action rifles, and muzzleloaders; handcuffs; suppressors; and other firearm-related products under the Smith & Wesson, M&P, Performance Center, Thompson/Center Arms, and Gemtech brands. It also provides manufacturing services, which include forging, heat treating, rapid prototyping, tooling, finishing, plating, machining, and custom plastic injection molding to other businesses under the Smith & Wesson and Smith & Wesson Precision Components brands; and sells parts purchased through third parties. The company sells its products to gun enthusiasts, collectors, sportsmen, competitive shooters, hunters, individuals desiring home and personal protection, law enforcement, security agencies, officers, and military agencies. Smith & Wesson Brands, Inc. markets its products through independent dealers, retailers, in-store retails, and direct to consumers; print, broadcast, and digital advertising campaigns; social and electronic media; and in-store retail merchandising strategies. The company was formerly known as American Outdoor Brands Corporation and changed its name to Smith & Wesson Brands, Inc. in June 2020. Smith & Wesson Brands, Inc. was founded in 1852 and is based in Springfield, Massachusetts."
SWBI,2019-04-30,12866000,28738000,NA,18410000,164885000,226231000,48480000,48480000,-9351000,10328000,638277000,589797000,412046000,-19742000,NA,18410000,18410000,NA,income_statement,Aerospace & Defense,"Smith & Wesson Brands, Inc.","Smith & Wesson Brands, Inc. designs, manufactures, and sells firearms worldwide. The company offers firearms products, such as revolvers and pistols; modern sporting rifles, bolt action rifles, and muzzleloaders; handcuffs; suppressors; and other firearm-related products under the Smith & Wesson, M&P, Performance Center, Thompson/Center Arms, and Gemtech brands. It also provides manufacturing services, which include forging, heat treating, rapid prototyping, tooling, finishing, plating, machining, and custom plastic injection molding to other businesses under the Smith & Wesson and Smith & Wesson Precision Components brands; and sells parts purchased through third parties. The company sells its products to gun enthusiasts, collectors, sportsmen, competitive shooters, hunters, individuals desiring home and personal protection, law enforcement, security agencies, officers, and military agencies. Smith & Wesson Brands, Inc. markets its products through independent dealers, retailers, in-store retails, and direct to consumers; print, broadcast, and digital advertising campaigns; social and electronic media; and in-store retail merchandising strategies. The company was formerly known as American Outdoor Brands Corporation and changed its name to Smith & Wesson Brands, Inc. in June 2020. Smith & Wesson Brands, Inc. was founded in 1852 and is based in Springfield, Massachusetts."
SWBI,2020-04-30,12362000,-59949000,NA,-61230000,172500000,234705000,49843000,49843000,-11213000,1281000,678390000,628547000,443685000,-109792000,NA,-61230000,-61230000,NA,income_statement,Aerospace & Defense,"Smith & Wesson Brands, Inc.","Smith & Wesson Brands, Inc. designs, manufactures, and sells firearms worldwide. The company offers firearms products, such as revolvers and pistols; modern sporting rifles, bolt action rifles, and muzzleloaders; handcuffs; suppressors; and other firearm-related products under the Smith & Wesson, M&P, Performance Center, Thompson/Center Arms, and Gemtech brands. It also provides manufacturing services, which include forging, heat treating, rapid prototyping, tooling, finishing, plating, machining, and custom plastic injection molding to other businesses under the Smith & Wesson and Smith & Wesson Precision Components brands; and sells parts purchased through third parties. The company sells its products to gun enthusiasts, collectors, sportsmen, competitive shooters, hunters, individuals desiring home and personal protection, law enforcement, security agencies, officers, and military agencies. Smith & Wesson Brands, Inc. markets its products through independent dealers, retailers, in-store retails, and direct to consumers; print, broadcast, and digital advertising campaigns; social and electronic media; and in-store retail merchandising strategies. The company was formerly known as American Outdoor Brands Corporation and changed its name to Smith & Wesson Brands, Inc. in June 2020. Smith & Wesson Brands, Inc. was founded in 1852 and is based in Springfield, Massachusetts."
SWK,2017-12-30,NA,1527800000,2800000,1227300000,2945200000,4825100000,1559900000,1559900000,-222600000,300900000,12966600000,11406700000,8141500000,-32100000,NA,1226900000,1227300000,303700000,income_statement,NA,NA,NA
SWK,2018-12-29,NA,1022100000,3700000,605200000,2985900000,4916800000,1692000000,1692000000,-277900000,416300000,13982400000,12290400000,9065600000,-669900000,NA,605800000,605200000,210900000,income_statement,NA,NA,NA
SWK,2019-12-28,NA,1118800000,5900000,955800000,2868500000,4845200000,1694700000,1694700000,-284300000,160800000,14442200000,12747500000,9597000000,-575900000,NA,958000000,955800000,249000000,income_statement,NA,NA,NA
SWK,2021-01-02,NA,1276100000,6800000,1233800000,2913500000,5039100000,1815900000,1815900000,-205100000,41400000,14534600000,12718700000,9495500000,-539800000,NA,1234700000,1210400000,309700000,income_statement,NA,NA,NA
SWKH,2016-12-31,NA,10403000,3756000,28888000,2829000,20721000,0,17892000,NA,-21638000,20721000,2829000,0,-7489000,NA,32041000,28888000,NA,income_statement,Asset Management,SWK Holdings Corporation,"SWK Holdings Corporation, a specialized finance company, focuses on the healthcare sector. The company operates through two segments, Finance Receivables and Pharmaceutical Development. It provides customized financing solutions to a range of life science companies, including companies in the biotechnology, medical device, medical diagnostics and related tools, animal health, and pharmaceutical industries, as well as institutions and inventors. The company, through its subsidiary, SWK Advisors LLC, offers non-discretionary investment advisory services to institutional clients in separately managed accounts to invest in life science finance. The company also engages in the pharmaceutical development, formulation and manufacturing, and licensing business through the Peptelligence platform. Its product pipeline includes Ovarest, an oral leuprolide tablet to treat endometriosis; and Tobrate, an oral tobramycin tablet for the treatment of uncomplicated urinary tract infections. The company was formerly known as Kana Software, Inc. and changed its name to SWK Holdings Corporation in December 2009. SWK Holdings Corporation was founded in 1996 and is headquartered in Dallas, Texas."
SWKH,2017-12-31,NA,24004000,NA,3047000,4101000,29886000,0,25785000,NA,15753000,29886000,4101000,0,-1781000,NA,8251000,3047000,NA,income_statement,Asset Management,SWK Holdings Corporation,"SWK Holdings Corporation, a specialized finance company, focuses on the healthcare sector. The company operates through two segments, Finance Receivables and Pharmaceutical Development. It provides customized financing solutions to a range of life science companies, including companies in the biotechnology, medical device, medical diagnostics and related tools, animal health, and pharmaceutical industries, as well as institutions and inventors. The company, through its subsidiary, SWK Advisors LLC, offers non-discretionary investment advisory services to institutional clients in separately managed accounts to invest in life science finance. The company also engages in the pharmaceutical development, formulation and manufacturing, and licensing business through the Peptelligence platform. Its product pipeline includes Ovarest, an oral leuprolide tablet to treat endometriosis; and Tobrate, an oral tobramycin tablet for the treatment of uncomplicated urinary tract infections. The company was formerly known as Kana Software, Inc. and changed its name to SWK Holdings Corporation in December 2009. SWK Holdings Corporation was founded in 1996 and is headquartered in Dallas, Texas."
SWKH,2018-12-31,NA,6237000,NA,6195000,4866000,11776000,0,6893000,NA,42000,11776000,4883000,0,-656000,NA,6195000,6195000,NA,income_statement,Asset Management,SWK Holdings Corporation,"SWK Holdings Corporation, a specialized finance company, focuses on the healthcare sector. The company operates through two segments, Finance Receivables and Pharmaceutical Development. It provides customized financing solutions to a range of life science companies, including companies in the biotechnology, medical device, medical diagnostics and related tools, animal health, and pharmaceutical industries, as well as institutions and inventors. The company, through its subsidiary, SWK Advisors LLC, offers non-discretionary investment advisory services to institutional clients in separately managed accounts to invest in life science finance. The company also engages in the pharmaceutical development, formulation and manufacturing, and licensing business through the Peptelligence platform. Its product pipeline includes Ovarest, an oral leuprolide tablet to treat endometriosis; and Tobrate, an oral tobramycin tablet for the treatment of uncomplicated urinary tract infections. The company was formerly known as Kana Software, Inc. and changed its name to SWK Holdings Corporation in December 2009. SWK Holdings Corporation was founded in 1996 and is headquartered in Dallas, Texas."
SWKH,2019-12-31,NA,16842000,NA,23828000,7430000,27024000,0,14640000,NA,-6986000,28200000,13560000,1176000,2202000,NA,23828000,23828000,NA,income_statement,Asset Management,SWK Holdings Corporation,"SWK Holdings Corporation, a specialized finance company, focuses on the healthcare sector. The company operates through two segments, Finance Receivables and Pharmaceutical Development. It provides customized financing solutions to a range of life science companies, including companies in the biotechnology, medical device, medical diagnostics and related tools, animal health, and pharmaceutical industries, as well as institutions and inventors. The company, through its subsidiary, SWK Advisors LLC, offers non-discretionary investment advisory services to institutional clients in separately managed accounts to invest in life science finance. The company also engages in the pharmaceutical development, formulation and manufacturing, and licensing business through the Peptelligence platform. Its product pipeline includes Ovarest, an oral leuprolide tablet to treat endometriosis; and Tobrate, an oral tobramycin tablet for the treatment of uncomplicated urinary tract infections. The company was formerly known as Kana Software, Inc. and changed its name to SWK Holdings Corporation in December 2009. SWK Holdings Corporation was founded in 1996 and is headquartered in Dallas, Texas."
SWKS,2017-09-29,355200000,1257000000,NA,1010200000,205900000,1841800000,1253100000,1253100000,NA,246800000,3651400000,2398300000,1809600000,3900000,NA,1010200000,1010200000,NA,income_statement,NA,NA,NA
SWKS,2018-09-28,404500000,1332100000,NA,918400000,207800000,1950700000,1320100000,1320100000,NA,413700000,3868000000,2547900000,1917300000,12000000,NA,918400000,918400000,NA,income_statement,NA,NA,NA
SWKS,2019-09-27,424100000,961000000,NA,853600000,198300000,1669900000,1024900000,1024900000,NA,107400000,3376800000,2351900000,1706900000,-63900000,NA,853600000,853600000,NA,income_statement,NA,NA,NA
SWKS,2020-10-02,464100000,891700000,NA,814800000,231400000,1636300000,929000000,929000000,NA,76900000,3355700000,2426700000,1719400000,-37300000,NA,814800000,814800000,NA,income_statement,NA,NA,NA
SWTX,2017-12-31,8397000,-13917000,NA,-13917000,5583000,0,-13980000,-13980000,NA,0,0,13980000,0,63000,NA,-13917000,-13917000,NA,income_statement,Biotechnology,"SpringWorks Therapeutics, Inc.","SpringWorks Therapeutics, Inc., a clinical-stage biopharmaceutical company, acquires, develops, and commercializes medicines for underserved patient populations suffering from rare diseases and cancer. Its lead product candidate is nirogacestat, an oral small molecule gamma secretase inhibitor that is in Phase III clinical trial for the treatment of desmoid tumors. The company is also developing mirdametinib, an oral small molecule MEK inhibitor that is in Phase IIb clinical trial for the treatment of neurofibromatosis type 1-associated plexiform neurofibromas; Nirogacestat + belantamab mafodotin, which is in Phase Ib clinical trial for the treatment of relapsed or refractory multiple myeloma (RRMM); and Nirogacestat + ALLO-715 that is in preclinical trials for the treatment of RRMM. In addition, it is developing Mirdametinib + lifirafenib, a combination therapy that is in Phase Ib clinical trial in patients with advanced or refractory solid tumors; and BGB-3245, an investigational oral selective small molecule inhibitor of monomeric and dimeric forms of activating BRAF mutations, which is in Phase I clinical trial. SpringWorks Therapeutics, Inc. has collaborations with BeiGene, Ltd., GlaxoSmithKline LLC, and Allogene to develop combination approaches with nirogacestat and mirdametinib, as well as medicines; and license agreements with Pfizer Inc. for nirogacestat and mirdametinib. SpringWorks Therapeutics, Inc. was founded in 2017 and is headquartered in Stamford, Connecticut."
SWTX,2018-12-31,9898000,-17813000,NA,-17813000,8593000,0,-18491000,-18491000,NA,0,0,18491000,0,678000,NA,-17813000,-17813000,NA,income_statement,Biotechnology,"SpringWorks Therapeutics, Inc.","SpringWorks Therapeutics, Inc., a clinical-stage biopharmaceutical company, acquires, develops, and commercializes medicines for underserved patient populations suffering from rare diseases and cancer. Its lead product candidate is nirogacestat, an oral small molecule gamma secretase inhibitor that is in Phase III clinical trial for the treatment of desmoid tumors. The company is also developing mirdametinib, an oral small molecule MEK inhibitor that is in Phase IIb clinical trial for the treatment of neurofibromatosis type 1-associated plexiform neurofibromas; Nirogacestat + belantamab mafodotin, which is in Phase Ib clinical trial for the treatment of relapsed or refractory multiple myeloma (RRMM); and Nirogacestat + ALLO-715 that is in preclinical trials for the treatment of RRMM. In addition, it is developing Mirdametinib + lifirafenib, a combination therapy that is in Phase Ib clinical trial in patients with advanced or refractory solid tumors; and BGB-3245, an investigational oral selective small molecule inhibitor of monomeric and dimeric forms of activating BRAF mutations, which is in Phase I clinical trial. SpringWorks Therapeutics, Inc. has collaborations with BeiGene, Ltd., GlaxoSmithKline LLC, and Allogene to develop combination approaches with nirogacestat and mirdametinib, as well as medicines; and license agreements with Pfizer Inc. for nirogacestat and mirdametinib. SpringWorks Therapeutics, Inc. was founded in 2017 and is headquartered in Stamford, Connecticut."
SWTX,2019-12-31,42545000,-58306000,NA,-58306000,16694000,0,-59239000,-59239000,NA,0,0,59239000,0,933000,NA,-58306000,-50577000,NA,income_statement,Biotechnology,"SpringWorks Therapeutics, Inc.","SpringWorks Therapeutics, Inc., a clinical-stage biopharmaceutical company, acquires, develops, and commercializes medicines for underserved patient populations suffering from rare diseases and cancer. Its lead product candidate is nirogacestat, an oral small molecule gamma secretase inhibitor that is in Phase III clinical trial for the treatment of desmoid tumors. The company is also developing mirdametinib, an oral small molecule MEK inhibitor that is in Phase IIb clinical trial for the treatment of neurofibromatosis type 1-associated plexiform neurofibromas; Nirogacestat + belantamab mafodotin, which is in Phase Ib clinical trial for the treatment of relapsed or refractory multiple myeloma (RRMM); and Nirogacestat + ALLO-715 that is in preclinical trials for the treatment of RRMM. In addition, it is developing Mirdametinib + lifirafenib, a combination therapy that is in Phase Ib clinical trial in patients with advanced or refractory solid tumors; and BGB-3245, an investigational oral selective small molecule inhibitor of monomeric and dimeric forms of activating BRAF mutations, which is in Phase I clinical trial. SpringWorks Therapeutics, Inc. has collaborations with BeiGene, Ltd., GlaxoSmithKline LLC, and Allogene to develop combination approaches with nirogacestat and mirdametinib, as well as medicines; and license agreements with Pfizer Inc. for nirogacestat and mirdametinib. SpringWorks Therapeutics, Inc. was founded in 2017 and is headquartered in Stamford, Connecticut."
SXTC,2017-03-31,NA,1580195,NA,1185146,709819,2312001,1602182,1602182,-40390,395049,4881523,3279341,2569522,-21987,NA,1185146,1185146,NA,income_statement,Drug Manufacturers—Specialty & Generic,"China SXT Pharmaceuticals, Inc.","China SXT Pharmaceuticals, Inc., a pharmaceutical company, engages in the research, development, manufacture, marketing, and sale of traditional Chinese medicine piece tablets (TCMP) in China. It offers advanced, fine, and regular TCMP products, such as ChenXiang, SanQiFen, HongQi, SuMu, JiangXiang, CuYanHuSuo, XiaTianWu, LuXueJing, XueJie, ChaoSuanZaoRen, HongQuMi, ChuanBeiMu, HuangShuKuiHua, WuWeiZi, DingXiang, RenShen, QingGuo, JueMingZi, and ShaRen. The company provides its products under the Suxuantang, Hui Chun Tang, and Tong Ren Tang brands. As of May 2, 2020, it served 116 pharmaceutical companies, 56 pharmacies, and 76 hospitals. The company was founded in 2005 and is based in Taizhou, China."
SXTC,2018-03-31,NA,1627684,NA,1187581,1769229,3401495,1632266,1632266,-779,440103,7019243,5386977,3617748,-4582,NA,1187581,1187581,NA,income_statement,Drug Manufacturers—Specialty & Generic,"China SXT Pharmaceuticals, Inc.","China SXT Pharmaceuticals, Inc., a pharmaceutical company, engages in the research, development, manufacture, marketing, and sale of traditional Chinese medicine piece tablets (TCMP) in China. It offers advanced, fine, and regular TCMP products, such as ChenXiang, SanQiFen, HongQi, SuMu, JiangXiang, CuYanHuSuo, XiaTianWu, LuXueJing, XueJie, ChaoSuanZaoRen, HongQuMi, ChuanBeiMu, HuangShuKuiHua, WuWeiZi, DingXiang, RenShen, QingGuo, JueMingZi, and ShaRen. The company provides its products under the Suxuantang, Hui Chun Tang, and Tong Ren Tang brands. As of May 2, 2020, it served 116 pharmaceutical companies, 56 pharmacies, and 76 hospitals. The company was founded in 2005 and is based in Taizhou, China."
SXTC,2019-03-31,NA,1791459,NA,1539227,2842043,4611535,1769492,1769492,-5174,252232,7012026,5242534,2400491,21967,NA,1539227,1539227,NA,income_statement,Drug Manufacturers—Specialty & Generic,"China SXT Pharmaceuticals, Inc.","China SXT Pharmaceuticals, Inc., a pharmaceutical company, engages in the research, development, manufacture, marketing, and sale of traditional Chinese medicine piece tablets (TCMP) in China. It offers advanced, fine, and regular TCMP products, such as ChenXiang, SanQiFen, HongQi, SuMu, JiangXiang, CuYanHuSuo, XiaTianWu, LuXueJing, XueJie, ChaoSuanZaoRen, HongQuMi, ChuanBeiMu, HuangShuKuiHua, WuWeiZi, DingXiang, RenShen, QingGuo, JueMingZi, and ShaRen. The company provides its products under the Suxuantang, Hui Chun Tang, and Tong Ren Tang brands. As of May 2, 2020, it served 116 pharmaceutical companies, 56 pharmacies, and 76 hospitals. The company was founded in 2005 and is based in Taizhou, China."
SXTC,2020-03-31,NA,-10389594,NA,-10287872,4044819,2703702,-1341117,-1341117,-3421910,-101722,5162268,6503385,2458566,-9048477,NA,-10287872,-10287872,NA,income_statement,Drug Manufacturers—Specialty & Generic,"China SXT Pharmaceuticals, Inc.","China SXT Pharmaceuticals, Inc., a pharmaceutical company, engages in the research, development, manufacture, marketing, and sale of traditional Chinese medicine piece tablets (TCMP) in China. It offers advanced, fine, and regular TCMP products, such as ChenXiang, SanQiFen, HongQi, SuMu, JiangXiang, CuYanHuSuo, XiaTianWu, LuXueJing, XueJie, ChaoSuanZaoRen, HongQuMi, ChuanBeiMu, HuangShuKuiHua, WuWeiZi, DingXiang, RenShen, QingGuo, JueMingZi, and ShaRen. The company provides its products under the Suxuantang, Hui Chun Tang, and Tong Ren Tang brands. As of May 2, 2020, it served 116 pharmaceutical companies, 56 pharmacies, and 76 hospitals. The company was founded in 2005 and is based in Taizhou, China."
SY,2016-12-31,17932000,-81036000,NA,-81036000,80249000,23898000,-74283000,-74283000,NA,0,49090000,123373000,25192000,-6753000,NA,-81036000,-102523000,NA,income_statement,Health Information Services,So-Young International Inc. - A,"So-Young International Inc. operates an online platform for medical aesthetics and consumption healthcare services focusing on discretionary medical treatments. Its platform enables users to discover content and share their own experience on medical aesthetics procedures, and leads users to reserve treatment services from medical aesthetic service providers for offline treatment in the People's Republic of China and internationally. The company facilitates research on medical aesthetic treatment trends; ratings and reviews on treatment experiences; and blogs under the name Beauty Diaries. It also provides reservation services in the areas of dermatology, dentistry and orthodontics, ophthalmology, physical examinations, gynecology, human papilloma virus vaccines, and postnatal care; Software as a Service; and guiding and consulting services through training programs for medical service providers. As of December 31, 2019, the company had approximately 6,100 medical aesthetic service providers and 2,600 other consumption healthcare service providers on its platform. So-Young International Inc. was founded in 2013 and is headquartered in Beijing, China."
SY,2017-12-31,32557000,13221000,NA,17202000,157187000,214506000,24762000,24762000,NA,-3981000,259305000,234543000,44799000,-11541000,NA,17202000,-11319000,NA,income_statement,Health Information Services,So-Young International Inc. - A,"So-Young International Inc. operates an online platform for medical aesthetics and consumption healthcare services focusing on discretionary medical treatments. Its platform enables users to discover content and share their own experience on medical aesthetics procedures, and leads users to reserve treatment services from medical aesthetic service providers for offline treatment in the People's Republic of China and internationally. The company facilitates research on medical aesthetic treatment trends; ratings and reviews on treatment experiences; and blogs under the name Beauty Diaries. It also provides reservation services in the areas of dermatology, dentistry and orthodontics, ophthalmology, physical examinations, gynecology, human papilloma virus vaccines, and postnatal care; Software as a Service; and guiding and consulting services through training programs for medical service providers. As of December 31, 2019, the company had approximately 6,100 medical aesthetic service providers and 2,600 other consumption healthcare service providers on its platform. So-Young International Inc. was founded in 2013 and is headquartered in Beijing, China."
SY,2018-12-31,94726000,58254000,NA,55083000,381802000,525663000,49135000,49135000,NA,3171000,617226000,568091000,91563000,9119000,NA,55083000,-49128000,NA,income_statement,Health Information Services,So-Young International Inc. - A,"So-Young International Inc. operates an online platform for medical aesthetics and consumption healthcare services focusing on discretionary medical treatments. Its platform enables users to discover content and share their own experience on medical aesthetics procedures, and leads users to reserve treatment services from medical aesthetic service providers for offline treatment in the People's Republic of China and internationally. The company facilitates research on medical aesthetic treatment trends; ratings and reviews on treatment experiences; and blogs under the name Beauty Diaries. It also provides reservation services in the areas of dermatology, dentistry and orthodontics, ophthalmology, physical examinations, gynecology, human papilloma virus vaccines, and postnatal care; Software as a Service; and guiding and consulting services through training programs for medical service providers. As of December 31, 2019, the company had approximately 6,100 medical aesthetic service providers and 2,600 other consumption healthcare service providers on its platform. So-Young International Inc. was founded in 2013 and is headquartered in Beijing, China."
SY,2019-12-31,177268000,226459000,NA,176724000,630564000,953007000,145175000,145175000,NA,49735000,1151637000,1006462000,198630000,81284000,NA,176724000,126505000,NA,income_statement,Health Information Services,So-Young International Inc. - A,"So-Young International Inc. operates an online platform for medical aesthetics and consumption healthcare services focusing on discretionary medical treatments. Its platform enables users to discover content and share their own experience on medical aesthetics procedures, and leads users to reserve treatment services from medical aesthetic service providers for offline treatment in the People's Republic of China and internationally. The company facilitates research on medical aesthetic treatment trends; ratings and reviews on treatment experiences; and blogs under the name Beauty Diaries. It also provides reservation services in the areas of dermatology, dentistry and orthodontics, ophthalmology, physical examinations, gynecology, human papilloma virus vaccines, and postnatal care; Software as a Service; and guiding and consulting services through training programs for medical service providers. As of December 31, 2019, the company had approximately 6,100 medical aesthetic service providers and 2,600 other consumption healthcare service providers on its platform. So-Young International Inc. was founded in 2013 and is headquartered in Beijing, China."
SYBT,2017-12-31,NA,55182000,NA,38043000,74502000,138478000,0,56142000,NA,17139000,138478000,82336000,0,-960000,NA,38043000,38043000,7615000,income_statement,Banks—Regional,"Stock Yards Bancorp, Inc.","Stock Yards Bancorp, Inc. operates as the holding company for Stock Yards Bank & Trust Company that provides commercial and personal banking services in Louisville, Indianapolis, and Cincinnati. Its deposit products include demand deposits, savings deposits, money market deposits, and time deposits. The company's loan portfolio comprises commercial and industrial, construction and development, undeveloped land, real estate mortgage, and consumer loans. In addition, it offers securities brokerage services through an arrangement with a third party broker-dealer; and financial planning, investment management, retirement planning, trust, and estate services. As of December 31, 2019, the company had 42 full service banking locations, including 32 in the Louisville metropolitan statistical area (MSA), 5 in Indianapolis MSA, and 5 in Cincinnati MSA. Stock Yards Bancorp, Inc. was founded in 1904 and is headquartered in Louisville, Kentucky."
SYBT,2018-12-31,NA,67548000,NA,55517000,80023000,155319000,0,68008000,NA,12031000,155319000,87311000,0,-460000,NA,55517000,55517000,7040000,income_statement,Banks—Regional,"Stock Yards Bancorp, Inc.","Stock Yards Bancorp, Inc. operates as the holding company for Stock Yards Bank & Trust Company that provides commercial and personal banking services in Louisville, Indianapolis, and Cincinnati. Its deposit products include demand deposits, savings deposits, money market deposits, and time deposits. The company's loan portfolio comprises commercial and industrial, construction and development, undeveloped land, real estate mortgage, and consumer loans. In addition, it offers securities brokerage services through an arrangement with a third party broker-dealer; and financial planning, investment management, retirement planning, trust, and estate services. As of December 31, 2019, the company had 42 full service banking locations, including 32 in the Louisville metropolitan statistical area (MSA), 5 in Indianapolis MSA, and 5 in Cincinnati MSA. Stock Yards Bancorp, Inc. was founded in 1904 and is headquartered in Louisville, Kentucky."
SYBT,2019-12-31,NA,75660000,NA,66067000,86187000,171747000,0,76537000,NA,9593000,171747000,95210000,0,-877000,NA,66067000,66067000,8694000,income_statement,Banks—Regional,"Stock Yards Bancorp, Inc.","Stock Yards Bancorp, Inc. operates as the holding company for Stock Yards Bank & Trust Company that provides commercial and personal banking services in Louisville, Indianapolis, and Cincinnati. Its deposit products include demand deposits, savings deposits, money market deposits, and time deposits. The company's loan portfolio comprises commercial and industrial, construction and development, undeveloped land, real estate mortgage, and consumer loans. In addition, it offers securities brokerage services through an arrangement with a third party broker-dealer; and financial planning, investment management, retirement planning, trust, and estate services. As of December 31, 2019, the company had 42 full service banking locations, including 32 in the Louisville metropolitan statistical area (MSA), 5 in Indianapolis MSA, and 5 in Cincinnati MSA. Stock Yards Bancorp, Inc. was founded in 1904 and is headquartered in Louisville, Kentucky."
SYBT,2020-12-31,NA,67743000,NA,58869000,85899000,167806000,0,67743000,NA,8874000,167806000,100063000,0,0,NA,58869000,58869000,14164000,income_statement,Banks—Regional,"Stock Yards Bancorp, Inc.","Stock Yards Bancorp, Inc. operates as the holding company for Stock Yards Bank & Trust Company that provides commercial and personal banking services in Louisville, Indianapolis, and Cincinnati. Its deposit products include demand deposits, savings deposits, money market deposits, and time deposits. The company's loan portfolio comprises commercial and industrial, construction and development, undeveloped land, real estate mortgage, and consumer loans. In addition, it offers securities brokerage services through an arrangement with a third party broker-dealer; and financial planning, investment management, retirement planning, trust, and estate services. As of December 31, 2019, the company had 42 full service banking locations, including 32 in the Louisville metropolitan statistical area (MSA), 5 in Indianapolis MSA, and 5 in Cincinnati MSA. Stock Yards Bancorp, Inc. was founded in 1904 and is headquartered in Louisville, Kentucky."
SYBX,2016-12-31,15010000,-20954000,NA,-20954000,6398000,444000,-20964000,-20964000,-7000,0,444000,21408000,0,10000,NA,-20954000,-20954000,NA,income_statement,Biotechnology,"Synlogic, Inc.","Synlogic, Inc., a clinical-stage biopharmaceutical company, focuses on the discovery and development of synthetic biotic medicines to treat metabolic, inflammatory, and cancer diseases in the United States. Its therapeutic programs include SYNB1618, an oral therapy that is in Phase I/IIa clinical trial to treat phenylketonuria. The company is also developing SYNB1891, an intratumorally administered synthetic biotic medicine that is in Phase I clinical trial to treat solid tumors and lymphoma. It has a collaboration agreement with Ginkgo Bioworks for the development of synthetic biotic medicines. Synlogic, Inc. is headquartered in Cambridge, Massachusetts."
SYBX,2017-12-31,30341000,-40377000,NA,-40377000,12927000,2444000,-40824000,-40824000,-57000,0,2444000,43268000,0,447000,NA,-40377000,-40377000,NA,income_statement,Biotechnology,"Synlogic, Inc.","Synlogic, Inc., a clinical-stage biopharmaceutical company, focuses on the discovery and development of synthetic biotic medicines to treat metabolic, inflammatory, and cancer diseases in the United States. Its therapeutic programs include SYNB1618, an oral therapy that is in Phase I/IIa clinical trial to treat phenylketonuria. The company is also developing SYNB1891, an intratumorally administered synthetic biotic medicine that is in Phase I clinical trial to treat solid tumors and lymphoma. It has a collaboration agreement with Ginkgo Bioworks for the development of synthetic biotic medicines. Synlogic, Inc. is headquartered in Cambridge, Massachusetts."
SYBX,2018-12-31,23137000,-48435000,NA,-48435000,15716000,-12377000,-51230000,-51230000,-43000,0,2520000,53750000,14897000,2795000,NA,-48435000,-48435000,NA,income_statement,Biotechnology,"Synlogic, Inc.","Synlogic, Inc., a clinical-stage biopharmaceutical company, focuses on the discovery and development of synthetic biotic medicines to treat metabolic, inflammatory, and cancer diseases in the United States. Its therapeutic programs include SYNB1618, an oral therapy that is in Phase I/IIa clinical trial to treat phenylketonuria. The company is also developing SYNB1891, an intratumorally administered synthetic biotic medicine that is in Phase I clinical trial to treat solid tumors and lymphoma. It has a collaboration agreement with Ginkgo Bioworks for the development of synthetic biotic medicines. Synlogic, Inc. is headquartered in Cambridge, Massachusetts."
SYBX,2019-12-31,25040000,-51373000,NA,-51373000,14728000,-14641000,-54409000,-54409000,-21000,0,2224000,56633000,16865000,3036000,NA,-51373000,-51373000,NA,income_statement,Biotechnology,"Synlogic, Inc.","Synlogic, Inc., a clinical-stage biopharmaceutical company, focuses on the discovery and development of synthetic biotic medicines to treat metabolic, inflammatory, and cancer diseases in the United States. Its therapeutic programs include SYNB1618, an oral therapy that is in Phase I/IIa clinical trial to treat phenylketonuria. The company is also developing SYNB1891, an intratumorally administered synthetic biotic medicine that is in Phase I clinical trial to treat solid tumors and lymphoma. It has a collaboration agreement with Ginkgo Bioworks for the development of synthetic biotic medicines. Synlogic, Inc. is headquartered in Cambridge, Massachusetts."
SYF,2017-12-31,NA,3324000000,NA,1935000000,2804000000,7071000000,0,3637000000,NA,1389000000,7071000000,3434000000,0,-313000000,NA,1935000000,1935000000,630000000,income_statement,NA,NA,NA
SYF,2018-12-31,NA,3644000000,NA,2790000000,3187000000,7739000000,0,3883000000,NA,854000000,7739000000,3856000000,0,-239000000,NA,2790000000,2790000000,669000000,income_statement,NA,NA,NA
SYF,2019-12-31,NA,4887000000,NA,3747000000,3356000000,9132000000,0,5160000000,NA,1140000000,9132000000,3972000000,0,-273000000,NA,3747000000,3747000000,616000000,income_statement,NA,NA,NA
SYF,2020-12-31,NA,1797000000,NA,1385000000,3038000000,5852000000,0,2172000000,NA,412000000,5852000000,3680000000,0,-375000000,NA,1385000000,1343000000,642000000,income_statement,NA,NA,NA
SYK,2017-12-31,787000000,2063000000,14000000,1020000000,4380000000,8259000000,2721000000,2721000000,-247000000,1043000000,12444000000,9723000000,4185000000,-658000000,NA,1020000000,1020000000,NA,income_statement,NA,NA,NA
SYK,2018-12-31,862000000,2356000000,NA,3553000000,4808000000,8981000000,2894000000,2894000000,-264000000,-1197000000,13601000000,10707000000,4620000000,-538000000,NA,3553000000,3553000000,NA,income_statement,NA,NA,NA
SYK,2019-12-31,971000000,2562000000,NA,2083000000,4978000000,9801000000,3388000000,3388000000,-287000000,479000000,14884000000,11496000000,5083000000,-826000000,NA,2083000000,2083000000,NA,income_statement,NA,NA,NA
SYK,2020-12-31,984000000,1954000000,NA,1599000000,4759000000,9158000000,2943000000,2943000000,-315000000,355000000,14351000000,11408000000,5193000000,-989000000,NA,1599000000,1599000000,NA,income_statement,NA,NA,NA
SYKE,2016-12-31,NA,88884000,NA,62390000,377413000,540435000,94632000,94632000,-5570000,26494000,1460037000,1365405000,919602000,-5748000,NA,62390000,62390000,NA,income_statement,Information Technology Services,"Sykes Enterprises, Incorporated","Sykes Enterprises, Incorporated, together with its subsidiaries, provides multichannel demand generation and customer engagement solutions and services. The company's customer care services include handling billing inquiries and claims, activating customer accounts, resolving complaints, cross-selling/up-selling, and prequalifying and warranty management, as well as offers health information and dispatching roadside assistance. Its technical support services comprise support around complex networks, hardware and software, communications equipment, Internet access technology, and Internet portal usage. The company also provides customer acquisition services, which focuses around digital marketing, multichannel demand generation, and inbound up-selling and sales conversion, as well as outbound selling of its clients' products and services. In addition, it offers consulting, implementation, hosting, and managed services that help clients in back-office workflow; fulfillment services, such as order processing, inventory control, product delivery, and product returns handling; and enterprise support services comprising technical staffing services and outsourced corporate help desk solutions. The company provides its services through phone, email, social media, text messaging, chat, and digital self-service support. It serves corporations, medium-sized businesses, and public institutions in the financial services, communications, technology, transportation and leisure, healthcare, and other industries. The company operates in the United States, Canada, Latin America, Australia, the Asia Pacific Rim, Europe, the Middle East, and Africa. Sykes Enterprises, Incorporated was founded in 1977 and is headquartered in Tampa, Florida."
SYKE,2017-12-31,NA,81307000,NA,32216000,414089000,582839000,91696000,91696000,-7689000,49091000,1586008000,1494312000,1003169000,-10389000,NA,32216000,32216000,NA,income_statement,Information Technology Services,"Sykes Enterprises, Incorporated","Sykes Enterprises, Incorporated, together with its subsidiaries, provides multichannel demand generation and customer engagement solutions and services. The company's customer care services include handling billing inquiries and claims, activating customer accounts, resolving complaints, cross-selling/up-selling, and prequalifying and warranty management, as well as offers health information and dispatching roadside assistance. Its technical support services comprise support around complex networks, hardware and software, communications equipment, Internet access technology, and Internet portal usage. The company also provides customer acquisition services, which focuses around digital marketing, multichannel demand generation, and inbound up-selling and sales conversion, as well as outbound selling of its clients' products and services. In addition, it offers consulting, implementation, hosting, and managed services that help clients in back-office workflow; fulfillment services, such as order processing, inventory control, product delivery, and product returns handling; and enterprise support services comprising technical staffing services and outsourced corporate help desk solutions. The company provides its services through phone, email, social media, text messaging, chat, and digital self-service support. It serves corporations, medium-sized businesses, and public institutions in the financial services, communications, technology, transportation and leisure, healthcare, and other industries. The company operates in the United States, Canada, Latin America, Australia, the Asia Pacific Rim, Europe, the Middle East, and Africa. Sykes Enterprises, Incorporated was founded in 1977 and is headquartered in Tampa, Florida."
SYKE,2018-12-31,NA,56917000,NA,48926000,447630000,605728000,85206000,85206000,-4743000,7991000,1625687000,1540481000,1019959000,-28289000,NA,48926000,48926000,NA,income_statement,Information Technology Services,"Sykes Enterprises, Incorporated","Sykes Enterprises, Incorporated, together with its subsidiaries, provides multichannel demand generation and customer engagement solutions and services. The company's customer care services include handling billing inquiries and claims, activating customer accounts, resolving complaints, cross-selling/up-selling, and prequalifying and warranty management, as well as offers health information and dispatching roadside assistance. Its technical support services comprise support around complex networks, hardware and software, communications equipment, Internet access technology, and Internet portal usage. The company also provides customer acquisition services, which focuses around digital marketing, multichannel demand generation, and inbound up-selling and sales conversion, as well as outbound selling of its clients' products and services. In addition, it offers consulting, implementation, hosting, and managed services that help clients in back-office workflow; fulfillment services, such as order processing, inventory control, product delivery, and product returns handling; and enterprise support services comprising technical staffing services and outsourced corporate help desk solutions. The company provides its services through phone, email, social media, text messaging, chat, and digital self-service support. It serves corporations, medium-sized businesses, and public institutions in the financial services, communications, technology, transportation and leisure, healthcare, and other industries. The company operates in the United States, Canada, Latin America, Australia, the Asia Pacific Rim, Europe, the Middle East, and Africa. Sykes Enterprises, Incorporated was founded in 1977 and is headquartered in Tampa, Florida."
SYKE,2019-12-31,NA,85923000,NA,64081000,458885000,620024000,92584000,92584000,-4309000,21842000,1614762000,1522178000,994738000,-6661000,NA,64081000,64081000,NA,income_statement,Information Technology Services,"Sykes Enterprises, Incorporated","Sykes Enterprises, Incorporated, together with its subsidiaries, provides multichannel demand generation and customer engagement solutions and services. The company's customer care services include handling billing inquiries and claims, activating customer accounts, resolving complaints, cross-selling/up-selling, and prequalifying and warranty management, as well as offers health information and dispatching roadside assistance. Its technical support services comprise support around complex networks, hardware and software, communications equipment, Internet access technology, and Internet portal usage. The company also provides customer acquisition services, which focuses around digital marketing, multichannel demand generation, and inbound up-selling and sales conversion, as well as outbound selling of its clients' products and services. In addition, it offers consulting, implementation, hosting, and managed services that help clients in back-office workflow; fulfillment services, such as order processing, inventory control, product delivery, and product returns handling; and enterprise support services comprising technical staffing services and outsourced corporate help desk solutions. The company provides its services through phone, email, social media, text messaging, chat, and digital self-service support. It serves corporations, medium-sized businesses, and public institutions in the financial services, communications, technology, transportation and leisure, healthcare, and other industries. The company operates in the United States, Canada, Latin America, Australia, the Asia Pacific Rim, Europe, the Middle East, and Africa. Sykes Enterprises, Incorporated was founded in 1977 and is headquartered in Tampa, Florida."
SYNA,2017-06-24,292300000,61000000,NA,48800000,137600000,523600000,82000000,82000000,-6000000,12200000,1718200000,1636200000,1194600000,-21000000,NA,48800000,48800000,NA,income_statement,Semiconductors,Synaptics Incorporated,"Synaptics Incorporated develops, markets, and sells intuitive human interface solutions for electronic devices and products worldwide. The company offers ClearPad, which enables users to interact directly with the display on mobile smartphones, tablets, and automobiles; ClearView products that provide advanced image processing and low power technology for displays on electronic devices, including smartphones and tablets; TouchView products, which integrate touch and display technologies to deliver performance and simplified design; and Natural ID, a fingerprint ID product that is used in automobiles, notebook personal computers (PCs), PC peripherals, and other applications. It also provides TouchPad, a touch-sensitive pad that senses the position and movement of one or more fingers on its surface; SecurePad that integrates fingerprint sensor directly into the TouchPad area; ClickPad that offers a clickable mechanical design to the TouchPad solution; ForcePad, a thinner version of its ClickPad; AudioSmart personal voice and audio solutions; VideoSmart single-chip 4K UHD media processors for TVs, set-top boxes, and over-the-top streaming devices; and ImagingSmart solutions. In addition, the company offers TouchPad with a pointing stick in a single notebook computer enabling users to select their interface of choice; TouchStyk, a self-contained pointing stick module; and TouchButtons, which provides capacitive buttons and scrolling controls, as well as display interface products. The company sells its products through direct sales, outside sales representatives, distributors, and resellers. It serves mobile and PC original equipment manufacturers; Internet of Things manufacturers; and consumer electronics manufacturers. The company was founded in 1986 and is headquartered in San Jose, California."
SYNA,2018-06-30,363200000,-83600000,NA,-124100000,154000000,480100000,-49900000,-49900000,-22200000,40500000,1630300000,1680200000,1150200000,-33700000,NA,-124100000,-124100000,NA,income_statement,Semiconductors,Synaptics Incorporated,"Synaptics Incorporated develops, markets, and sells intuitive human interface solutions for electronic devices and products worldwide. The company offers ClearPad, which enables users to interact directly with the display on mobile smartphones, tablets, and automobiles; ClearView products that provide advanced image processing and low power technology for displays on electronic devices, including smartphones and tablets; TouchView products, which integrate touch and display technologies to deliver performance and simplified design; and Natural ID, a fingerprint ID product that is used in automobiles, notebook personal computers (PCs), PC peripherals, and other applications. It also provides TouchPad, a touch-sensitive pad that senses the position and movement of one or more fingers on its surface; SecurePad that integrates fingerprint sensor directly into the TouchPad area; ClickPad that offers a clickable mechanical design to the TouchPad solution; ForcePad, a thinner version of its ClickPad; AudioSmart personal voice and audio solutions; VideoSmart single-chip 4K UHD media processors for TVs, set-top boxes, and over-the-top streaming devices; and ImagingSmart solutions. In addition, the company offers TouchPad with a pointing stick in a single notebook computer enabling users to select their interface of choice; TouchStyk, a self-contained pointing stick module; and TouchButtons, which provides capacitive buttons and scrolling controls, as well as display interface products. The company sells its products through direct sales, outside sales representatives, distributors, and resellers. It serves mobile and PC original equipment manufacturers; Internet of Things manufacturers; and consumer electronics manufacturers. The company was founded in 1986 and is headquartered in San Jose, California."
SYNA,2019-06-29,342700000,-22600000,NA,-22900000,131300000,497100000,11400000,11400000,-21200000,300000,1472200000,1460800000,975100000,-34000000,NA,-22900000,-22900000,NA,income_statement,Semiconductors,Synaptics Incorporated,"Synaptics Incorporated develops, markets, and sells intuitive human interface solutions for electronic devices and products worldwide. The company offers ClearPad, which enables users to interact directly with the display on mobile smartphones, tablets, and automobiles; ClearView products that provide advanced image processing and low power technology for displays on electronic devices, including smartphones and tablets; TouchView products, which integrate touch and display technologies to deliver performance and simplified design; and Natural ID, a fingerprint ID product that is used in automobiles, notebook personal computers (PCs), PC peripherals, and other applications. It also provides TouchPad, a touch-sensitive pad that senses the position and movement of one or more fingers on its surface; SecurePad that integrates fingerprint sensor directly into the TouchPad area; ClickPad that offers a clickable mechanical design to the TouchPad solution; ForcePad, a thinner version of its ClickPad; AudioSmart personal voice and audio solutions; VideoSmart single-chip 4K UHD media processors for TVs, set-top boxes, and over-the-top streaming devices; and ImagingSmart solutions. In addition, the company offers TouchPad with a pointing stick in a single notebook computer enabling users to select their interface of choice; TouchStyk, a self-contained pointing stick module; and TouchButtons, which provides capacitive buttons and scrolling controls, as well as display interface products. The company sells its products through direct sales, outside sales representatives, distributors, and resellers. It serves mobile and PC original equipment manufacturers; Internet of Things manufacturers; and consumer electronics manufacturers. The company was founded in 1986 and is headquartered in San Jose, California."
SYNA,2020-06-27,302500000,157400000,NA,118800000,127000000,543100000,101900000,101900000,-22500000,38600000,1333900000,1232000000,790800000,55500000,NA,118800000,118800000,NA,income_statement,Semiconductors,Synaptics Incorporated,"Synaptics Incorporated develops, markets, and sells intuitive human interface solutions for electronic devices and products worldwide. The company offers ClearPad, which enables users to interact directly with the display on mobile smartphones, tablets, and automobiles; ClearView products that provide advanced image processing and low power technology for displays on electronic devices, including smartphones and tablets; TouchView products, which integrate touch and display technologies to deliver performance and simplified design; and Natural ID, a fingerprint ID product that is used in automobiles, notebook personal computers (PCs), PC peripherals, and other applications. It also provides TouchPad, a touch-sensitive pad that senses the position and movement of one or more fingers on its surface; SecurePad that integrates fingerprint sensor directly into the TouchPad area; ClickPad that offers a clickable mechanical design to the TouchPad solution; ForcePad, a thinner version of its ClickPad; AudioSmart personal voice and audio solutions; VideoSmart single-chip 4K UHD media processors for TVs, set-top boxes, and over-the-top streaming devices; and ImagingSmart solutions. In addition, the company offers TouchPad with a pointing stick in a single notebook computer enabling users to select their interface of choice; TouchStyk, a self-contained pointing stick module; and TouchButtons, which provides capacitive buttons and scrolling controls, as well as display interface products. The company sells its products through direct sales, outside sales representatives, distributors, and resellers. It serves mobile and PC original equipment manufacturers; Internet of Things manufacturers; and consumer electronics manufacturers. The company was founded in 1986 and is headquartered in San Jose, California."
SYNC,2016-12-31,25612000,-9521000,NA,-10740000,42207000,68227000,-8827000,-8827000,-318000,1219000,127373000,136200000,59146000,-694000,NA,-10740000,-10740000,NA,income_statement,Software—Infrastructure,"Synacor, Inc.","Synacor, Inc., a digital technology company, provides email and collaboration software, cloud-based identity management platforms, managed web and mobile portals, and advertising solutions in the United States and internationally. It operates through two segments, Software & Services, and Portal & Advertising. The company, through its managed portals and advertising solutions, enables its customers to earn revenue by monetizing media among their consumers. It also provides Cloud ID Authentication, a cloud-based identity and access management platform for large enterprises that offers native single sign on, home-based authentication, and device management to reduce login friction and enhance security; Email/Collaboration services, which include white-label hosting, security, and migration; and paid content and premium services. The company serves video, internet, and communications providers; device manufactures; media companies; government entities; enterprises; financial institutions; and small and medium sized businesses. It markets its products through direct and indirect sales channels. The company was formerly known as CKMP, Inc. and changed its name to Synacor, Inc. in July 2001. Synacor, Inc. was founded in 1998 and is headquartered in Buffalo, New York."
SYNC,2017-12-31,27642000,-8677000,NA,-9777000,42485000,69974000,-9973000,-9973000,-433000,1100000,140027000,150000000,70053000,1296000,NA,-9777000,-9777000,NA,income_statement,Software—Infrastructure,"Synacor, Inc.","Synacor, Inc., a digital technology company, provides email and collaboration software, cloud-based identity management platforms, managed web and mobile portals, and advertising solutions in the United States and internationally. It operates through two segments, Software & Services, and Portal & Advertising. The company, through its managed portals and advertising solutions, enables its customers to earn revenue by monetizing media among their consumers. It also provides Cloud ID Authentication, a cloud-based identity and access management platform for large enterprises that offers native single sign on, home-based authentication, and device management to reduce login friction and enhance security; Email/Collaboration services, which include white-label hosting, security, and migration; and paid content and premium services. The company serves video, internet, and communications providers; device manufactures; media companies; government entities; enterprises; financial institutions; and small and medium sized businesses. It markets its products through direct and indirect sales channels. The company was formerly known as CKMP, Inc. and changed its name to Synacor, Inc. in July 2001. Synacor, Inc. was founded in 1998 and is headquartered in Buffalo, New York."
SYNC,2018-12-31,23455000,-6939000,NA,-7555000,42051000,70575000,-4572000,-4572000,-338000,616000,143879000,148451000,73304000,-2367000,NA,-7555000,-7555000,NA,income_statement,Software—Infrastructure,"Synacor, Inc.","Synacor, Inc., a digital technology company, provides email and collaboration software, cloud-based identity management platforms, managed web and mobile portals, and advertising solutions in the United States and internationally. It operates through two segments, Software & Services, and Portal & Advertising. The company, through its managed portals and advertising solutions, enables its customers to earn revenue by monetizing media among their consumers. It also provides Cloud ID Authentication, a cloud-based identity and access management platform for large enterprises that offers native single sign on, home-based authentication, and device management to reduce login friction and enhance security; Email/Collaboration services, which include white-label hosting, security, and migration; and paid content and premium services. The company serves video, internet, and communications providers; device manufactures; media companies; government entities; enterprises; financial institutions; and small and medium sized businesses. It markets its products through direct and indirect sales channels. The company was formerly known as CKMP, Inc. and changed its name to Synacor, Inc. in July 2001. Synacor, Inc. was founded in 1998 and is headquartered in Buffalo, New York."
SYNC,2019-12-31,17903000,-8092000,NA,-9021000,36783000,60089000,-4462000,-4462000,-268000,929000,121845000,126307000,61756000,-3630000,NA,-9021000,-9021000,NA,income_statement,Software—Infrastructure,"Synacor, Inc.","Synacor, Inc., a digital technology company, provides email and collaboration software, cloud-based identity management platforms, managed web and mobile portals, and advertising solutions in the United States and internationally. It operates through two segments, Software & Services, and Portal & Advertising. The company, through its managed portals and advertising solutions, enables its customers to earn revenue by monetizing media among their consumers. It also provides Cloud ID Authentication, a cloud-based identity and access management platform for large enterprises that offers native single sign on, home-based authentication, and device management to reduce login friction and enhance security; Email/Collaboration services, which include white-label hosting, security, and migration; and paid content and premium services. The company serves video, internet, and communications providers; device manufactures; media companies; government entities; enterprises; financial institutions; and small and medium sized businesses. It markets its products through direct and indirect sales channels. The company was formerly known as CKMP, Inc. and changed its name to Synacor, Inc. in July 2001. Synacor, Inc. was founded in 1998 and is headquartered in Buffalo, New York."
SYNH,2017-12-31,NA,-111877000,NA,-138469000,282620000,620820000,126937000,126937000,-63725000,26592000,1852843000,1725906000,1232023000,-238814000,NA,-138469000,-138469000,NA,income_statement,Diagnostics & Research,"Syneos Health, Inc.","Syneos Health, Inc. operates as an integrated biopharmaceutical solutions company in North America, Europe, the Middle East, Africa, the Asia-Pacific, and Latin America. It operates through two segments, Clinical Solutions and Commercial Solutions. The Clinical Solutions segment offers various clinical development services spanning Phase I to Phase IV, including full-service global studies, as well as clinical monitoring, investigator recruitment, patient recruitment, data management, and study startup to assist customers with drug development process. The Commercial Solutions segment provides commercialization services, including medication adherence, communications solutions, and consulting services. Its customers include small, mid-sized, and large companies in the pharmaceutical, biotechnology, and medical device industries. Syneos Health, Inc. has a strategic agreement with Daiichi Sankyo, Inc. for the development of Daiichi Sankyo'S Adc oncology pipeline; and a partnership with VBI Vaccines Inc. for the commercialization of VBI's 3-antigen prophylactic hepatitis B vaccine in the United States, Europe, and Canada, which is in pending regulatory approvals. The company was formerly known as INC Research Holdings, Inc. and changed its name to Syneos Health, Inc. in January 2018. Syneos Health, Inc. was incorporated in 2010 and is headquartered in Morrisville, North Carolina."
SYNH,2018-12-31,NA,57258000,NA,24284000,406305000,955806000,275816000,275816000,-130701000,32974000,4390116000,4114300000,3434310000,-218558000,NA,24284000,24284000,NA,income_statement,Diagnostics & Research,"Syneos Health, Inc.","Syneos Health, Inc. operates as an integrated biopharmaceutical solutions company in North America, Europe, the Middle East, Africa, the Asia-Pacific, and Latin America. It operates through two segments, Clinical Solutions and Commercial Solutions. The Clinical Solutions segment offers various clinical development services spanning Phase I to Phase IV, including full-service global studies, as well as clinical monitoring, investigator recruitment, patient recruitment, data management, and study startup to assist customers with drug development process. The Commercial Solutions segment provides commercialization services, including medication adherence, communications solutions, and consulting services. Its customers include small, mid-sized, and large companies in the pharmaceutical, biotechnology, and medical device industries. Syneos Health, Inc. has a strategic agreement with Daiichi Sankyo, Inc. for the development of Daiichi Sankyo'S Adc oncology pipeline; and a partnership with VBI Vaccines Inc. for the commercialization of VBI's 3-antigen prophylactic hepatitis B vaccine in the United States, Europe, and Canada, which is in pending regulatory approvals. The company was formerly known as INC Research Holdings, Inc. and changed its name to Syneos Health, Inc. in January 2018. Syneos Health, Inc. was incorporated in 2010 and is headquartered in Morrisville, North Carolina."
SYNH,2019-12-31,NA,101709000,NA,131258000,446281000,1029910000,341164000,341164000,-129820000,-29549000,4675815000,4334651000,3645905000,-239455000,NA,131258000,131258000,NA,income_statement,Diagnostics & Research,"Syneos Health, Inc.","Syneos Health, Inc. operates as an integrated biopharmaceutical solutions company in North America, Europe, the Middle East, Africa, the Asia-Pacific, and Latin America. It operates through two segments, Clinical Solutions and Commercial Solutions. The Clinical Solutions segment offers various clinical development services spanning Phase I to Phase IV, including full-service global studies, as well as clinical monitoring, investigator recruitment, patient recruitment, data management, and study startup to assist customers with drug development process. The Commercial Solutions segment provides commercialization services, including medication adherence, communications solutions, and consulting services. Its customers include small, mid-sized, and large companies in the pharmaceutical, biotechnology, and medical device industries. Syneos Health, Inc. has a strategic agreement with Daiichi Sankyo, Inc. for the development of Daiichi Sankyo'S Adc oncology pipeline; and a partnership with VBI Vaccines Inc. for the commercialization of VBI's 3-antigen prophylactic hepatitis B vaccine in the United States, Europe, and Canada, which is in pending regulatory approvals. The company was formerly known as INC Research Holdings, Inc. and changed its name to Syneos Health, Inc. in January 2018. Syneos Health, Inc. was incorporated in 2010 and is headquartered in Morrisville, North Carolina."
SYNH,2020-12-31,NA,203658000,NA,192787000,442484000,1017635000,352799000,352799000,-91145000,10871000,4415777000,4062978000,3398142000,-149141000,NA,192787000,192787000,NA,income_statement,Diagnostics & Research,"Syneos Health, Inc.","Syneos Health, Inc. operates as an integrated biopharmaceutical solutions company in North America, Europe, the Middle East, Africa, the Asia-Pacific, and Latin America. It operates through two segments, Clinical Solutions and Commercial Solutions. The Clinical Solutions segment offers various clinical development services spanning Phase I to Phase IV, including full-service global studies, as well as clinical monitoring, investigator recruitment, patient recruitment, data management, and study startup to assist customers with drug development process. The Commercial Solutions segment provides commercialization services, including medication adherence, communications solutions, and consulting services. Its customers include small, mid-sized, and large companies in the pharmaceutical, biotechnology, and medical device industries. Syneos Health, Inc. has a strategic agreement with Daiichi Sankyo, Inc. for the development of Daiichi Sankyo'S Adc oncology pipeline; and a partnership with VBI Vaccines Inc. for the commercialization of VBI's 3-antigen prophylactic hepatitis B vaccine in the United States, Europe, and Canada, which is in pending regulatory approvals. The company was formerly known as INC Research Holdings, Inc. and changed its name to Syneos Health, Inc. in January 2018. Syneos Health, Inc. was incorporated in 2010 and is headquartered in Morrisville, North Carolina."
SYNL,2016-12-31,NA,-9191967,NA,-7093301,22507872,16904479,-5603393,-5603393,-945569,-2198000,138565782,144169175,121661303,-3588574,-99334,-6993967,-7093301,NA,income_statement,Steel,Synalloy Corporation,"Synalloy Corporation manufactures and sells metals and specialty chemicals in the United States and internationally. The company's Metals segment offers stainless steel, galvanized, and other alloy pipes and tubes under the BRISMET trade name; liquid storage solutions and separation equipment; and ornamental stainless steel tubes under the ASTI trade name, as well as distributes seamless carbon pipes and tubes. It serves oil and gas, chemical, petrochemical, pulp and paper, mining, power generation, water and waste water treatment, liquid natural gas, brewery, food processing, petroleum, pharmaceutical, automotive and commercial transportation, appliance, architectural, and other heavy industries. The company's Specialty Chemicals segment produces lubricants, surfactants, defoamers, reaction intermediaries, and sulfated fats and oils for the chemical, paper, metals, mining, agricultural, fiber, paint, textile, automotive, petroleum, cosmetics, mattress, furniture, janitorial, and other industries. It also provides chemical tolling manufacturing resources to chemical companies; and contracts with other chemical companies to manufacture pre-defined products. The company was formerly known as Blackman Uhler Industries, Inc. and changed its name to Synalloy Corporation in July 1967. Synalloy Corporation was founded in 1945 and is headquartered in Richmond, Virginia."
SYNL,2017-12-31,NA,1478000,NA,1341000,24875000,28081000,3206000,3206000,-889000,137000,201148000,197942000,173067000,-1728000,NA,1341000,1341000,NA,income_statement,Steel,Synalloy Corporation,"Synalloy Corporation manufactures and sells metals and specialty chemicals in the United States and internationally. The company's Metals segment offers stainless steel, galvanized, and other alloy pipes and tubes under the BRISMET trade name; liquid storage solutions and separation equipment; and ornamental stainless steel tubes under the ASTI trade name, as well as distributes seamless carbon pipes and tubes. It serves oil and gas, chemical, petrochemical, pulp and paper, mining, power generation, water and waste water treatment, liquid natural gas, brewery, food processing, petroleum, pharmaceutical, automotive and commercial transportation, appliance, architectural, and other heavy industries. The company's Specialty Chemicals segment produces lubricants, surfactants, defoamers, reaction intermediaries, and sulfated fats and oils for the chemical, paper, metals, mining, agricultural, fiber, paint, textile, automotive, petroleum, cosmetics, mattress, furniture, janitorial, and other industries. It also provides chemical tolling manufacturing resources to chemical companies; and contracts with other chemical companies to manufacture pre-defined products. The company was formerly known as Blackman Uhler Industries, Inc. and changed its name to Synalloy Corporation in July 1967. Synalloy Corporation was founded in 1945 and is headquartered in Richmond, Virginia."
SYNL,2018-12-31,NA,16473000,NA,13097000,27991000,51237000,23246000,23246000,-2191000,3376000,280841000,257595000,229604000,-6773000,NA,13097000,13097000,NA,income_statement,Steel,Synalloy Corporation,"Synalloy Corporation manufactures and sells metals and specialty chemicals in the United States and internationally. The company's Metals segment offers stainless steel, galvanized, and other alloy pipes and tubes under the BRISMET trade name; liquid storage solutions and separation equipment; and ornamental stainless steel tubes under the ASTI trade name, as well as distributes seamless carbon pipes and tubes. It serves oil and gas, chemical, petrochemical, pulp and paper, mining, power generation, water and waste water treatment, liquid natural gas, brewery, food processing, petroleum, pharmaceutical, automotive and commercial transportation, appliance, architectural, and other heavy industries. The company's Specialty Chemicals segment produces lubricants, surfactants, defoamers, reaction intermediaries, and sulfated fats and oils for the chemical, paper, metals, mining, agricultural, fiber, paint, textile, automotive, petroleum, cosmetics, mattress, furniture, janitorial, and other industries. It also provides chemical tolling manufacturing resources to chemical companies; and contracts with other chemical companies to manufacture pre-defined products. The company was formerly known as Blackman Uhler Industries, Inc. and changed its name to Synalloy Corporation in July 1967. Synalloy Corporation was founded in 1945 and is headquartered in Richmond, Virginia."
SYNL,2019-12-31,NA,-3763000,NA,-3036000,32627000,30773000,-1854000,-1854000,-3959000,-727000,305168000,307022000,274395000,-1909000,NA,-3036000,-3036000,NA,income_statement,Steel,Synalloy Corporation,"Synalloy Corporation manufactures and sells metals and specialty chemicals in the United States and internationally. The company's Metals segment offers stainless steel, galvanized, and other alloy pipes and tubes under the BRISMET trade name; liquid storage solutions and separation equipment; and ornamental stainless steel tubes under the ASTI trade name, as well as distributes seamless carbon pipes and tubes. It serves oil and gas, chemical, petrochemical, pulp and paper, mining, power generation, water and waste water treatment, liquid natural gas, brewery, food processing, petroleum, pharmaceutical, automotive and commercial transportation, appliance, architectural, and other heavy industries. The company's Specialty Chemicals segment produces lubricants, surfactants, defoamers, reaction intermediaries, and sulfated fats and oils for the chemical, paper, metals, mining, agricultural, fiber, paint, textile, automotive, petroleum, cosmetics, mattress, furniture, janitorial, and other industries. It also provides chemical tolling manufacturing resources to chemical companies; and contracts with other chemical companies to manufacture pre-defined products. The company was formerly known as Blackman Uhler Industries, Inc. and changed its name to Synalloy Corporation in July 1967. Synalloy Corporation was founded in 1945 and is headquartered in Richmond, Virginia."
SYPR,2016-12-31,330000,6344000,NA,6043000,21508000,749000,-21089000,-21089000,-4882000,301000,91797000,112886000,91048000,27433000,NA,6043000,5859000,NA,income_statement,Auto Parts,"Sypris Solutions, Inc.","Sypris Solutions, Inc. provides truck components, oil and gas pipeline components, and aerospace and defense electronics primarily in North America and Mexico. It operates through two segments, Sypris Technologies and Sypris Electronics. The Sypris Technologies segment supplies forged, machined, welded, and heat-treated steel components for the commercial vehicle, off highway vehicle, light truck, automotive, and energy markets. This segment also offers drive train components, including axle shafts, transmission shafts, gear sets, steer axle knuckles, and other components for automotive and truck manufacturers. In addition, it provides value added operations for drive train assemblies; and manufactures pressure closures and other fabricated products for oil and gas pipelines. The Sypris Electronics segment offers electronic manufacturing services, such as circuit card and full box build manufacturing, high reliability manufacturing, systems assembly and integration, design for manufacturability, and design for specification work for aerospace and defense electronics market. This segment also provides circuit card assembly services for electronic sensors and systems, including radar and targeting systems, tactical ground stations, navigation systems, weapons systems, and targeting and warning systems; and value added solutions, such as low-volume prototype assembly and high-volume turnkey manufacturing. The company also offers engineering design and repair or inspection services. In addition, it sells its engineered product under the Tube Turns brand. The company was incorporated in 1977 and is headquartered in Louisville, Kentucky."
SYPR,2017-12-31,38000,-11440000,NA,-10822000,13476000,3330000,-10184000,-10184000,-809000,-618000,82294000,92478000,78964000,-1256000,NA,-10822000,-10822000,NA,income_statement,Auto Parts,"Sypris Solutions, Inc.","Sypris Solutions, Inc. provides truck components, oil and gas pipeline components, and aerospace and defense electronics primarily in North America and Mexico. It operates through two segments, Sypris Technologies and Sypris Electronics. The Sypris Technologies segment supplies forged, machined, welded, and heat-treated steel components for the commercial vehicle, off highway vehicle, light truck, automotive, and energy markets. This segment also offers drive train components, including axle shafts, transmission shafts, gear sets, steer axle knuckles, and other components for automotive and truck manufacturers. In addition, it provides value added operations for drive train assemblies; and manufactures pressure closures and other fabricated products for oil and gas pipelines. The Sypris Electronics segment offers electronic manufacturing services, such as circuit card and full box build manufacturing, high reliability manufacturing, systems assembly and integration, design for manufacturability, and design for specification work for aerospace and defense electronics market. This segment also provides circuit card assembly services for electronic sensors and systems, including radar and targeting systems, tactical ground stations, navigation systems, weapons systems, and targeting and warning systems; and value added solutions, such as low-volume prototype assembly and high-volume turnkey manufacturing. The company also offers engineering design and repair or inspection services. In addition, it sells its engineered product under the Tube Turns brand. The company was incorporated in 1977 and is headquartered in Louisville, Kentucky."
SYPR,2018-12-31,NA,-3710000,NA,-3505000,11058000,7572000,-3486000,-3486000,-850000,-205000,87969000,91455000,80397000,-224000,NA,-3505000,-3505000,NA,income_statement,Auto Parts,"Sypris Solutions, Inc.","Sypris Solutions, Inc. provides truck components, oil and gas pipeline components, and aerospace and defense electronics primarily in North America and Mexico. It operates through two segments, Sypris Technologies and Sypris Electronics. The Sypris Technologies segment supplies forged, machined, welded, and heat-treated steel components for the commercial vehicle, off highway vehicle, light truck, automotive, and energy markets. This segment also offers drive train components, including axle shafts, transmission shafts, gear sets, steer axle knuckles, and other components for automotive and truck manufacturers. In addition, it provides value added operations for drive train assemblies; and manufactures pressure closures and other fabricated products for oil and gas pipelines. The Sypris Electronics segment offers electronic manufacturing services, such as circuit card and full box build manufacturing, high reliability manufacturing, systems assembly and integration, design for manufacturability, and design for specification work for aerospace and defense electronics market. This segment also provides circuit card assembly services for electronic sensors and systems, including radar and targeting systems, tactical ground stations, navigation systems, weapons systems, and targeting and warning systems; and value added solutions, such as low-volume prototype assembly and high-volume turnkey manufacturing. The company also offers engineering design and repair or inspection services. In addition, it sells its engineered product under the Tube Turns brand. The company was incorporated in 1977 and is headquartered in Louisville, Kentucky."
SYPR,2019-12-31,NA,-3953000,NA,-3949000,14650000,9883000,-4767000,-4767000,-903000,-4000,87891000,92658000,78008000,814000,NA,-3949000,-3949000,NA,income_statement,Auto Parts,"Sypris Solutions, Inc.","Sypris Solutions, Inc. provides truck components, oil and gas pipeline components, and aerospace and defense electronics primarily in North America and Mexico. It operates through two segments, Sypris Technologies and Sypris Electronics. The Sypris Technologies segment supplies forged, machined, welded, and heat-treated steel components for the commercial vehicle, off highway vehicle, light truck, automotive, and energy markets. This segment also offers drive train components, including axle shafts, transmission shafts, gear sets, steer axle knuckles, and other components for automotive and truck manufacturers. In addition, it provides value added operations for drive train assemblies; and manufactures pressure closures and other fabricated products for oil and gas pipelines. The Sypris Electronics segment offers electronic manufacturing services, such as circuit card and full box build manufacturing, high reliability manufacturing, systems assembly and integration, design for manufacturability, and design for specification work for aerospace and defense electronics market. This segment also provides circuit card assembly services for electronic sensors and systems, including radar and targeting systems, tactical ground stations, navigation systems, weapons systems, and targeting and warning systems; and value added solutions, such as low-volume prototype assembly and high-volume turnkey manufacturing. The company also offers engineering design and repair or inspection services. In addition, it sells its engineered product under the Tube Turns brand. The company was incorporated in 1977 and is headquartered in Louisville, Kentucky."
SYRS,2016-12-31,37817000,-47743000,NA,-47743000,10463000,317000,-47963000,-47963000,NA,0,317000,48280000,0,220000,NA,-47743000,-51424000,NA,income_statement,Biotechnology,"Syros Pharmaceuticals, Inc.","Syros Pharmaceuticals, Inc., a biopharmaceutical company, focuses on the development of treatments for cancer and monogenic diseases, and building a pipeline of gene control medicines. The company's lead product candidates are SY-1425, a selective retinoic acid receptor alpha agonist, which is in a Phase II clinical trial for genomically defined subset of patients with acute myeloid leukemia and myelodysplastic syndrome; and SY-5609, a cyclin-dependent kinase 7 inhibitor, which is in a Phase I clinical trial in patients with select advanced solid tumors. It has target discovery, research collaboration, and option agreement with Incyte Corporation to identify therapeutic targets with a focus on myeloproliferative neoplasms; and a license agreement with TMRC Co. Ltd. for the development and commercialization of tamibarotene. The company was formerly known as LS22, Inc. and changed its name to Syros Pharmaceuticals, Inc. in August 2012. Syros Pharmaceuticals, Inc. was founded in 2011 and is headquartered in Cambridge, Massachusetts."
SYRS,2017-12-31,41896000,-54010000,NA,-54010000,13891000,1101000,-54686000,-54686000,NA,0,1101000,55787000,0,676000,NA,-54010000,-54010000,NA,income_statement,Biotechnology,"Syros Pharmaceuticals, Inc.","Syros Pharmaceuticals, Inc., a biopharmaceutical company, focuses on the development of treatments for cancer and monogenic diseases, and building a pipeline of gene control medicines. The company's lead product candidates are SY-1425, a selective retinoic acid receptor alpha agonist, which is in a Phase II clinical trial for genomically defined subset of patients with acute myeloid leukemia and myelodysplastic syndrome; and SY-5609, a cyclin-dependent kinase 7 inhibitor, which is in a Phase I clinical trial in patients with select advanced solid tumors. It has target discovery, research collaboration, and option agreement with Incyte Corporation to identify therapeutic targets with a focus on myeloproliferative neoplasms; and a license agreement with TMRC Co. Ltd. for the development and commercialization of tamibarotene. The company was formerly known as LS22, Inc. and changed its name to Syros Pharmaceuticals, Inc. in August 2012. Syros Pharmaceuticals, Inc. was founded in 2011 and is headquartered in Cambridge, Massachusetts."
SYRS,2018-12-31,50182000,-62279000,NA,-62279000,16164000,2050000,-64296000,-64296000,NA,0,2050000,66346000,0,2017000,NA,-62279000,-62279000,NA,income_statement,Biotechnology,"Syros Pharmaceuticals, Inc.","Syros Pharmaceuticals, Inc., a biopharmaceutical company, focuses on the development of treatments for cancer and monogenic diseases, and building a pipeline of gene control medicines. The company's lead product candidates are SY-1425, a selective retinoic acid receptor alpha agonist, which is in a Phase II clinical trial for genomically defined subset of patients with acute myeloid leukemia and myelodysplastic syndrome; and SY-5609, a cyclin-dependent kinase 7 inhibitor, which is in a Phase I clinical trial in patients with select advanced solid tumors. It has target discovery, research collaboration, and option agreement with Incyte Corporation to identify therapeutic targets with a focus on myeloproliferative neoplasms; and a license agreement with TMRC Co. Ltd. for the development and commercialization of tamibarotene. The company was formerly known as LS22, Inc. and changed its name to Syros Pharmaceuticals, Inc. in August 2012. Syros Pharmaceuticals, Inc. was founded in 2011 and is headquartered in Cambridge, Massachusetts."
SYRS,2019-12-31,58245000,-75438000,NA,-75438000,21478000,1982000,-77741000,-77741000,NA,0,1982000,79723000,0,2303000,NA,-75438000,-75438000,NA,income_statement,Biotechnology,"Syros Pharmaceuticals, Inc.","Syros Pharmaceuticals, Inc., a biopharmaceutical company, focuses on the development of treatments for cancer and monogenic diseases, and building a pipeline of gene control medicines. The company's lead product candidates are SY-1425, a selective retinoic acid receptor alpha agonist, which is in a Phase II clinical trial for genomically defined subset of patients with acute myeloid leukemia and myelodysplastic syndrome; and SY-5609, a cyclin-dependent kinase 7 inhibitor, which is in a Phase I clinical trial in patients with select advanced solid tumors. It has target discovery, research collaboration, and option agreement with Incyte Corporation to identify therapeutic targets with a focus on myeloproliferative neoplasms; and a license agreement with TMRC Co. Ltd. for the development and commercialization of tamibarotene. The company was formerly known as LS22, Inc. and changed its name to Syros Pharmaceuticals, Inc. in August 2012. Syros Pharmaceuticals, Inc. was founded in 2011 and is headquartered in Cambridge, Massachusetts."
SYTA,2016-12-31,1005000,-2162708,NA,-2162708,3528920,2937557,-1446960,-1446960,-192660,0,12326414,13773374,9388857,-715748,NA,-2162708,-2162708,NA,income_statement,Communication Equipment,"Siyata Mobile, Inc.","Siyata Mobile Inc. develops and provides cellular communications solutions for enterprise customers. It offers vehicle mounted cellular based communications platforms over advanced 4G mobile networks. The company also provides 4G/LTE devices, such as Uniden UV350 and Uniden CP250, a vehicle communication device that delivers cellular voice calls, push-to-talk over cellular, data applications, navigation, built in camera, DVR, and others; and Uniden UR7, a 4G/LTE rugged smartphone for industrial users. In addition, it offers Uniden cellular signal boosters and accessories for homes, buildings, manufacturing facilities, and vehicles with poor cell coverage. The company serves cellular network operators and their dealers, as well as commercial vehicle technology distributors for fleets in Israel, Europe, Australia, New Zealand, Canada, and the United States. Siyata Mobile Inc. was incorporated in 1986 and is based in Montreal, Canada."
SYTA,2017-12-31,1005000,-5092495,NA,-5058495,6194423,3878745,-3688415,-3688415,-164099,-34000,17753006,21441421,13874261,-1404080,NA,-5058495,-5058495,NA,income_statement,Communication Equipment,"Siyata Mobile, Inc.","Siyata Mobile Inc. develops and provides cellular communications solutions for enterprise customers. It offers vehicle mounted cellular based communications platforms over advanced 4G mobile networks. The company also provides 4G/LTE devices, such as Uniden UV350 and Uniden CP250, a vehicle communication device that delivers cellular voice calls, push-to-talk over cellular, data applications, navigation, built in camera, DVR, and others; and Uniden UR7, a 4G/LTE rugged smartphone for industrial users. In addition, it offers Uniden cellular signal boosters and accessories for homes, buildings, manufacturing facilities, and vehicles with poor cell coverage. The company serves cellular network operators and their dealers, as well as commercial vehicle technology distributors for fleets in Israel, Europe, Australia, New Zealand, Canada, and the United States. Siyata Mobile Inc. was incorporated in 1986 and is based in Montreal, Canada."
SYTA,2018-12-31,1005000,-11527981,NA,-11527981,8378308,2059498,-8125872,-8125872,-833930,0,14220542,22346414,12161044,-3402109,NA,-11527981,-11527981,NA,income_statement,Communication Equipment,"Siyata Mobile, Inc.","Siyata Mobile Inc. develops and provides cellular communications solutions for enterprise customers. It offers vehicle mounted cellular based communications platforms over advanced 4G mobile networks. The company also provides 4G/LTE devices, such as Uniden UV350 and Uniden CP250, a vehicle communication device that delivers cellular voice calls, push-to-talk over cellular, data applications, navigation, built in camera, DVR, and others; and Uniden UR7, a 4G/LTE rugged smartphone for industrial users. In addition, it offers Uniden cellular signal boosters and accessories for homes, buildings, manufacturing facilities, and vehicles with poor cell coverage. The company serves cellular network operators and their dealers, as well as commercial vehicle technology distributors for fleets in Israel, Europe, Australia, New Zealand, Canada, and the United States. Siyata Mobile Inc. was incorporated in 1986 and is based in Montreal, Canada."
SYTA,2019-12-31,1005000,-10160351,NA,-10160351,7805202,3287215,-8563907,-8563907,-935314,0,13019792,21583699,9732577,-1596444,NA,-10160351,-10160351,NA,income_statement,Communication Equipment,"Siyata Mobile, Inc.","Siyata Mobile Inc. develops and provides cellular communications solutions for enterprise customers. It offers vehicle mounted cellular based communications platforms over advanced 4G mobile networks. The company also provides 4G/LTE devices, such as Uniden UV350 and Uniden CP250, a vehicle communication device that delivers cellular voice calls, push-to-talk over cellular, data applications, navigation, built in camera, DVR, and others; and Uniden UR7, a 4G/LTE rugged smartphone for industrial users. In addition, it offers Uniden cellular signal boosters and accessories for homes, buildings, manufacturing facilities, and vehicles with poor cell coverage. The company serves cellular network operators and their dealers, as well as commercial vehicle technology distributors for fleets in Israel, Europe, Australia, New Zealand, Canada, and the United States. Siyata Mobile Inc. was incorporated in 1986 and is based in Montreal, Canada."
SYY,2017-07-01,NA,1766230000,82839000,1142503000,8504291000,10557507000,2053216000,2053216000,-302878000,623727000,55371139000,53317923000,44813632000,-286986000,NA,1142503000,1142503000,NA,income_statement,NA,NA,NA
SYY,2018-06-30,NA,1956224000,37649000,1430766000,8735275000,11085391000,2350116000,2350116000,-395483000,525458000,58727324000,56377208000,47641933000,-393892000,NA,1430766000,1430766000,NA,income_statement,NA,NA,NA
SYY,2019-06-29,NA,2005836000,35426000,1674271000,8779693000,11408987000,2629294000,2629294000,-360423000,331565000,60113922000,57484628000,48704935000,-623458000,NA,1674271000,1674271000,NA,income_statement,NA,NA,NA
SYY,2020-06-27,NA,293384000,34265000,215475000,8238103000,9901664000,1625276000,1625276000,-408220000,77909000,52893310000,51268034000,42991646000,-1331892000,NA,215475000,215475000,NA,income_statement,NA,NA,NA
T,2017-12-31,NA,15139000000,1146000000,29450000000,34354000000,82736000000,23995000000,23995000000,-6300000000,-14708000000,160546000000,136551000000,77810000000,-8856000000,NA,29847000000,29450000000,NA,income_statement,NA,NA,NA
T,2018-12-31,NA,24873000000,9795000000,19370000000,31289000000,91337000000,31618000000,31618000000,-7957000000,4920000000,170756000000,139138000000,79419000000,-6745000000,NA,19953000000,19370000000,NA,income_statement,NA,NA,NA
T,2019-12-31,NA,18468000000,17713000000,13903000000,41094000000,97052000000,27741000000,27741000000,-8422000000,3493000000,181193000000,153452000000,84141000000,-9273000000,NA,14975000000,13900000000,NA,income_statement,NA,NA,NA
T,2020-12-31,NA,-2856000000,17567000000,-5176000000,38039000000,91840000000,25285000000,25285000000,-7925000000,965000000,171760000000,146475000000,79920000000,-28141000000,NA,-3821000000,-5369000000,NA,income_statement,NA,NA,NA
TA,2016-12-31,NA,-3662000,1398000,-2018000,401350000,515799000,22060000,22060000,-27815000,-1733000,5451124000,5429064000,4935325000,-25722000,-10619000,-1929000,-1918000,-70229000,income_statement,Specialty Retail,TravelCenters of America Inc.,"TravelCenters of America Inc. operates travel centers and standalone restaurants in the United States and Canada. Its travel centers offer a range of products and services, including diesel fuel and gasoline, as well as nonfuel products and services, such as truck repair and maintenance services, full service restaurants, quick service restaurants, and various customer amenities. As of October 28, 2020, it operated 270 locations in 44 states and Canada primarily under the TA, Petro Stopping Centers, and TA Express brands; and 650 full-service and quick-service restaurants and 10 proprietary brands, including Quaker Steak and Lube, Iron Skillet, and Country Pride. The company serves trucking fleets and their drivers, independent truck drivers, highway and local motorists, and casual diners. TravelCenters of America Inc. was founded in 1972 and is based in Westlake, Ohio."
TA,2017-12-31,NA,-60348000,1447000,9151000,411159000,479017000,-14748000,-14748000,-30016000,-80250000,5316897000,5331645000,4837880000,-45600000,-10619000,19902000,8123000,-70229000,income_statement,Specialty Retail,TravelCenters of America Inc.,"TravelCenters of America Inc. operates travel centers and standalone restaurants in the United States and Canada. Its travel centers offer a range of products and services, including diesel fuel and gasoline, as well as nonfuel products and services, such as truck repair and maintenance services, full service restaurants, quick service restaurants, and various customer amenities. As of October 28, 2020, it operated 270 locations in 44 states and Canada primarily under the TA, Petro Stopping Centers, and TA Express brands; and 650 full-service and quick-service restaurants and 10 proprietary brands, including Quaker Steak and Lube, Iron Skillet, and Country Pride. The company serves trucking fleets and their drivers, independent truck drivers, highway and local motorists, and casual diners. TravelCenters of America Inc. was founded in 1972 and is based in Westlake, Ohio."
TA,2018-12-31,NA,-4347000,1495000,-120553000,431503000,531316000,16634000,16634000,-29003000,-1574000,6232215000,6215581000,5700899000,-20981000,-117631000,-2773000,-120428000,-70229000,income_statement,Specialty Retail,TravelCenters of America Inc.,"TravelCenters of America Inc. operates travel centers and standalone restaurants in the United States and Canada. Its travel centers offer a range of products and services, including diesel fuel and gasoline, as well as nonfuel products and services, such as truck repair and maintenance services, full service restaurants, quick service restaurants, and various customer amenities. As of October 28, 2020, it operated 270 locations in 44 states and Canada primarily under the TA, Petro Stopping Centers, and TA Express brands; and 650 full-service and quick-service restaurants and 10 proprietary brands, including Quaker Steak and Lube, Iron Skillet, and Country Pride. The company serves trucking fleets and their drivers, independent truck drivers, highway and local motorists, and casual diners. TravelCenters of America Inc. was founded in 1972 and is based in Westlake, Ohio."
TA,2019-12-31,NA,37808000,1483000,33345000,412657000,511391000,71072000,71072000,-28356000,4339000,6117359000,6046287000,5605968000,-33264000,NA,33469000,32044000,-70229000,income_statement,Specialty Retail,TravelCenters of America Inc.,"TravelCenters of America Inc. operates travel centers and standalone restaurants in the United States and Canada. Its travel centers offer a range of products and services, including diesel fuel and gasoline, as well as nonfuel products and services, such as truck repair and maintenance services, full service restaurants, quick service restaurants, and various customer amenities. As of October 28, 2020, it operated 270 locations in 44 states and Canada primarily under the TA, Petro Stopping Centers, and TA Express brands; and 650 full-service and quick-service restaurants and 10 proprietary brands, including Quaker Steak and Lube, Iron Skillet, and Country Pride. The company serves trucking fleets and their drivers, independent truck drivers, highway and local motorists, and casual diners. TravelCenters of America Inc. was founded in 1972 and is based in Westlake, Ohio."
TACO,2017-01-03,NA,36242000,NA,20913000,54420000,122327000,44047000,44047000,-6327000,15329000,452083000,408036000,329756000,-7805000,NA,20913000,20913000,NA,income_statement,Restaurants,"Del Taco Restaurants, Inc.","Del Taco Restaurants, Inc. develops, franchises, owns, and operates Del Taco quick-service Mexican-American restaurants in the United States. The company's restaurants offer Mexican inspired and American classic dishes. As of February 18, 2021, it operated approximately 600 restaurants across 16 states. The company was founded in 1964 and is headquartered in Lake Forest, California."
TACO,2018-01-02,NA,34047000,NA,49871000,38154000,105620000,42513000,42513000,-7200000,-15824000,471456000,428943000,365836000,-8466000,NA,49871000,49871000,NA,income_statement,Restaurants,"Del Taco Restaurants, Inc.","Del Taco Restaurants, Inc. develops, franchises, owns, and operates Del Taco quick-service Mexican-American restaurants in the United States. The company's restaurants offer Mexican inspired and American classic dishes. As of February 18, 2021, it operated approximately 600 restaurants across 16 states. The company was founded in 1964 and is headquartered in Lake Forest, California."
TACO,2019-01-01,NA,25618000,NA,18959000,43773000,110451000,39300000,39300000,-9075000,6659000,505490000,466190000,395039000,-13682000,NA,18959000,18959000,NA,income_statement,Restaurants,"Del Taco Restaurants, Inc.","Del Taco Restaurants, Inc. develops, franchises, owns, and operates Del Taco quick-service Mexican-American restaurants in the United States. The company's restaurants offer Mexican inspired and American classic dishes. As of February 18, 2021, it operated approximately 600 restaurants across 16 states. The company was founded in 1964 and is headquartered in Lake Forest, California."
TACO,2019-12-31,NA,-113914000,NA,-118285000,43439000,101790000,31213000,31213000,-7235000,4371000,512951000,481738000,411161000,-145127000,NA,-118285000,-118285000,NA,income_statement,Restaurants,"Del Taco Restaurants, Inc.","Del Taco Restaurants, Inc. develops, franchises, owns, and operates Del Taco quick-service Mexican-American restaurants in the United States. The company's restaurants offer Mexican inspired and American classic dishes. As of February 18, 2021, it operated approximately 600 restaurants across 16 states. The company was founded in 1964 and is headquartered in Lake Forest, California."
TACT,2016-12-31,4425000,5170000,NA,3617000,14174000,23799000,5200000,5200000,-33000,1553000,57235000,52035000,33436000,-30000,NA,3617000,3617000,NA,income_statement,Computer Hardware,TransAct Technologies Incorpora,"TransAct Technologies Incorporated designs, develops, and markets transaction-based and specialty printers and terminals in the United States and internationally. Its thermal and inkjet printers and terminals to generates labels, coupons, and transaction records, such as receipts, tickets, and other documents, as well as printed logging and plotting of data. The company also provides consumable products, including inkjet cartridges, ribbons, receipt papers, color thermal papers, and other printing supplies, as well as replacement parts; maintenance, repair, and testing services; and refurbished printers. In addition, it offers EPICENTRAL print system, a software solution that enables casino operators to create promotional coupons and marketing messages, and print them at the slot machine; and technical support services, as well as spare parts and accessories. Further, the company provides BOHA! terminal for the food service technology solution market that combines hardware and software components in a device that includes an operating system, touchscreen, and one or two thermal print mechanisms. It markets its products under the BOHA!, AccuDate, Epic, EPICENTRAL, Ithaca, and Printrex brand names for restaurant, point of sale automation and banking, casino and gaming, lottery, oil and gas, and hospitality markets, as well as government. The company sells its products to original equipment manufacturers, resellers, and distributors, as well as directly to end-users through online Webstore transactsupplies.com. TransAct Technologies Incorporated was founded in 1996 and is headquartered in Hamden, Connecticut."
TACT,2017-12-31,4303000,6772000,NA,3211000,15545000,26662000,6814000,6814000,-33000,3561000,56311000,49497000,29649000,-42000,NA,3211000,3211000,NA,income_statement,Computer Hardware,TransAct Technologies Incorpora,"TransAct Technologies Incorporated designs, develops, and markets transaction-based and specialty printers and terminals in the United States and internationally. Its thermal and inkjet printers and terminals to generates labels, coupons, and transaction records, such as receipts, tickets, and other documents, as well as printed logging and plotting of data. The company also provides consumable products, including inkjet cartridges, ribbons, receipt papers, color thermal papers, and other printing supplies, as well as replacement parts; maintenance, repair, and testing services; and refurbished printers. In addition, it offers EPICENTRAL print system, a software solution that enables casino operators to create promotional coupons and marketing messages, and print them at the slot machine; and technical support services, as well as spare parts and accessories. Further, the company provides BOHA! terminal for the food service technology solution market that combines hardware and software components in a device that includes an operating system, touchscreen, and one or two thermal print mechanisms. It markets its products under the BOHA!, AccuDate, Epic, EPICENTRAL, Ithaca, and Printrex brand names for restaurant, point of sale automation and banking, casino and gaming, lottery, oil and gas, and hospitality markets, as well as government. The company sells its products to original equipment manufacturers, resellers, and distributors, as well as directly to end-users through online Webstore transactsupplies.com. TransAct Technologies Incorporated was founded in 1996 and is headquartered in Hamden, Connecticut."
TACT,2018-12-31,4576000,6466000,NA,5426000,15408000,26743000,6759000,6759000,-27000,1040000,54587000,47828000,27844000,-293000,NA,5426000,5426000,NA,income_statement,Computer Hardware,TransAct Technologies Incorpora,"TransAct Technologies Incorporated designs, develops, and markets transaction-based and specialty printers and terminals in the United States and internationally. Its thermal and inkjet printers and terminals to generates labels, coupons, and transaction records, such as receipts, tickets, and other documents, as well as printed logging and plotting of data. The company also provides consumable products, including inkjet cartridges, ribbons, receipt papers, color thermal papers, and other printing supplies, as well as replacement parts; maintenance, repair, and testing services; and refurbished printers. In addition, it offers EPICENTRAL print system, a software solution that enables casino operators to create promotional coupons and marketing messages, and print them at the slot machine; and technical support services, as well as spare parts and accessories. Further, the company provides BOHA! terminal for the food service technology solution market that combines hardware and software components in a device that includes an operating system, touchscreen, and one or two thermal print mechanisms. It markets its products under the BOHA!, AccuDate, Epic, EPICENTRAL, Ithaca, and Printrex brand names for restaurant, point of sale automation and banking, casino and gaming, lottery, oil and gas, and hospitality markets, as well as government. The company sells its products to original equipment manufacturers, resellers, and distributors, as well as directly to end-users through online Webstore transactsupplies.com. TransAct Technologies Incorporated was founded in 1996 and is headquartered in Hamden, Connecticut."
TACT,2019-12-31,4393000,367000,NA,516000,17199000,21935000,343000,343000,-28000,-149000,45748000,45405000,23813000,24000,NA,516000,516000,NA,income_statement,Computer Hardware,TransAct Technologies Incorpora,"TransAct Technologies Incorporated designs, develops, and markets transaction-based and specialty printers and terminals in the United States and internationally. Its thermal and inkjet printers and terminals to generates labels, coupons, and transaction records, such as receipts, tickets, and other documents, as well as printed logging and plotting of data. The company also provides consumable products, including inkjet cartridges, ribbons, receipt papers, color thermal papers, and other printing supplies, as well as replacement parts; maintenance, repair, and testing services; and refurbished printers. In addition, it offers EPICENTRAL print system, a software solution that enables casino operators to create promotional coupons and marketing messages, and print them at the slot machine; and technical support services, as well as spare parts and accessories. Further, the company provides BOHA! terminal for the food service technology solution market that combines hardware and software components in a device that includes an operating system, touchscreen, and one or two thermal print mechanisms. It markets its products under the BOHA!, AccuDate, Epic, EPICENTRAL, Ithaca, and Printrex brand names for restaurant, point of sale automation and banking, casino and gaming, lottery, oil and gas, and hospitality markets, as well as government. The company sells its products to original equipment manufacturers, resellers, and distributors, as well as directly to end-users through online Webstore transactsupplies.com. TransAct Technologies Incorporated was founded in 1996 and is headquartered in Hamden, Connecticut."
TAIT,2016-12-31,NA,-3098000,104000,-3111000,2124000,-748000,-2872000,-2872000,-48000,20000,6915000,9787000,7663000,-226000,NA,-3118000,-3111000,NA,income_statement,Electronics & Computer Distribution,Taitron Components Incorporated,"Taitron Components Incorporated engages in the supply of original designed and manufactured (ODM) electronic components, and distribution of brand name electronic components. It distributes discrete semiconductors, commodity integrated circuits, optoelectronic devices, and passive components. The company also provides value-added engineering and turn-key solutions focusing on providing contract electronic manufacturers (CEMs) and original equipment manufacturers (OEMs) with ODM services for their turn-key projects. It serves other electronic distributors, CEMs, and OEMs in the United States, South Korea, China, Taiwan, and internationally. The company has strategic alliances with Teamforce Co. Ltd.; Grand Shine Management Limited; and Zowie Technology Corporation. Taitron Components Incorporated was founded in 1989 and is headquartered in Valencia, California."
TAIT,2017-12-31,NA,701000,100000,701000,2209000,3000000,791000,791000,-38000,5000,7622000,6831000,4622000,-90000,NA,696000,701000,NA,income_statement,Electronics & Computer Distribution,Taitron Components Incorporated,"Taitron Components Incorporated engages in the supply of original designed and manufactured (ODM) electronic components, and distribution of brand name electronic components. It distributes discrete semiconductors, commodity integrated circuits, optoelectronic devices, and passive components. The company also provides value-added engineering and turn-key solutions focusing on providing contract electronic manufacturers (CEMs) and original equipment manufacturers (OEMs) with ODM services for their turn-key projects. It serves other electronic distributors, CEMs, and OEMs in the United States, South Korea, China, Taiwan, and internationally. The company has strategic alliances with Teamforce Co. Ltd.; Grand Shine Management Limited; and Zowie Technology Corporation. Taitron Components Incorporated was founded in 1989 and is headquartered in Valencia, California."
TAIT,2018-12-31,NA,1376000,96000,1378000,2199000,3618000,1419000,1419000,NA,6000,8222000,6803000,4604000,-43000,NA,1370000,1378000,NA,income_statement,Electronics & Computer Distribution,Taitron Components Incorporated,"Taitron Components Incorporated engages in the supply of original designed and manufactured (ODM) electronic components, and distribution of brand name electronic components. It distributes discrete semiconductors, commodity integrated circuits, optoelectronic devices, and passive components. The company also provides value-added engineering and turn-key solutions focusing on providing contract electronic manufacturers (CEMs) and original equipment manufacturers (OEMs) with ODM services for their turn-key projects. It serves other electronic distributors, CEMs, and OEMs in the United States, South Korea, China, Taiwan, and internationally. The company has strategic alliances with Teamforce Co. Ltd.; Grand Shine Management Limited; and Zowie Technology Corporation. Taitron Components Incorporated was founded in 1989 and is headquartered in Valencia, California."
TAIT,2019-12-31,NA,806000,100000,773000,2378000,3076000,698000,698000,NA,0,6783000,6085000,3707000,108000,NA,806000,773000,NA,income_statement,Electronics & Computer Distribution,Taitron Components Incorporated,"Taitron Components Incorporated engages in the supply of original designed and manufactured (ODM) electronic components, and distribution of brand name electronic components. It distributes discrete semiconductors, commodity integrated circuits, optoelectronic devices, and passive components. The company also provides value-added engineering and turn-key solutions focusing on providing contract electronic manufacturers (CEMs) and original equipment manufacturers (OEMs) with ODM services for their turn-key projects. It serves other electronic distributors, CEMs, and OEMs in the United States, South Korea, China, Taiwan, and internationally. The company has strategic alliances with Teamforce Co. Ltd.; Grand Shine Management Limited; and Zowie Technology Corporation. Taitron Components Incorporated was founded in 1989 and is headquartered in Valencia, California."
TANH,2016-12-31,136626,8332830,8799460,4299251,4235107,13023026,8651293,8651293,-470656,1367270,39902342,31251049,26879316,-318463,-2357867,6965560,4299251,NA,income_statement,Household & Personal Products,Tantech Holdings Ltd.,"Tantech Holdings Ltd. develops and manufactures bamboo-based charcoal products for industrial energy, household cooking, heating, purification, agricultural, and cleaning applications in the People's Republic of China and internationally. The company operates in three segments: Consumer Products, Trading, and Electric Vehicle. It provides pressed and formed charcoal briquettes for use in grills, incense burners, and other applications under the Algold brand. The company also offers Charcoal Doctor branded products, such as air purifiers and humidifiers, automotive accessories for air purification, underfloor humidity control products, pillows and mattresses, wardrobe deodorizers, mouse pads and wrist mats, refrigerator deodorants, charcoal toilet cleaner disks, liquid charcoal cleaners, shoe insoles, and decorative charcoal gifts. In addition, it provides bamboo vinegar, a liquid byproduct for use in disinfectants, detergents, lotions, specialized soaps, toilet cleaners, and fertilizers, as well as in various agricultural applications; and trades in charcoal products. Further, the company develops, manufactures, and sells electric buses and specialty electric vehicles, such as electric logistics cars, brushless cleaning cars, electric cleaning cars, special emergency vehicles, and funeral cars; and solar cells, lithium-ion batteries, auto parts, and electric control systems. Tantech Holdings Ltd. was founded in 2001 and is headquartered in Lishui, the People's Republic of China."
TANH,2017-12-31,627577,4475584,8799460,3767215,5356397,10555859,4571885,4571885,-551044,1528003,42297612,37725727,31741753,-96301,65550,2947581,3767215,NA,income_statement,Household & Personal Products,Tantech Holdings Ltd.,"Tantech Holdings Ltd. develops and manufactures bamboo-based charcoal products for industrial energy, household cooking, heating, purification, agricultural, and cleaning applications in the People's Republic of China and internationally. The company operates in three segments: Consumer Products, Trading, and Electric Vehicle. It provides pressed and formed charcoal briquettes for use in grills, incense burners, and other applications under the Algold brand. The company also offers Charcoal Doctor branded products, such as air purifiers and humidifiers, automotive accessories for air purification, underfloor humidity control products, pillows and mattresses, wardrobe deodorizers, mouse pads and wrist mats, refrigerator deodorants, charcoal toilet cleaner disks, liquid charcoal cleaners, shoe insoles, and decorative charcoal gifts. In addition, it provides bamboo vinegar, a liquid byproduct for use in disinfectants, detergents, lotions, specialized soaps, toilet cleaners, and fertilizers, as well as in various agricultural applications; and trades in charcoal products. Further, the company develops, manufactures, and sells electric buses and specialty electric vehicles, such as electric logistics cars, brushless cleaning cars, electric cleaning cars, special emergency vehicles, and funeral cars; and solar cells, lithium-ion batteries, auto parts, and electric control systems. Tantech Holdings Ltd. was founded in 2001 and is headquartered in Lishui, the People's Republic of China."
TANH,2018-12-31,386628,2027789,7918096,1976767,5292283,8029080,2350169,2350169,-626343,1031158,29561399,27211230,21532319,-322380,83367,996631,1976767,NA,income_statement,Household & Personal Products,Tantech Holdings Ltd.,"Tantech Holdings Ltd. develops and manufactures bamboo-based charcoal products for industrial energy, household cooking, heating, purification, agricultural, and cleaning applications in the People's Republic of China and internationally. The company operates in three segments: Consumer Products, Trading, and Electric Vehicle. It provides pressed and formed charcoal briquettes for use in grills, incense burners, and other applications under the Algold brand. The company also offers Charcoal Doctor branded products, such as air purifiers and humidifiers, automotive accessories for air purification, underfloor humidity control products, pillows and mattresses, wardrobe deodorizers, mouse pads and wrist mats, refrigerator deodorants, charcoal toilet cleaner disks, liquid charcoal cleaners, shoe insoles, and decorative charcoal gifts. In addition, it provides bamboo vinegar, a liquid byproduct for use in disinfectants, detergents, lotions, specialized soaps, toilet cleaners, and fertilizers, as well as in various agricultural applications; and trades in charcoal products. Further, the company develops, manufactures, and sells electric buses and specialty electric vehicles, such as electric logistics cars, brushless cleaning cars, electric cleaning cars, special emergency vehicles, and funeral cars; and solar cells, lithium-ion batteries, auto parts, and electric control systems. Tantech Holdings Ltd. was founded in 2001 and is headquartered in Lishui, the People's Republic of China."
TANH,2019-12-31,327260,-9295621,4346216,-6356967,4975328,5977500,674912,674912,-443262,363662,49230570,48555658,43253070,-9970533,-299412,-9659283,-6356967,NA,income_statement,Household & Personal Products,Tantech Holdings Ltd.,"Tantech Holdings Ltd. develops and manufactures bamboo-based charcoal products for industrial energy, household cooking, heating, purification, agricultural, and cleaning applications in the People's Republic of China and internationally. The company operates in three segments: Consumer Products, Trading, and Electric Vehicle. It provides pressed and formed charcoal briquettes for use in grills, incense burners, and other applications under the Algold brand. The company also offers Charcoal Doctor branded products, such as air purifiers and humidifiers, automotive accessories for air purification, underfloor humidity control products, pillows and mattresses, wardrobe deodorizers, mouse pads and wrist mats, refrigerator deodorants, charcoal toilet cleaner disks, liquid charcoal cleaners, shoe insoles, and decorative charcoal gifts. In addition, it provides bamboo vinegar, a liquid byproduct for use in disinfectants, detergents, lotions, specialized soaps, toilet cleaners, and fertilizers, as well as in various agricultural applications; and trades in charcoal products. Further, the company develops, manufactures, and sells electric buses and specialty electric vehicles, such as electric logistics cars, brushless cleaning cars, electric cleaning cars, special emergency vehicles, and funeral cars; and solar cells, lithium-ion batteries, auto parts, and electric control systems. Tantech Holdings Ltd. was founded in 2001 and is headquartered in Lishui, the People's Republic of China."
TAOP,2016-12-31,3044972,-18466633,9094085,-18170601,9676989,2586400,-10135561,-10135561,-498931,57844,10193590,20329151,7607190,-8331072,NA,-18524477,-18170601,NA,income_statement,Software—Infrastructure,Taoping Inc.,"Taoping Inc. provides cloud-based platform, resource sharing, and big data solutions to the Chinese new media, education residential community management, and elevator Internet of Things (IoT) industries in the People's Republic of China. The company operates in two segments, Cloud-based Technology and Traditional Information Technology. It offers cloud-based software as a service to automate the interactive workflow between advertising agencies and their customers, including establishing new projects, submitting advertisement proposals, revising and approving advertising proposals, processing payment online, remotely uploading advertisement content, and tracking and analyzing performance data. The company also provides project-based technology products and services for the public sector; and software and hardware with fully integrated solutions, including information technology infrastructure, Internet-enabled display technologies, and IoT platforms to customers in government, education, residential community management, media, transportation, healthcare, and other private sectors, as well as related maintenance and support services. In addition, it offers cloud-app-terminal and IoT technology based digital advertising distribution network and media resource sharing platform in the out-of-home advertising markets. Further, the company operates Taoping Net, an advertising-resources trading service platform, which connect screen owners, advertisers, and consumers; and Taoping App, which enable customers to distribute and manage ads from mobile terminals. The company was formerly known as China Information Technology, Inc. and changed its name to Taoping Inc. in June 2018. Taoping Inc. was founded in 1993 and is headquartered in Shenzhen, the People's Republic of China."
TAOP,2017-12-31,4031313,-131034,9134005,858605,4741156,8321766,-450703,-450703,-450024,-1070343,18189274,18639977,9867508,319669,NA,939309,858605,NA,income_statement,Software—Infrastructure,Taoping Inc.,"Taoping Inc. provides cloud-based platform, resource sharing, and big data solutions to the Chinese new media, education residential community management, and elevator Internet of Things (IoT) industries in the People's Republic of China. The company operates in two segments, Cloud-based Technology and Traditional Information Technology. It offers cloud-based software as a service to automate the interactive workflow between advertising agencies and their customers, including establishing new projects, submitting advertisement proposals, revising and approving advertising proposals, processing payment online, remotely uploading advertisement content, and tracking and analyzing performance data. The company also provides project-based technology products and services for the public sector; and software and hardware with fully integrated solutions, including information technology infrastructure, Internet-enabled display technologies, and IoT platforms to customers in government, education, residential community management, media, transportation, healthcare, and other private sectors, as well as related maintenance and support services. In addition, it offers cloud-app-terminal and IoT technology based digital advertising distribution network and media resource sharing platform in the out-of-home advertising markets. Further, the company operates Taoping Net, an advertising-resources trading service platform, which connect screen owners, advertisers, and consumers; and Taoping App, which enable customers to distribute and manage ads from mobile terminals. The company was formerly known as China Information Technology, Inc. and changed its name to Taoping Inc. in June 2018. Taoping Inc. was founded in 1993 and is headquartered in Shenzhen, the People's Republic of China."
TAOP,2018-12-31,4756088,677555,9347036,1691983,4729182,9654094,168824,168824,-484403,-1201231,20578340,20409516,10924246,508731,NA,1878786,1691983,NA,income_statement,Software—Infrastructure,Taoping Inc.,"Taoping Inc. provides cloud-based platform, resource sharing, and big data solutions to the Chinese new media, education residential community management, and elevator Internet of Things (IoT) industries in the People's Republic of China. The company operates in two segments, Cloud-based Technology and Traditional Information Technology. It offers cloud-based software as a service to automate the interactive workflow between advertising agencies and their customers, including establishing new projects, submitting advertisement proposals, revising and approving advertising proposals, processing payment online, remotely uploading advertisement content, and tracking and analyzing performance data. The company also provides project-based technology products and services for the public sector; and software and hardware with fully integrated solutions, including information technology infrastructure, Internet-enabled display technologies, and IoT platforms to customers in government, education, residential community management, media, transportation, healthcare, and other private sectors, as well as related maintenance and support services. In addition, it offers cloud-app-terminal and IoT technology based digital advertising distribution network and media resource sharing platform in the out-of-home advertising markets. Further, the company operates Taoping Net, an advertising-resources trading service platform, which connect screen owners, advertisers, and consumers; and Taoping App, which enable customers to distribute and manage ads from mobile terminals. The company was formerly known as China Information Technology, Inc. and changed its name to Taoping Inc. in June 2018. Taoping Inc. was founded in 1993 and is headquartered in Shenzhen, the People's Republic of China."
TAOP,2019-12-31,3592843,-3868741,9340551,-3582332,7181529,6602211,-4172161,-4172161,-499852,-274480,13791303,17963464,7189092,303420,NA,-3594261,-3582332,NA,income_statement,Software—Infrastructure,Taoping Inc.,"Taoping Inc. provides cloud-based platform, resource sharing, and big data solutions to the Chinese new media, education residential community management, and elevator Internet of Things (IoT) industries in the People's Republic of China. The company operates in two segments, Cloud-based Technology and Traditional Information Technology. It offers cloud-based software as a service to automate the interactive workflow between advertising agencies and their customers, including establishing new projects, submitting advertisement proposals, revising and approving advertising proposals, processing payment online, remotely uploading advertisement content, and tracking and analyzing performance data. The company also provides project-based technology products and services for the public sector; and software and hardware with fully integrated solutions, including information technology infrastructure, Internet-enabled display technologies, and IoT platforms to customers in government, education, residential community management, media, transportation, healthcare, and other private sectors, as well as related maintenance and support services. In addition, it offers cloud-app-terminal and IoT technology based digital advertising distribution network and media resource sharing platform in the out-of-home advertising markets. Further, the company operates Taoping Net, an advertising-resources trading service platform, which connect screen owners, advertisers, and consumers; and Taoping App, which enable customers to distribute and manage ads from mobile terminals. The company was formerly known as China Information Technology, Inc. and changed its name to Taoping Inc. in June 2018. Taoping Inc. was founded in 1993 and is headquartered in Shenzhen, the People's Republic of China."
TAP,2017-12-31,NA,1383200000,208900000,1565600000,2934000000,4766100000,1832100000,1832100000,-349300000,-204600000,11002800000,9170700000,6236700000,-448900000,1500000,1587800000,1565600000,NA,income_statement,NA,NA,NA
TAP,2018-12-31,NA,1359800000,228400000,1116500000,2725700000,4184800000,1459100000,1459100000,-306200000,225200000,10769600000,9310500000,6584800000,-99300000,NA,1134600000,1116500000,NA,income_statement,NA,NA,NA
TAP,2019-12-31,NA,479900000,253700000,241700000,2700100000,4201200000,1501100000,1501100000,-280900000,233700000,10579400000,9078300000,6378200000,-1021200000,NA,246200000,241700000,NA,income_statement,NA,NA,NA
TAP,2020-12-31,NA,-643900000,256300000,-949000000,2406700000,3768300000,1361600000,1361600000,-274600000,301800000,9654000000,8292400000,5885700000,-2005500000,NA,-945700000,-949000000,NA,income_statement,NA,NA,NA
TARA,2017-12-31,1105768,-1211757,NA,-1211757,105989,0,-1211757,-1211757,NA,0,0,1211757,0,0,NA,-1211757,-1211757,NA,income_statement,Biotechnology,"Protara Therapeutics, Inc.","Protara Therapeutics, Inc., a clinical-stage company, engages in the identifying and advancing transformative therapies for people with rare and specialty diseases. The company's lead program is TARA-002, an investigational cell therapy for the treatment of lymphatic malformations. It also develops intravenous choline chloride, an investigational phospholipid substrate replacement therapy for the treatment of intestinal failure associated liver disease. The company was formerly known as ArTara Therapeutics, Inc. and changed its name to Protara Therapeutics, Inc. in May 2020. Protara Therapeutics, Inc. is based in New York, New York."
TARA,2018-12-31,3478805,-4245585,NA,-4245585,766780,0,-4245585,-4245585,NA,0,0,4245585,0,0,NA,-4245585,-4245585,NA,income_statement,Biotechnology,"Protara Therapeutics, Inc.","Protara Therapeutics, Inc., a clinical-stage company, engages in the identifying and advancing transformative therapies for people with rare and specialty diseases. The company's lead program is TARA-002, an investigational cell therapy for the treatment of lymphatic malformations. It also develops intravenous choline chloride, an investigational phospholipid substrate replacement therapy for the treatment of intestinal failure associated liver disease. The company was formerly known as ArTara Therapeutics, Inc. and changed its name to Protara Therapeutics, Inc. in May 2020. Protara Therapeutics, Inc. is based in New York, New York."
TARS,2018-12-31,901000,-1318000,NA,-1319000,449000,0,-1350000,-1350000,-100000,1000,0,1350000,0,32000,NA,-1319000,-1319000,NA,income_statement,Biotechnology,"Tarsus Pharmaceuticals, Inc.","Tarsus Pharmaceuticals, Inc., a clinical-stage biopharmaceutical company, focuses on the development and commercialization of novel therapeutic candidates for ophthalmic conditions. Its lead product candidate is TP-03, a novel therapeutic that is in Phase IIb/III for the treatment of blepharitis caused by the infestation of Demodex mites, as well as to treat meibomian gland disease. The company is also developing TP-04 for the treatment of rosacea; and TP-05 for Lyme prophylaxis and community malaria reduction. Tarsus Pharmaceuticals, Inc. was founded in 2016 and is headquartered in Irvine, California."
TARS,2019-12-31,3162000,-4669000,NA,-4670000,1136000,0,-4298000,-4298000,-100000,1000,0,4298000,0,-371000,NA,-4670000,-4670000,NA,income_statement,Biotechnology,"Tarsus Pharmaceuticals, Inc.","Tarsus Pharmaceuticals, Inc., a clinical-stage biopharmaceutical company, focuses on the development and commercialization of novel therapeutic candidates for ophthalmic conditions. Its lead product candidate is TP-03, a novel therapeutic that is in Phase IIb/III for the treatment of blepharitis caused by the infestation of Demodex mites, as well as to treat meibomian gland disease. The company is also developing TP-04 for the treatment of rosacea; and TP-05 for Lyme prophylaxis and community malaria reduction. Tarsus Pharmaceuticals, Inc. was founded in 2016 and is headquartered in Irvine, California."
TAST,2017-01-01,NA,17387000,NA,45472000,94402000,181945000,40005000,40005000,-18315000,-28085000,943583000,903578000,761638000,-22618000,NA,45472000,35395000,243000,income_statement,Restaurants,"Carrols Restaurant Group, Inc.","Carrols Restaurant Group, Inc., through its subsidiaries, operates as a restaurant company in the United States. The company operates as a Burger King franchisee. As of December 29, 2019, it had, as franchisee, 1,036 Burger King restaurants located in 23 Northeastern, Midwestern, and Southeastern states; and 65 Popeyes restaurants in seven Southeastern states. The company was founded in 1960 and is headquartered in Syracuse, New York."
TAST,2017-12-31,NA,7763000,NA,7159000,103232000,191151000,32804000,32804000,-21710000,604000,1088532000,1055728000,897381000,-25041000,NA,7159000,5562000,956000,income_statement,Restaurants,"Carrols Restaurant Group, Inc.","Carrols Restaurant Group, Inc., through its subsidiaries, operates as a restaurant company in the United States. The company operates as a Burger King franchisee. As of December 29, 2019, it had, as franchisee, 1,036 Burger King restaurants located in 23 Northeastern, Midwestern, and Southeastern states; and 65 Popeyes restaurants in seven Southeastern states. The company was founded in 1960 and is headquartered in Syracuse, New York."
TAST,2018-12-30,NA,9947000,NA,10104000,113482000,210011000,37876000,37876000,-23638000,-157000,1179307000,1141431000,969296000,-27929000,NA,10104000,7855000,185000,income_statement,Restaurants,"Carrols Restaurant Group, Inc.","Carrols Restaurant Group, Inc., through its subsidiaries, operates as a restaurant company in the United States. The company operates as a Burger King franchisee. As of December 29, 2019, it had, as franchisee, 1,036 Burger King restaurants located in 23 Northeastern, Midwestern, and Southeastern states; and 65 Popeyes restaurants in seven Southeastern states. The company was founded in 1960 and is headquartered in Syracuse, New York."
TAST,2019-12-29,NA,-44042000,NA,-31919000,134923000,211007000,-543000,-543000,-27856000,-12123000,1462765000,1463308000,1251758000,-43499000,NA,-31919000,-31919000,1953000,income_statement,Restaurants,"Carrols Restaurant Group, Inc.","Carrols Restaurant Group, Inc., through its subsidiaries, operates as a restaurant company in the United States. The company operates as a Burger King franchisee. As of December 29, 2019, it had, as franchisee, 1,036 Burger King restaurants located in 23 Northeastern, Midwestern, and Southeastern states; and 65 Popeyes restaurants in seven Southeastern states. The company was founded in 1960 and is headquartered in Syracuse, New York."
TATT,2016-12-31,1140000,3927000,NA,62000,13899000,19037000,3998000,3998000,-1139000,3865000,95794000,91796000,76757000,-71000,NA,62000,62000,NA,income_statement,Aerospace & Defense,TAT Technologies Ltd.,"TAT Technologies Ltd., together with its subsidiaries, provides solutions and services to the commercial and military aerospace, and ground defense industries in the United States, Israel, and internationally. The company operates through four segments: Original Equipment Manufacturing (OEM) of Heat Transfer Solutions and Aviation Accessories; Maintenance, Repair, and Overhaul (MRO) Services for Heat Transfer Components and OEM of Heat Transfer Solutions; MRO Services for Aviation Components; and Overhaul and Coating of Jet Engine Components. It designs, develops, and manufactures a range of heat transfer solutions, such as pre-cooler and oil/fuel hydraulic heat exchangers used in mechanical and electronic systems in commercial, military, and business aircraft; environmental control and power electronics cooling systems for use in aircraft and ground applications; and a range of other mechanical aircraft accessories and systems, such as pumps, valves, and turbine power units. The company also provides MRO services for heat transfer components, as well as for manufacturing heat transfer solutions; and aviation components, such as power plants, landing gears, and other aircraft components. In addition, it engages in the operation of a repair station, which provides heat transfer MRO services for airlines, air cargo carriers, maintenance service centers, and the military; and the overhaul and coating of jet engine components, including turbine vanes and blades, fan blades, variable inlet guide vanes, and afterburner flaps. The company was formerly known as Galagraph Ltd. and changed its name to TAT Technologies Ltd. in May 1992. TAT Technologies Ltd. was founded in 1985 and is headquartered in Gedera, Israel."
TATT,2017-12-31,731000,4729000,NA,2396000,14383000,20444000,5330000,5330000,-1132000,2333000,106527000,101197000,86083000,-601000,NA,2396000,2396000,NA,income_statement,Aerospace & Defense,TAT Technologies Ltd.,"TAT Technologies Ltd., together with its subsidiaries, provides solutions and services to the commercial and military aerospace, and ground defense industries in the United States, Israel, and internationally. The company operates through four segments: Original Equipment Manufacturing (OEM) of Heat Transfer Solutions and Aviation Accessories; Maintenance, Repair, and Overhaul (MRO) Services for Heat Transfer Components and OEM of Heat Transfer Solutions; MRO Services for Aviation Components; and Overhaul and Coating of Jet Engine Components. It designs, develops, and manufactures a range of heat transfer solutions, such as pre-cooler and oil/fuel hydraulic heat exchangers used in mechanical and electronic systems in commercial, military, and business aircraft; environmental control and power electronics cooling systems for use in aircraft and ground applications; and a range of other mechanical aircraft accessories and systems, such as pumps, valves, and turbine power units. The company also provides MRO services for heat transfer components, as well as for manufacturing heat transfer solutions; and aviation components, such as power plants, landing gears, and other aircraft components. In addition, it engages in the operation of a repair station, which provides heat transfer MRO services for airlines, air cargo carriers, maintenance service centers, and the military; and the overhaul and coating of jet engine components, including turbine vanes and blades, fan blades, variable inlet guide vanes, and afterburner flaps. The company was formerly known as Galagraph Ltd. and changed its name to TAT Technologies Ltd. in May 1992. TAT Technologies Ltd. was founded in 1985 and is headquartered in Gedera, Israel."
TATT,2018-12-31,553000,-5872000,NA,-4408000,13472000,8391000,-5634000,-5634000,-1569000,-1464000,93178000,98812000,84787000,-238000,NA,-4408000,-4408000,NA,income_statement,Aerospace & Defense,TAT Technologies Ltd.,"TAT Technologies Ltd., together with its subsidiaries, provides solutions and services to the commercial and military aerospace, and ground defense industries in the United States, Israel, and internationally. The company operates through four segments: Original Equipment Manufacturing (OEM) of Heat Transfer Solutions and Aviation Accessories; Maintenance, Repair, and Overhaul (MRO) Services for Heat Transfer Components and OEM of Heat Transfer Solutions; MRO Services for Aviation Components; and Overhaul and Coating of Jet Engine Components. It designs, develops, and manufactures a range of heat transfer solutions, such as pre-cooler and oil/fuel hydraulic heat exchangers used in mechanical and electronic systems in commercial, military, and business aircraft; environmental control and power electronics cooling systems for use in aircraft and ground applications; and a range of other mechanical aircraft accessories and systems, such as pumps, valves, and turbine power units. The company also provides MRO services for heat transfer components, as well as for manufacturing heat transfer solutions; and aviation components, such as power plants, landing gears, and other aircraft components. In addition, it engages in the operation of a repair station, which provides heat transfer MRO services for airlines, air cargo carriers, maintenance service centers, and the military; and the overhaul and coating of jet engine components, including turbine vanes and blades, fan blades, variable inlet guide vanes, and afterburner flaps. The company was formerly known as Galagraph Ltd. and changed its name to TAT Technologies Ltd. in May 1992. TAT Technologies Ltd. was founded in 1985 and is headquartered in Gedera, Israel."
TATT,2019-12-31,74000,1395000,NA,806000,13510000,15562000,1978000,1978000,-1299000,589000,102032000,100054000,86470000,-583000,NA,806000,806000,NA,income_statement,Aerospace & Defense,TAT Technologies Ltd.,"TAT Technologies Ltd., together with its subsidiaries, provides solutions and services to the commercial and military aerospace, and ground defense industries in the United States, Israel, and internationally. The company operates through four segments: Original Equipment Manufacturing (OEM) of Heat Transfer Solutions and Aviation Accessories; Maintenance, Repair, and Overhaul (MRO) Services for Heat Transfer Components and OEM of Heat Transfer Solutions; MRO Services for Aviation Components; and Overhaul and Coating of Jet Engine Components. It designs, develops, and manufactures a range of heat transfer solutions, such as pre-cooler and oil/fuel hydraulic heat exchangers used in mechanical and electronic systems in commercial, military, and business aircraft; environmental control and power electronics cooling systems for use in aircraft and ground applications; and a range of other mechanical aircraft accessories and systems, such as pumps, valves, and turbine power units. The company also provides MRO services for heat transfer components, as well as for manufacturing heat transfer solutions; and aviation components, such as power plants, landing gears, and other aircraft components. In addition, it engages in the operation of a repair station, which provides heat transfer MRO services for airlines, air cargo carriers, maintenance service centers, and the military; and the overhaul and coating of jet engine components, including turbine vanes and blades, fan blades, variable inlet guide vanes, and afterburner flaps. The company was formerly known as Galagraph Ltd. and changed its name to TAT Technologies Ltd. in May 1992. TAT Technologies Ltd. was founded in 1985 and is headquartered in Gedera, Israel."
TAYD,2017-05-31,NA,2987577,NA,2330577,5065101,7985833,2920732,2920732,NA,657000,25536996,22616264,17551163,66845,NA,2330577,2330577,NA,income_statement,Specialty Industrial Machinery,"Taylor Devices, Inc.","Taylor Devices, Inc. designs, develops, manufactures, and markets shock absorption, rate control, and energy storage devices for use in machinery, equipment, and structures in North America, Asia, and internationally. The company's products include seismic dampers that are designed to mitigate the effects of earthquake tremors on structures; Fluidicshoks, which are compact shock absorbers primarily used in defense, aerospace, and commercial industries; and crane and industrial buffers, which are larger versions of the Fluidicshoks for industrial application on cranes, ships, container ships, railroad cars, truck docks, ladle and ingot cars, ore trolleys, and car stops. Its products also comprise self-adjusting shock absorbers that include versions of Fluidicshoks, and crane and industrial buffers, which automatically adjust to various impact conditions and are designed for high cycle application primarily in the heavy industry; liquid die springs that are used as component parts of machinery and equipment used in the manufacture of tools and dies; vibration dampers, which are primarily used by aerospace and defense industries to control the response of electronics and optical systems subjected to air, ship, or spacecraft vibration; machined springs used in the aerospace applications; and custom actuators for special military and aerospace applications. The company markets its products through a network of sales representatives and distributors. Taylor Devices, Inc. was founded in 1955 and is headquartered in North Tonawanda, New York."
TAYD,2018-05-31,NA,676370,NA,443370,5276574,5924207,647633,647633,NA,233000,24363967,23716334,18439760,28737,NA,443370,443370,NA,income_statement,Specialty Industrial Machinery,"Taylor Devices, Inc.","Taylor Devices, Inc. designs, develops, manufactures, and markets shock absorption, rate control, and energy storage devices for use in machinery, equipment, and structures in North America, Asia, and internationally. The company's products include seismic dampers that are designed to mitigate the effects of earthquake tremors on structures; Fluidicshoks, which are compact shock absorbers primarily used in defense, aerospace, and commercial industries; and crane and industrial buffers, which are larger versions of the Fluidicshoks for industrial application on cranes, ships, container ships, railroad cars, truck docks, ladle and ingot cars, ore trolleys, and car stops. Its products also comprise self-adjusting shock absorbers that include versions of Fluidicshoks, and crane and industrial buffers, which automatically adjust to various impact conditions and are designed for high cycle application primarily in the heavy industry; liquid die springs that are used as component parts of machinery and equipment used in the manufacture of tools and dies; vibration dampers, which are primarily used by aerospace and defense industries to control the response of electronics and optical systems subjected to air, ship, or spacecraft vibration; machined springs used in the aerospace applications; and custom actuators for special military and aerospace applications. The company markets its products through a network of sales representatives and distributors. Taylor Devices, Inc. was founded in 1955 and is headquartered in North Tonawanda, New York."
TAYD,2019-05-31,NA,3059525,NA,2544525,6045984,9047776,3001792,3001792,NA,515000,33619031,30617239,24571255,57733,NA,2544525,2544525,NA,income_statement,Specialty Industrial Machinery,"Taylor Devices, Inc.","Taylor Devices, Inc. designs, develops, manufactures, and markets shock absorption, rate control, and energy storage devices for use in machinery, equipment, and structures in North America, Asia, and internationally. The company's products include seismic dampers that are designed to mitigate the effects of earthquake tremors on structures; Fluidicshoks, which are compact shock absorbers primarily used in defense, aerospace, and commercial industries; and crane and industrial buffers, which are larger versions of the Fluidicshoks for industrial application on cranes, ships, container ships, railroad cars, truck docks, ladle and ingot cars, ore trolleys, and car stops. Its products also comprise self-adjusting shock absorbers that include versions of Fluidicshoks, and crane and industrial buffers, which automatically adjust to various impact conditions and are designed for high cycle application primarily in the heavy industry; liquid die springs that are used as component parts of machinery and equipment used in the manufacture of tools and dies; vibration dampers, which are primarily used by aerospace and defense industries to control the response of electronics and optical systems subjected to air, ship, or spacecraft vibration; machined springs used in the aerospace applications; and custom actuators for special military and aerospace applications. The company markets its products through a network of sales representatives and distributors. Taylor Devices, Inc. was founded in 1955 and is headquartered in North Tonawanda, New York."
TAYD,2020-05-31,NA,3415976,NA,3029976,5934410,9237090,3302680,3302680,NA,386000,28381541,25078861,19144451,113296,NA,3029976,3029976,NA,income_statement,Specialty Industrial Machinery,"Taylor Devices, Inc.","Taylor Devices, Inc. designs, develops, manufactures, and markets shock absorption, rate control, and energy storage devices for use in machinery, equipment, and structures in North America, Asia, and internationally. The company's products include seismic dampers that are designed to mitigate the effects of earthquake tremors on structures; Fluidicshoks, which are compact shock absorbers primarily used in defense, aerospace, and commercial industries; and crane and industrial buffers, which are larger versions of the Fluidicshoks for industrial application on cranes, ships, container ships, railroad cars, truck docks, ladle and ingot cars, ore trolleys, and car stops. Its products also comprise self-adjusting shock absorbers that include versions of Fluidicshoks, and crane and industrial buffers, which automatically adjust to various impact conditions and are designed for high cycle application primarily in the heavy industry; liquid die springs that are used as component parts of machinery and equipment used in the manufacture of tools and dies; vibration dampers, which are primarily used by aerospace and defense industries to control the response of electronics and optical systems subjected to air, ship, or spacecraft vibration; machined springs used in the aerospace applications; and custom actuators for special military and aerospace applications. The company markets its products through a network of sales representatives and distributors. Taylor Devices, Inc. was founded in 1955 and is headquartered in North Tonawanda, New York."
TBBK,2017-12-31,NA,40394000,NA,21673000,126616000,196207000,0,56344000,NA,23056000,196207000,139863000,0,-15950000,4335000,17338000,21673000,13247000,income_statement,Banks—Regional,"The Bancorp, Inc.","The Bancorp, Inc. operates as the financial holding company for The Bancorp Bank that provides banking products and services in the United States. The company offers a range of deposit products and services, including checking, savings, money market, commercial, and retirement accounts. It also provides securities-backed lines of credit, insurance policy cash value-backed lines of credit, vehicle fleet and other equipment leasing, small business administration loans, and commercial mortgage-backed loans, as well as prepaid and debit cards. In addition, it offers private label banking; credit and debit card payment processing for independent service organizations; institutional banking; and internet banking services. The Bancorp, Inc. was founded in 1999 and is headquartered in Wilmington, Delaware."
TBBK,2018-12-31,NA,119781000,NA,88677000,127144000,271059000,0,130236000,NA,32241000,271059000,140823000,0,-10455000,1137000,87540000,88677000,13679000,income_statement,Banks—Regional,"The Bancorp, Inc.","The Bancorp, Inc. operates as the financial holding company for The Bancorp Bank that provides banking products and services in the United States. The company offers a range of deposit products and services, including checking, savings, money market, commercial, and retirement accounts. It also provides securities-backed lines of credit, insurance policy cash value-backed lines of credit, vehicle fleet and other equipment leasing, small business administration loans, and commercial mortgage-backed loans, as well as prepaid and debit cards. In addition, it offers private label banking; credit and debit card payment processing for independent service organizations; institutional banking; and internet banking services. The Bancorp, Inc. was founded in 1999 and is headquartered in Wilmington, Delaware."
TBBK,2019-12-31,NA,72494000,NA,51559000,137939000,241015000,0,90858000,NA,21226000,241015000,150157000,0,-18364000,291000,51268000,51559000,12218000,income_statement,Banks—Regional,"The Bancorp, Inc.","The Bancorp, Inc. operates as the financial holding company for The Bancorp Bank that provides banking products and services in the United States. The company offers a range of deposit products and services, including checking, savings, money market, commercial, and retirement accounts. It also provides securities-backed lines of credit, insurance policy cash value-backed lines of credit, vehicle fleet and other equipment leasing, small business administration loans, and commercial mortgage-backed loans, as well as prepaid and debit cards. In addition, it offers private label banking; credit and debit card payment processing for independent service organizations; institutional banking; and internet banking services. The Bancorp, Inc. was founded in 1999 and is headquartered in Wilmington, Delaware."
TBBK,2020-12-31,NA,108284000,NA,80084000,125618000,273131000,0,118092000,NA,27688000,273131000,155039000,0,-9808000,-512000,80596000,80084000,29421000,income_statement,Banks—Regional,"The Bancorp, Inc.","The Bancorp, Inc. operates as the financial holding company for The Bancorp Bank that provides banking products and services in the United States. The company offers a range of deposit products and services, including checking, savings, money market, commercial, and retirement accounts. It also provides securities-backed lines of credit, insurance policy cash value-backed lines of credit, vehicle fleet and other equipment leasing, small business administration loans, and commercial mortgage-backed loans, as well as prepaid and debit cards. In addition, it offers private label banking; credit and debit card payment processing for independent service organizations; institutional banking; and internet banking services. The Bancorp, Inc. was founded in 1999 and is headquartered in Wilmington, Delaware."
TBIO,2016-12-31,9554000,-26698000,NA,-26698000,8144000,-6104000,-23802000,-23802000,NA,0,0,23802000,6104000,-2896000,NA,-26698000,-27369000,NA,income_statement,Biotechnology,"Translate Bio, Inc.","Translate Bio, Inc., a clinical-stage messenger RNA (mRNA) therapeutics company, develops medicines to treat diseases caused by protein or gene dysfunction. The company is developing MRT5005, which is in Phase I/II clinical trial for the treatment of cystic fibrosis; and MRT5201 to treat ornithine transcarbamylase deficiency. The company was formerly known as RaNA Therapeutics, Inc. and changed its name to Translate Bio, Inc. in June 2017. Translate Bio, Inc. was founded in 2011 and is headquartered in Lexington, Massachusetts."
TBIO,2017-12-31,17606000,-78924000,NA,-66443000,14311000,-28944000,-60861000,-60861000,NA,-12481000,0,60861000,28944000,-18063000,NA,-66443000,-67162000,NA,income_statement,Biotechnology,"Translate Bio, Inc.","Translate Bio, Inc., a clinical-stage messenger RNA (mRNA) therapeutics company, develops medicines to treat diseases caused by protein or gene dysfunction. The company is developing MRT5005, which is in Phase I/II clinical trial for the treatment of cystic fibrosis; and MRT5201 to treat ornithine transcarbamylase deficiency. The company was formerly known as RaNA Therapeutics, Inc. and changed its name to Translate Bio, Inc. in June 2017. Translate Bio, Inc. was founded in 2011 and is headquartered in Lexington, Massachusetts."
TBIO,2018-12-31,22836000,-102960000,NA,-97395000,22606000,-33768000,-79210000,-79210000,NA,-5565000,1420000,80630000,35188000,-23750000,NA,-97395000,-98039000,NA,income_statement,Biotechnology,"Translate Bio, Inc.","Translate Bio, Inc., a clinical-stage messenger RNA (mRNA) therapeutics company, develops medicines to treat diseases caused by protein or gene dysfunction. The company is developing MRT5005, which is in Phase I/II clinical trial for the treatment of cystic fibrosis; and MRT5201 to treat ornithine transcarbamylase deficiency. The company was formerly known as RaNA Therapeutics, Inc. and changed its name to Translate Bio, Inc. in June 2017. Translate Bio, Inc. was founded in 2011 and is headquartered in Lexington, Massachusetts."
TBIO,2019-12-31,29685000,-113779000,NA,-113293000,28632000,-38880000,-97197000,-97197000,NA,-486000,7804000,105001000,46684000,-16582000,NA,-113293000,-113293000,NA,income_statement,Biotechnology,"Translate Bio, Inc.","Translate Bio, Inc., a clinical-stage messenger RNA (mRNA) therapeutics company, develops medicines to treat diseases caused by protein or gene dysfunction. The company is developing MRT5005, which is in Phase I/II clinical trial for the treatment of cystic fibrosis; and MRT5201 to treat ornithine transcarbamylase deficiency. The company was formerly known as RaNA Therapeutics, Inc. and changed its name to Translate Bio, Inc. in June 2017. Translate Bio, Inc. was founded in 2011 and is headquartered in Lexington, Massachusetts."
TBK,2017-12-31,NA,61098000,NA,36220000,101790000,163852000,0,46640000,NA,24878000,163852000,117212000,0,14458000,NA,36220000,35446000,15422000,income_statement,Banks—Regional,"Triumph Bancorp, Inc.","Triumph Bancorp, Inc. operates as a financial holding company for TBK Bank, SSB that provides various banking and commercial finance products and services to retail customers and small-to-mid-sized businesses in the United States. The company operates through three segments: Banking, Factoring, and Corporate. It offers depository products, including checking, savings, and money market accounts, as well as certificates of deposit; and commercial and industrial loans, loans to purchase capital equipment, and business loans for working capital and operational purposes. The company also provides asset-based, and equipment and premium finance loans; real estate loans to finance commercial properties; factoring services to the transportation and non-transportation sectors; agriculture loans; commercial construction, land, and land development loans; mortgage warehouse loans; residential real estate loans; and consumer loans. In addition, it offers debit cards; electronic banking, trust, and treasury management services; and insurance brokerage services. As of December 31, 2020, the company operated through a network of 10 branches in the Quad Cities Metropolitan Area of Iowa and Illinois; 8 branches in northern and central Illinois; 7 branches in southern Colorado; 3 branches in New Mexico; 31 branches in central and eastern Colorado; and 2 branches in far western Kansas, as well as a branch office dedicated to deposit gathering activities in Dallas, Texas. Triumph Bancorp, Inc. is headquartered in Dallas, Texas."
TBK,2018-12-31,NA,66500000,NA,51708000,136418000,233853000,0,74609000,NA,14792000,233853000,159244000,0,-8109000,NA,51708000,51130000,22826000,income_statement,Banks—Regional,"Triumph Bancorp, Inc.","Triumph Bancorp, Inc. operates as a financial holding company for TBK Bank, SSB that provides various banking and commercial finance products and services to retail customers and small-to-mid-sized businesses in the United States. The company operates through three segments: Banking, Factoring, and Corporate. It offers depository products, including checking, savings, and money market accounts, as well as certificates of deposit; and commercial and industrial loans, loans to purchase capital equipment, and business loans for working capital and operational purposes. The company also provides asset-based, and equipment and premium finance loans; real estate loans to finance commercial properties; factoring services to the transportation and non-transportation sectors; agriculture loans; commercial construction, land, and land development loans; mortgage warehouse loans; residential real estate loans; and consumer loans. In addition, it offers debit cards; electronic banking, trust, and treasury management services; and insurance brokerage services. As of December 31, 2020, the company operated through a network of 10 branches in the Quad Cities Metropolitan Area of Iowa and Illinois; 8 branches in northern and central Illinois; 7 branches in southern Colorado; 3 branches in New Mexico; 31 branches in central and eastern Colorado; and 2 branches in far western Kansas, as well as a branch office dedicated to deposit gathering activities in Dallas, Texas. Triumph Bancorp, Inc. is headquartered in Dallas, Texas."
TBK,2019-12-31,NA,75446000,NA,58544000,165448000,279530000,0,84875000,NA,16902000,279530000,194655000,0,-9429000,NA,58544000,58544000,29207000,income_statement,Banks—Regional,"Triumph Bancorp, Inc.","Triumph Bancorp, Inc. operates as a financial holding company for TBK Bank, SSB that provides various banking and commercial finance products and services to retail customers and small-to-mid-sized businesses in the United States. The company operates through three segments: Banking, Factoring, and Corporate. It offers depository products, including checking, savings, and money market accounts, as well as certificates of deposit; and commercial and industrial loans, loans to purchase capital equipment, and business loans for working capital and operational purposes. The company also provides asset-based, and equipment and premium finance loans; real estate loans to finance commercial properties; factoring services to the transportation and non-transportation sectors; agriculture loans; commercial construction, land, and land development loans; mortgage warehouse loans; residential real estate loans; and consumer loans. In addition, it offers debit cards; electronic banking, trust, and treasury management services; and insurance brokerage services. As of December 31, 2020, the company operated through a network of 10 branches in the Quad Cities Metropolitan Area of Iowa and Illinois; 8 branches in northern and central Illinois; 7 branches in southern Colorado; 3 branches in New Mexico; 31 branches in central and eastern Colorado; and 2 branches in far western Kansas, as well as a branch office dedicated to deposit gathering activities in Dallas, Texas. Triumph Bancorp, Inc. is headquartered in Dallas, Texas."
TBK,2020-12-31,NA,84710000,NA,64024000,184561000,306784000,0,95960000,NA,20686000,306784000,210824000,0,-11250000,NA,64024000,62323000,26263000,income_statement,Banks—Regional,"Triumph Bancorp, Inc.","Triumph Bancorp, Inc. operates as a financial holding company for TBK Bank, SSB that provides various banking and commercial finance products and services to retail customers and small-to-mid-sized businesses in the United States. The company operates through three segments: Banking, Factoring, and Corporate. It offers depository products, including checking, savings, and money market accounts, as well as certificates of deposit; and commercial and industrial loans, loans to purchase capital equipment, and business loans for working capital and operational purposes. The company also provides asset-based, and equipment and premium finance loans; real estate loans to finance commercial properties; factoring services to the transportation and non-transportation sectors; agriculture loans; commercial construction, land, and land development loans; mortgage warehouse loans; residential real estate loans; and consumer loans. In addition, it offers debit cards; electronic banking, trust, and treasury management services; and insurance brokerage services. As of December 31, 2020, the company operated through a network of 10 branches in the Quad Cities Metropolitan Area of Iowa and Illinois; 8 branches in northern and central Illinois; 7 branches in southern Colorado; 3 branches in New Mexico; 31 branches in central and eastern Colorado; and 2 branches in far western Kansas, as well as a branch office dedicated to deposit gathering activities in Dallas, Texas. Triumph Bancorp, Inc. is headquartered in Dallas, Texas."
TBKCP,2017-12-31,NA,61098000,NA,36220000,101790000,163852000,0,46640000,NA,24878000,163852000,117212000,0,14458000,NA,36220000,35446000,15422000,income_statement,Banks—Regional,"Triumph Bancorp, Inc. - Deposit","Triumph Bancorp, Inc. operates as a financial holding company for TBK Bank, SSB that provides various banking and commercial finance products and services to retail customers and small-to-mid-sized businesses in the United States. The company operates through three segments: Banking, Factoring, and Corporate. It offers depository products, including checking, savings, and money market accounts, as well as certificates of deposit; and commercial and industrial loans, loans to purchase capital equipment, and business loans for working capital and operational purposes. The company also provides asset-based, and equipment and premium finance loans; real estate loans to finance commercial properties; factoring services to the transportation and non-transportation sectors; agriculture loans; commercial construction, land, and land development loans; mortgage warehouse loans; residential real estate loans; and consumer loans. In addition, it offers debit cards; electronic banking, trust, and treasury management services; and insurance brokerage services. As of December 31, 2020, the company operated through a network of 10 branches in the Quad Cities Metropolitan Area of Iowa and Illinois; 8 branches in northern and central Illinois; 7 branches in southern Colorado; 3 branches in New Mexico; 31 branches in central and eastern Colorado; and 2 branches in far western Kansas, as well as a branch office dedicated to deposit gathering activities in Dallas, Texas. Triumph Bancorp, Inc. is headquartered in Dallas, Texas."
TBKCP,2018-12-31,NA,66500000,NA,51708000,136418000,233853000,0,74609000,NA,14792000,233853000,159244000,0,-8109000,NA,51708000,51130000,22826000,income_statement,Banks—Regional,"Triumph Bancorp, Inc. - Deposit","Triumph Bancorp, Inc. operates as a financial holding company for TBK Bank, SSB that provides various banking and commercial finance products and services to retail customers and small-to-mid-sized businesses in the United States. The company operates through three segments: Banking, Factoring, and Corporate. It offers depository products, including checking, savings, and money market accounts, as well as certificates of deposit; and commercial and industrial loans, loans to purchase capital equipment, and business loans for working capital and operational purposes. The company also provides asset-based, and equipment and premium finance loans; real estate loans to finance commercial properties; factoring services to the transportation and non-transportation sectors; agriculture loans; commercial construction, land, and land development loans; mortgage warehouse loans; residential real estate loans; and consumer loans. In addition, it offers debit cards; electronic banking, trust, and treasury management services; and insurance brokerage services. As of December 31, 2020, the company operated through a network of 10 branches in the Quad Cities Metropolitan Area of Iowa and Illinois; 8 branches in northern and central Illinois; 7 branches in southern Colorado; 3 branches in New Mexico; 31 branches in central and eastern Colorado; and 2 branches in far western Kansas, as well as a branch office dedicated to deposit gathering activities in Dallas, Texas. Triumph Bancorp, Inc. is headquartered in Dallas, Texas."
TBKCP,2019-12-31,NA,75446000,NA,58544000,165448000,279530000,0,84875000,NA,16902000,279530000,194655000,0,-9429000,NA,58544000,58544000,29207000,income_statement,Banks—Regional,"Triumph Bancorp, Inc. - Deposit","Triumph Bancorp, Inc. operates as a financial holding company for TBK Bank, SSB that provides various banking and commercial finance products and services to retail customers and small-to-mid-sized businesses in the United States. The company operates through three segments: Banking, Factoring, and Corporate. It offers depository products, including checking, savings, and money market accounts, as well as certificates of deposit; and commercial and industrial loans, loans to purchase capital equipment, and business loans for working capital and operational purposes. The company also provides asset-based, and equipment and premium finance loans; real estate loans to finance commercial properties; factoring services to the transportation and non-transportation sectors; agriculture loans; commercial construction, land, and land development loans; mortgage warehouse loans; residential real estate loans; and consumer loans. In addition, it offers debit cards; electronic banking, trust, and treasury management services; and insurance brokerage services. As of December 31, 2020, the company operated through a network of 10 branches in the Quad Cities Metropolitan Area of Iowa and Illinois; 8 branches in northern and central Illinois; 7 branches in southern Colorado; 3 branches in New Mexico; 31 branches in central and eastern Colorado; and 2 branches in far western Kansas, as well as a branch office dedicated to deposit gathering activities in Dallas, Texas. Triumph Bancorp, Inc. is headquartered in Dallas, Texas."
TBKCP,2020-12-31,NA,84710000,NA,64024000,184561000,306784000,0,95960000,NA,20686000,306784000,210824000,0,-11250000,NA,64024000,62323000,26263000,income_statement,Banks—Regional,"Triumph Bancorp, Inc. - Deposit","Triumph Bancorp, Inc. operates as a financial holding company for TBK Bank, SSB that provides various banking and commercial finance products and services to retail customers and small-to-mid-sized businesses in the United States. The company operates through three segments: Banking, Factoring, and Corporate. It offers depository products, including checking, savings, and money market accounts, as well as certificates of deposit; and commercial and industrial loans, loans to purchase capital equipment, and business loans for working capital and operational purposes. The company also provides asset-based, and equipment and premium finance loans; real estate loans to finance commercial properties; factoring services to the transportation and non-transportation sectors; agriculture loans; commercial construction, land, and land development loans; mortgage warehouse loans; residential real estate loans; and consumer loans. In addition, it offers debit cards; electronic banking, trust, and treasury management services; and insurance brokerage services. As of December 31, 2020, the company operated through a network of 10 branches in the Quad Cities Metropolitan Area of Iowa and Illinois; 8 branches in northern and central Illinois; 7 branches in southern Colorado; 3 branches in New Mexico; 31 branches in central and eastern Colorado; and 2 branches in far western Kansas, as well as a branch office dedicated to deposit gathering activities in Dallas, Texas. Triumph Bancorp, Inc. is headquartered in Dallas, Texas."
TBLT,2016-12-31,1247449,-4732331,NA,-4732331,4397797,1715429,-3929817,-3929817,-802514,0,9216863,13146680,7501434,-802514,NA,-4732331,-4732331,NA,income_statement,Tools & Accessories,"ToughBuilt Industries, Inc.","ToughBuilt Industries, Inc. designs, develops, manufactures, and distributes home improvement and construction products for the building industry in the United States and internationally. The company offers tool pouches, tool rigs, tool belts and accessories, tools bags, totes, various storage solutions, and office organizers/bags for laptop/tablet/cellphones; and kneepads. It also provides sawhorses, miter saws, table saws, and roller stands; sawhorse/jobsite tables; and gloves. The company offers its products under the TOUGHBUILT brand name through various home improvement big box stores, professional outlets, and direct marketing to construction companies and trade/wholesale outlets. The company was formerly known as Phalanx, Inc. and changed its name to ToughBuilt Industries, Inc. in December 2015. ToughBuilt Industries, Inc. was founded in 2012 and is based in Lake Forest, California."
TBLT,2017-12-31,1675093,-5941457,NA,-5941457,6070868,3966998,-3778963,-3778963,-2162494,0,14201836,17980799,10234838,-2162494,NA,-5941457,-5941457,NA,income_statement,Tools & Accessories,"ToughBuilt Industries, Inc.","ToughBuilt Industries, Inc. designs, develops, manufactures, and distributes home improvement and construction products for the building industry in the United States and internationally. The company offers tool pouches, tool rigs, tool belts and accessories, tools bags, totes, various storage solutions, and office organizers/bags for laptop/tablet/cellphones; and kneepads. It also provides sawhorses, miter saws, table saws, and roller stands; sawhorse/jobsite tables; and gloves. The company offers its products under the TOUGHBUILT brand name through various home improvement big box stores, professional outlets, and direct marketing to construction companies and trade/wholesale outlets. The company was formerly known as Phalanx, Inc. and changed its name to ToughBuilt Industries, Inc. in December 2015. ToughBuilt Industries, Inc. was founded in 2012 and is based in Lake Forest, California."
TBLT,2018-12-31,1816389,-27651412,NA,-27651412,6937704,3495194,-5258899,-5258899,-3321439,0,15289400,20548299,11794206,-22392513,NA,-27651412,-32299407,NA,income_statement,Tools & Accessories,"ToughBuilt Industries, Inc.","ToughBuilt Industries, Inc. designs, develops, manufactures, and distributes home improvement and construction products for the building industry in the United States and internationally. The company offers tool pouches, tool rigs, tool belts and accessories, tools bags, totes, various storage solutions, and office organizers/bags for laptop/tablet/cellphones; and kneepads. It also provides sawhorses, miter saws, table saws, and roller stands; sawhorse/jobsite tables; and gloves. The company offers its products under the TOUGHBUILT brand name through various home improvement big box stores, professional outlets, and direct marketing to construction companies and trade/wholesale outlets. The company was formerly known as Phalanx, Inc. and changed its name to ToughBuilt Industries, Inc. in December 2015. ToughBuilt Industries, Inc. was founded in 2012 and is based in Lake Forest, California."
TBLT,2019-12-31,2116018,-4300969,NA,-4300969,12078762,5614124,-8580656,-8580656,-972165,0,19090071,27670727,13475947,4279687,NA,-4300969,-4300969,NA,income_statement,Tools & Accessories,"ToughBuilt Industries, Inc.","ToughBuilt Industries, Inc. designs, develops, manufactures, and distributes home improvement and construction products for the building industry in the United States and internationally. The company offers tool pouches, tool rigs, tool belts and accessories, tools bags, totes, various storage solutions, and office organizers/bags for laptop/tablet/cellphones; and kneepads. It also provides sawhorses, miter saws, table saws, and roller stands; sawhorse/jobsite tables; and gloves. The company offers its products under the TOUGHBUILT brand name through various home improvement big box stores, professional outlets, and direct marketing to construction companies and trade/wholesale outlets. The company was formerly known as Phalanx, Inc. and changed its name to ToughBuilt Industries, Inc. in December 2015. ToughBuilt Industries, Inc. was founded in 2012 and is based in Lake Forest, California."
TBNK,2017-12-31,NA,26064000,NA,14962000,35869000,62538000,0,26669000,NA,11102000,62538000,35869000,0,-605000,NA,14962000,14935000,NA,income_statement,Banks—Regional,Territorial Bancorp Inc.,"Territorial Bancorp Inc. operates as the holding company for Territorial Savings Bank that provides various financial services to individuals, families, and businesses in the State of Hawaii. The company offers a range of deposit accounts, including passbook and statement savings accounts, certificates of deposit, money market accounts, commercial and regular checking accounts, and Super NOW accounts. It also provides various loan products comprising one- to four-family residential mortgage loans; home equity loans; construction, commercial, and other nonresidential real estate loans; consumer loans; multi-family mortgage loans; commercial business loans; and other loans, as well as offers lines of credit and investment securities. In addition, the company, through its subsidiary, Territorial Financial Services, Inc. engages in the insurance agency activities. Further, it provides various non-deposit investments, including annuities and mutual funds through a third-party broker-dealer. The company operates through a network of 29 full-service branches located in the state of Hawaii. Territorial Bancorp Inc. was founded in 1921 and is based in Honolulu, Hawaii."
TBNK,2018-12-31,NA,25323000,NA,19212000,36886000,62817000,0,25931000,NA,6111000,62817000,36886000,0,-608000,NA,19212000,19122000,NA,income_statement,Banks—Regional,Territorial Bancorp Inc.,"Territorial Bancorp Inc. operates as the holding company for Territorial Savings Bank that provides various financial services to individuals, families, and businesses in the State of Hawaii. The company offers a range of deposit accounts, including passbook and statement savings accounts, certificates of deposit, money market accounts, commercial and regular checking accounts, and Super NOW accounts. It also provides various loan products comprising one- to four-family residential mortgage loans; home equity loans; construction, commercial, and other nonresidential real estate loans; consumer loans; multi-family mortgage loans; commercial business loans; and other loans, as well as offers lines of credit and investment securities. In addition, the company, through its subsidiary, Territorial Financial Services, Inc. engages in the insurance agency activities. Further, it provides various non-deposit investments, including annuities and mutual funds through a third-party broker-dealer. The company operates through a network of 29 full-service branches located in the state of Hawaii. Territorial Bancorp Inc. was founded in 1921 and is based in Honolulu, Hawaii."
TBNK,2019-12-31,NA,28306000,NA,21995000,37718000,66312000,0,28594000,NA,6311000,66312000,37718000,0,-288000,NA,21995000,21846000,NA,income_statement,Banks—Regional,Territorial Bancorp Inc.,"Territorial Bancorp Inc. operates as the holding company for Territorial Savings Bank that provides various financial services to individuals, families, and businesses in the State of Hawaii. The company offers a range of deposit accounts, including passbook and statement savings accounts, certificates of deposit, money market accounts, commercial and regular checking accounts, and Super NOW accounts. It also provides various loan products comprising one- to four-family residential mortgage loans; home equity loans; construction, commercial, and other nonresidential real estate loans; consumer loans; multi-family mortgage loans; commercial business loans; and other loans, as well as offers lines of credit and investment securities. In addition, the company, through its subsidiary, Territorial Financial Services, Inc. engages in the insurance agency activities. Further, it provides various non-deposit investments, including annuities and mutual funds through a third-party broker-dealer. The company operates through a network of 29 full-service branches located in the state of Hawaii. Territorial Bancorp Inc. was founded in 1921 and is based in Honolulu, Hawaii."
TBNK,2020-12-31,NA,25320000,NA,18605000,37073000,62745000,0,25672000,NA,6715000,62745000,37073000,0,-352000,NA,18605000,18605000,NA,income_statement,Banks—Regional,Territorial Bancorp Inc.,"Territorial Bancorp Inc. operates as the holding company for Territorial Savings Bank that provides various financial services to individuals, families, and businesses in the State of Hawaii. The company offers a range of deposit accounts, including passbook and statement savings accounts, certificates of deposit, money market accounts, commercial and regular checking accounts, and Super NOW accounts. It also provides various loan products comprising one- to four-family residential mortgage loans; home equity loans; construction, commercial, and other nonresidential real estate loans; consumer loans; multi-family mortgage loans; commercial business loans; and other loans, as well as offers lines of credit and investment securities. In addition, the company, through its subsidiary, Territorial Financial Services, Inc. engages in the insurance agency activities. Further, it provides various non-deposit investments, including annuities and mutual funds through a third-party broker-dealer. The company operates through a network of 29 full-service branches located in the state of Hawaii. Territorial Bancorp Inc. was founded in 1921 and is based in Honolulu, Hawaii."
TBPH,2016-12-31,NA,-180559000,NA,-190669000,84509000,-95958000,-180467000,-180467000,-1404000,10110000,48648000,229115000,144606000,-92000,NA,-190669000,-190669000,NA,income_statement,Biotechnology,"Theravance Biopharma, Inc.","Theravance Biopharma, Inc., a diversified biopharmaceutical company, discovers, develops, and commercializes organ-selective medicines. The company offers YUPELRI, a once-daily, nebulized long-acting muscarinic antagonist used for the treatment of chronic obstructive pulmonary disease. Its product portfolio also include TD-1473, a gut-selective pan-janus kinase (JAK) inhibitor that is in Phase IIb/III clinical trials for the treatment of rheumatoid arthritis, myelofibrosis, and ulcerative colitis, as well as for a range of inflammatory intestinal diseases, including ulcerative colitis and Crohn's disease. In addition, the company's product portfolio also comprise Ampreloxetine, an investigational norepinephrine reuptake inhibitor that has completed Phase III study for neurogenic orthostatic hypotension; TD-8236, an investigational, inhaled lung-selective pan-JAK inhibitor, which is Phase II clinical study for treatment of a range of inflammatory diseases; and TD-5202, an investigational, orally administered, gut-selective, irreversible JAK3 inhibitor that is in Phase I clinical study for treatment of inflammatory intestinal diseases. Further, it offers TRELEGY ELLIPTA for the treatment of COPD; Velusetrag, an oral and investigational medicine for gastrointestinal motility disorders; and Selective 5-HT4 Agonist for treatment of gastrointestinal motility disorders. It has a licensing and collaboration agreements with Pfizer Inc., Mylan Ireland Limited, Janssen Biotech, Inc., Alfasigma S.p.A, Trek Therapeutics, PBC, and Takeda Pharmaceutical Company Limited. The company was incorporated in 2013 and is based in George Town, the Cayman Islands."
TBPH,2017-12-31,NA,-271711000,NA,-285405000,95592000,-164531000,-260123000,-260123000,-8547000,13694000,15386000,275509000,179917000,-11588000,NA,-285405000,-285405000,NA,income_statement,Biotechnology,"Theravance Biopharma, Inc.","Theravance Biopharma, Inc., a diversified biopharmaceutical company, discovers, develops, and commercializes organ-selective medicines. The company offers YUPELRI, a once-daily, nebulized long-acting muscarinic antagonist used for the treatment of chronic obstructive pulmonary disease. Its product portfolio also include TD-1473, a gut-selective pan-janus kinase (JAK) inhibitor that is in Phase IIb/III clinical trials for the treatment of rheumatoid arthritis, myelofibrosis, and ulcerative colitis, as well as for a range of inflammatory intestinal diseases, including ulcerative colitis and Crohn's disease. In addition, the company's product portfolio also comprise Ampreloxetine, an investigational norepinephrine reuptake inhibitor that has completed Phase III study for neurogenic orthostatic hypotension; TD-8236, an investigational, inhaled lung-selective pan-JAK inhibitor, which is Phase II clinical study for treatment of a range of inflammatory diseases; and TD-5202, an investigational, orally administered, gut-selective, irreversible JAK3 inhibitor that is in Phase I clinical study for treatment of inflammatory intestinal diseases. Further, it offers TRELEGY ELLIPTA for the treatment of COPD; Velusetrag, an oral and investigational medicine for gastrointestinal motility disorders; and Selective 5-HT4 Agonist for treatment of gastrointestinal motility disorders. It has a licensing and collaboration agreements with Pfizer Inc., Mylan Ireland Limited, Janssen Biotech, Inc., Alfasigma S.p.A, Trek Therapeutics, PBC, and Takeda Pharmaceutical Company Limited. The company was incorporated in 2013 and is based in George Town, the Cayman Islands."
TBPH,2018-12-31,NA,-226085000,NA,-215524000,97058000,-141693000,-238751000,-238751000,-10482000,-10561000,60370000,299121000,202063000,12666000,NA,-215524000,-215524000,NA,income_statement,Biotechnology,"Theravance Biopharma, Inc.","Theravance Biopharma, Inc., a diversified biopharmaceutical company, discovers, develops, and commercializes organ-selective medicines. The company offers YUPELRI, a once-daily, nebulized long-acting muscarinic antagonist used for the treatment of chronic obstructive pulmonary disease. Its product portfolio also include TD-1473, a gut-selective pan-janus kinase (JAK) inhibitor that is in Phase IIb/III clinical trials for the treatment of rheumatoid arthritis, myelofibrosis, and ulcerative colitis, as well as for a range of inflammatory intestinal diseases, including ulcerative colitis and Crohn's disease. In addition, the company's product portfolio also comprise Ampreloxetine, an investigational norepinephrine reuptake inhibitor that has completed Phase III study for neurogenic orthostatic hypotension; TD-8236, an investigational, inhaled lung-selective pan-JAK inhibitor, which is Phase II clinical study for treatment of a range of inflammatory diseases; and TD-5202, an investigational, orally administered, gut-selective, irreversible JAK3 inhibitor that is in Phase I clinical study for treatment of inflammatory intestinal diseases. Further, it offers TRELEGY ELLIPTA for the treatment of COPD; Velusetrag, an oral and investigational medicine for gastrointestinal motility disorders; and Selective 5-HT4 Agonist for treatment of gastrointestinal motility disorders. It has a licensing and collaboration agreements with Pfizer Inc., Mylan Ireland Limited, Janssen Biotech, Inc., Alfasigma S.p.A, Trek Therapeutics, PBC, and Takeda Pharmaceutical Company Limited. The company was incorporated in 2013 and is based in George Town, the Cayman Islands."
TBPH,2019-12-31,NA,-241677000,NA,-236455000,106081000,-145834000,-251915000,-251915000,-31862000,-5222000,73414000,325329000,219248000,10238000,NA,-236455000,-236455000,NA,income_statement,Biotechnology,"Theravance Biopharma, Inc.","Theravance Biopharma, Inc., a diversified biopharmaceutical company, discovers, develops, and commercializes organ-selective medicines. The company offers YUPELRI, a once-daily, nebulized long-acting muscarinic antagonist used for the treatment of chronic obstructive pulmonary disease. Its product portfolio also include TD-1473, a gut-selective pan-janus kinase (JAK) inhibitor that is in Phase IIb/III clinical trials for the treatment of rheumatoid arthritis, myelofibrosis, and ulcerative colitis, as well as for a range of inflammatory intestinal diseases, including ulcerative colitis and Crohn's disease. In addition, the company's product portfolio also comprise Ampreloxetine, an investigational norepinephrine reuptake inhibitor that has completed Phase III study for neurogenic orthostatic hypotension; TD-8236, an investigational, inhaled lung-selective pan-JAK inhibitor, which is Phase II clinical study for treatment of a range of inflammatory diseases; and TD-5202, an investigational, orally administered, gut-selective, irreversible JAK3 inhibitor that is in Phase I clinical study for treatment of inflammatory intestinal diseases. Further, it offers TRELEGY ELLIPTA for the treatment of COPD; Velusetrag, an oral and investigational medicine for gastrointestinal motility disorders; and Selective 5-HT4 Agonist for treatment of gastrointestinal motility disorders. It has a licensing and collaboration agreements with Pfizer Inc., Mylan Ireland Limited, Janssen Biotech, Inc., Alfasigma S.p.A, Trek Therapeutics, PBC, and Takeda Pharmaceutical Company Limited. The company was incorporated in 2013 and is based in George Town, the Cayman Islands."
TC,2016-12-31,19576000,-81508000,-659000,-86568000,161124000,99605000,-81095000,-81095000,-1376000,0,117353000,198448000,17748000,-413000,-5060000,-81508000,-103473000,NA,income_statement,Internet Content & Information,TuanChe Limited,"TuanChe Limited, through with its subsidiaries, operates as an omni-channel automotive marketplace in China. It organizes auto shows and group-purchase events that attract various consumers; and provides integrated marketing solutions to industry customers, which include automakers, franchised dealerships, secondary dealers, and automotive service providers, as well as enable interactions between participants on both sides of a potential transaction. As of December 31, 2019, the company organized 1,055 auto shows in 233 cities across China. It also provides virtual dealership services by connecting automakers and franchised dealerships with secondary dealers by providing a suite of services traditionally undertaken by franchised dealerships without setting up permanent physical presence. In addition, the company offers business and technical support, and consulting services. TuanChe Limited has a strategic partnership with Beijing Easyhome Furnishing Chain Group Co., Ltd. to jointly establish an one-stop retail experience that combines home decoration products and automotive services. The company was founded in 2010 and is headquartered in Beijing, China."
TC,2017-12-31,15925000,-75694000,-659000,-90671000,281699000,225883000,-71741000,-71741000,-2416000,0,280666000,352407000,54783000,-3953000,-14977000,-75694000,-111616000,NA,income_statement,Internet Content & Information,TuanChe Limited,"TuanChe Limited, through with its subsidiaries, operates as an omni-channel automotive marketplace in China. It organizes auto shows and group-purchase events that attract various consumers; and provides integrated marketing solutions to industry customers, which include automakers, franchised dealerships, secondary dealers, and automotive service providers, as well as enable interactions between participants on both sides of a potential transaction. As of December 31, 2019, the company organized 1,055 auto shows in 233 cities across China. It also provides virtual dealership services by connecting automakers and franchised dealerships with secondary dealers by providing a suite of services traditionally undertaken by franchised dealerships without setting up permanent physical presence. In addition, the company offers business and technical support, and consulting services. TuanChe Limited has a strategic partnership with Beijing Easyhome Furnishing Chain Group Co., Ltd. to jointly establish an one-stop retail experience that combines home decoration products and automotive services. The company was founded in 2010 and is headquartered in Beijing, China."
TC,2018-12-31,19262000,-75088000,-659000,-78700000,583137000,534362000,-68037000,-68037000,-3146000,0,651013000,719050000,116651000,-7051000,-3612000,-75088000,-113766000,NA,income_statement,Internet Content & Information,TuanChe Limited,"TuanChe Limited, through with its subsidiaries, operates as an omni-channel automotive marketplace in China. It organizes auto shows and group-purchase events that attract various consumers; and provides integrated marketing solutions to industry customers, which include automakers, franchised dealerships, secondary dealers, and automotive service providers, as well as enable interactions between participants on both sides of a potential transaction. As of December 31, 2019, the company organized 1,055 auto shows in 233 cities across China. It also provides virtual dealership services by connecting automakers and franchised dealerships with secondary dealers by providing a suite of services traditionally undertaken by franchised dealerships without setting up permanent physical presence. In addition, the company offers business and technical support, and consulting services. TuanChe Limited has a strategic partnership with Beijing Easyhome Furnishing Chain Group Co., Ltd. to jointly establish an one-stop retail experience that combines home decoration products and automotive services. The company was founded in 2010 and is headquartered in Beijing, China."
TC,2019-12-31,43339000,-251299000,-659000,-250640000,753064000,535366000,-261037000,-261037000,NA,0,644773000,905810000,109407000,9738000,NA,-251299000,-250640000,NA,income_statement,Internet Content & Information,TuanChe Limited,"TuanChe Limited, through with its subsidiaries, operates as an omni-channel automotive marketplace in China. It organizes auto shows and group-purchase events that attract various consumers; and provides integrated marketing solutions to industry customers, which include automakers, franchised dealerships, secondary dealers, and automotive service providers, as well as enable interactions between participants on both sides of a potential transaction. As of December 31, 2019, the company organized 1,055 auto shows in 233 cities across China. It also provides virtual dealership services by connecting automakers and franchised dealerships with secondary dealers by providing a suite of services traditionally undertaken by franchised dealerships without setting up permanent physical presence. In addition, the company offers business and technical support, and consulting services. TuanChe Limited has a strategic partnership with Beijing Easyhome Furnishing Chain Group Co., Ltd. to jointly establish an one-stop retail experience that combines home decoration products and automotive services. The company was founded in 2010 and is headquartered in Beijing, China."
TCBI,2017-12-31,NA,325708000,NA,197063000,377564000,791584000,0,355655000,NA,128645000,791584000,435929000,0,-29947000,NA,197063000,187313000,58365000,income_statement,Banks—Regional,"Texas Capital Bancshares, Inc.","Texas Capital Bancshares, Inc. operates as the bank holding company for Texas Capital Bank, National Association that provides various banking products and services for commercial businesses, and professionals and entrepreneurs. It offers business deposit products and services, including commercial checking accounts, lockbox accounts, and cash concentration accounts, as well as other treasury management services, including information services, wire transfer initiation, ACH initiation, account transfer, and service integration; and consumer deposit products, such as checking accounts, savings accounts, money market accounts, and certificates of deposit. The company also provides commercial loans for general corporate purposes comprising financing for working capital, internal growth, and acquisitions, as well as financing for business insurance premiums; real estate term and construction loans; mortgage warehouse lending; mortgage correspondent aggregation; equipment finance and leasing; treasury management services, including online banking and debit and credit card services; escrow services; and letters of credit. In addition, it offers personal wealth management and trust services; secured and unsecured loans; and online and mobile banking services. Further, the company provides American Airlines AAdvantage, an all-digital branch offering depositors. It operates in Austin, Fort Worth, Dallas, Houston, and San Antonio metropolitan areas of Texas. Texas Capital Bancshares, Inc. was founded in 1996 and is headquartered in Dallas, Texas."
TCBI,2018-12-31,NA,373351000,NA,293387000,443622000,905884000,0,397658000,NA,79964000,905884000,508226000,0,-24307000,NA,293387000,283637000,64604000,income_statement,Banks—Regional,"Texas Capital Bancshares, Inc.","Texas Capital Bancshares, Inc. operates as the bank holding company for Texas Capital Bank, National Association that provides various banking products and services for commercial businesses, and professionals and entrepreneurs. It offers business deposit products and services, including commercial checking accounts, lockbox accounts, and cash concentration accounts, as well as other treasury management services, including information services, wire transfer initiation, ACH initiation, account transfer, and service integration; and consumer deposit products, such as checking accounts, savings accounts, money market accounts, and certificates of deposit. The company also provides commercial loans for general corporate purposes comprising financing for working capital, internal growth, and acquisitions, as well as financing for business insurance premiums; real estate term and construction loans; mortgage warehouse lending; mortgage correspondent aggregation; equipment finance and leasing; treasury management services, including online banking and debit and credit card services; escrow services; and letters of credit. In addition, it offers personal wealth management and trust services; secured and unsecured loans; and online and mobile banking services. Further, the company provides American Airlines AAdvantage, an all-digital branch offering depositors. It operates in Austin, Fort Worth, Dallas, Houston, and San Antonio metropolitan areas of Texas. Texas Capital Bancshares, Inc. was founded in 1996 and is headquartered in Dallas, Texas."
TCBI,2019-12-31,NA,396310000,NA,312015000,512113000,982160000,0,408576000,NA,84295000,982160000,573584000,0,-12266000,NA,312015000,302265000,61471000,income_statement,Banks—Regional,"Texas Capital Bancshares, Inc.","Texas Capital Bancshares, Inc. operates as the bank holding company for Texas Capital Bank, National Association that provides various banking products and services for commercial businesses, and professionals and entrepreneurs. It offers business deposit products and services, including commercial checking accounts, lockbox accounts, and cash concentration accounts, as well as other treasury management services, including information services, wire transfer initiation, ACH initiation, account transfer, and service integration; and consumer deposit products, such as checking accounts, savings accounts, money market accounts, and certificates of deposit. The company also provides commercial loans for general corporate purposes comprising financing for working capital, internal growth, and acquisitions, as well as financing for business insurance premiums; real estate term and construction loans; mortgage warehouse lending; mortgage correspondent aggregation; equipment finance and leasing; treasury management services, including online banking and debit and credit card services; escrow services; and letters of credit. In addition, it offers personal wealth management and trust services; secured and unsecured loans; and online and mobile banking services. Further, the company provides American Airlines AAdvantage, an all-digital branch offering depositors. It operates in Austin, Fort Worth, Dallas, Houston, and San Antonio metropolitan areas of Texas. Texas Capital Bancshares, Inc. was founded in 1996 and is headquartered in Dallas, Texas."
TCBI,2020-12-31,NA,91946000,NA,66289000,494351000,796342000,0,215721000,NA,25657000,796342000,580621000,0,-123775000,NA,66289000,56539000,86270000,income_statement,Banks—Regional,"Texas Capital Bancshares, Inc.","Texas Capital Bancshares, Inc. operates as the bank holding company for Texas Capital Bank, National Association that provides various banking products and services for commercial businesses, and professionals and entrepreneurs. It offers business deposit products and services, including commercial checking accounts, lockbox accounts, and cash concentration accounts, as well as other treasury management services, including information services, wire transfer initiation, ACH initiation, account transfer, and service integration; and consumer deposit products, such as checking accounts, savings accounts, money market accounts, and certificates of deposit. The company also provides commercial loans for general corporate purposes comprising financing for working capital, internal growth, and acquisitions, as well as financing for business insurance premiums; real estate term and construction loans; mortgage warehouse lending; mortgage correspondent aggregation; equipment finance and leasing; treasury management services, including online banking and debit and credit card services; escrow services; and letters of credit. In addition, it offers personal wealth management and trust services; secured and unsecured loans; and online and mobile banking services. Further, the company provides American Airlines AAdvantage, an all-digital branch offering depositors. It operates in Austin, Fort Worth, Dallas, Houston, and San Antonio metropolitan areas of Texas. Texas Capital Bancshares, Inc. was founded in 1996 and is headquartered in Dallas, Texas."
TCBIL,2017-12-31,NA,325708000,NA,197063000,377564000,791584000,0,355655000,NA,128645000,791584000,435929000,0,-29947000,NA,197063000,187313000,58365000,income_statement,NA,NA,NA
TCBIL,2018-12-31,NA,373351000,NA,293387000,443622000,905884000,0,397658000,NA,79964000,905884000,508226000,0,-24307000,NA,293387000,283637000,64604000,income_statement,NA,NA,NA
TCBIL,2019-12-31,NA,396310000,NA,312015000,512113000,982160000,0,408576000,NA,84295000,982160000,573584000,0,-12266000,NA,312015000,302265000,61471000,income_statement,NA,NA,NA
TCBIL,2020-12-31,NA,91946000,NA,66289000,494351000,796342000,0,215721000,NA,25657000,796342000,580621000,0,-123775000,NA,66289000,56539000,86270000,income_statement,NA,NA,NA
TCBIP,2017-12-31,NA,325708000,NA,197063000,377564000,791584000,0,355655000,NA,128645000,791584000,435929000,0,-29947000,NA,197063000,187313000,58365000,income_statement,Banks—Regional,"Texas Capital Bancshares, Inc.","Texas Capital Bancshares, Inc. operates as the bank holding company for Texas Capital Bank, National Association that provides various banking products and services for commercial businesses, and professionals and entrepreneurs. It offers business deposit products and services, including commercial checking accounts, lockbox accounts, and cash concentration accounts, as well as other treasury management services, including information services, wire transfer initiation, ACH initiation, account transfer, and service integration; and consumer deposit products, such as checking accounts, savings accounts, money market accounts, and certificates of deposit. The company also provides commercial loans for general corporate purposes comprising financing for working capital, internal growth, and acquisitions, as well as financing for business insurance premiums; real estate term and construction loans; mortgage warehouse lending; mortgage correspondent aggregation; equipment finance and leasing; treasury management services, including online banking and debit and credit card services; escrow services; and letters of credit. In addition, it offers personal wealth management and trust services; secured and unsecured loans; and online and mobile banking services. Further, the company provides American Airlines AAdvantage, an all-digital branch offering depositors. It operates in Austin, Fort Worth, Dallas, Houston, and San Antonio metropolitan areas of Texas. Texas Capital Bancshares, Inc. was founded in 1996 and is headquartered in Dallas, Texas."
TCBIP,2018-12-31,NA,373351000,NA,293387000,443622000,905884000,0,397658000,NA,79964000,905884000,508226000,0,-24307000,NA,293387000,283637000,64604000,income_statement,Banks—Regional,"Texas Capital Bancshares, Inc.","Texas Capital Bancshares, Inc. operates as the bank holding company for Texas Capital Bank, National Association that provides various banking products and services for commercial businesses, and professionals and entrepreneurs. It offers business deposit products and services, including commercial checking accounts, lockbox accounts, and cash concentration accounts, as well as other treasury management services, including information services, wire transfer initiation, ACH initiation, account transfer, and service integration; and consumer deposit products, such as checking accounts, savings accounts, money market accounts, and certificates of deposit. The company also provides commercial loans for general corporate purposes comprising financing for working capital, internal growth, and acquisitions, as well as financing for business insurance premiums; real estate term and construction loans; mortgage warehouse lending; mortgage correspondent aggregation; equipment finance and leasing; treasury management services, including online banking and debit and credit card services; escrow services; and letters of credit. In addition, it offers personal wealth management and trust services; secured and unsecured loans; and online and mobile banking services. Further, the company provides American Airlines AAdvantage, an all-digital branch offering depositors. It operates in Austin, Fort Worth, Dallas, Houston, and San Antonio metropolitan areas of Texas. Texas Capital Bancshares, Inc. was founded in 1996 and is headquartered in Dallas, Texas."
TCBIP,2019-12-31,NA,396310000,NA,312015000,512113000,982160000,0,408576000,NA,84295000,982160000,573584000,0,-12266000,NA,312015000,302265000,61471000,income_statement,Banks—Regional,"Texas Capital Bancshares, Inc.","Texas Capital Bancshares, Inc. operates as the bank holding company for Texas Capital Bank, National Association that provides various banking products and services for commercial businesses, and professionals and entrepreneurs. It offers business deposit products and services, including commercial checking accounts, lockbox accounts, and cash concentration accounts, as well as other treasury management services, including information services, wire transfer initiation, ACH initiation, account transfer, and service integration; and consumer deposit products, such as checking accounts, savings accounts, money market accounts, and certificates of deposit. The company also provides commercial loans for general corporate purposes comprising financing for working capital, internal growth, and acquisitions, as well as financing for business insurance premiums; real estate term and construction loans; mortgage warehouse lending; mortgage correspondent aggregation; equipment finance and leasing; treasury management services, including online banking and debit and credit card services; escrow services; and letters of credit. In addition, it offers personal wealth management and trust services; secured and unsecured loans; and online and mobile banking services. Further, the company provides American Airlines AAdvantage, an all-digital branch offering depositors. It operates in Austin, Fort Worth, Dallas, Houston, and San Antonio metropolitan areas of Texas. Texas Capital Bancshares, Inc. was founded in 1996 and is headquartered in Dallas, Texas."
TCBIP,2020-12-31,NA,91946000,NA,66289000,494351000,796342000,0,215721000,NA,25657000,796342000,580621000,0,-123775000,NA,66289000,56539000,86270000,income_statement,Banks—Regional,"Texas Capital Bancshares, Inc.","Texas Capital Bancshares, Inc. operates as the bank holding company for Texas Capital Bank, National Association that provides various banking products and services for commercial businesses, and professionals and entrepreneurs. It offers business deposit products and services, including commercial checking accounts, lockbox accounts, and cash concentration accounts, as well as other treasury management services, including information services, wire transfer initiation, ACH initiation, account transfer, and service integration; and consumer deposit products, such as checking accounts, savings accounts, money market accounts, and certificates of deposit. The company also provides commercial loans for general corporate purposes comprising financing for working capital, internal growth, and acquisitions, as well as financing for business insurance premiums; real estate term and construction loans; mortgage warehouse lending; mortgage correspondent aggregation; equipment finance and leasing; treasury management services, including online banking and debit and credit card services; escrow services; and letters of credit. In addition, it offers personal wealth management and trust services; secured and unsecured loans; and online and mobile banking services. Further, the company provides American Airlines AAdvantage, an all-digital branch offering depositors. It operates in Austin, Fort Worth, Dallas, Houston, and San Antonio metropolitan areas of Texas. Texas Capital Bancshares, Inc. was founded in 1996 and is headquartered in Dallas, Texas."
TCBK,2017-12-31,NA,77512000,NA,40554000,97925000,223825000,0,78042000,NA,36958000,223825000,145783000,0,-530000,NA,40554000,40554000,47858000,income_statement,Banks—Regional,TriCo Bancshares,"TriCo Bancshares operates as a bank holding company for Tri Counties Bank that provides commercial banking services to individual and corporate customers. The company accepts demand, savings, and time deposits. It also provides small business loans; real estate mortgage loans, such as residential and commercial loans; consumer loans; commercial loans, including agricultural loans; and real estate construction loans. In addition, the company offers treasury management services; and other customary banking services, including safe deposit boxes; and independent financial and broker-dealer services. It operates 69 traditional branches, 7 in-store branches, and 2 loan production offices in northern and central California. TriCo Bancshares was incorporated in 1974 and is headquartered in Chico, California."
TCBK,2018-12-31,NA,93352000,NA,68320000,110659000,261639000,0,98579000,NA,25032000,261639000,163060000,0,-5227000,NA,68320000,68320000,52401000,income_statement,Banks—Regional,TriCo Bancshares,"TriCo Bancshares operates as a bank holding company for Tri Counties Bank that provides commercial banking services to individual and corporate customers. The company accepts demand, savings, and time deposits. It also provides small business loans; real estate mortgage loans, such as residential and commercial loans; consumer loans; commercial loans, including agricultural loans; and real estate construction loans. In addition, the company offers treasury management services; and other customary banking services, including safe deposit boxes; and independent financial and broker-dealer services. It operates 69 traditional branches, 7 in-store branches, and 2 loan production offices in northern and central California. TriCo Bancshares was incorporated in 1974 and is headquartered in Chico, California."
TCBK,2019-12-31,NA,126822000,NA,92072000,126591000,311366000,0,125991000,NA,34750000,311366000,185375000,0,831000,NA,92072000,92072000,58784000,income_statement,Banks—Regional,TriCo Bancshares,"TriCo Bancshares operates as a bank holding company for Tri Counties Bank that provides commercial banking services to individual and corporate customers. The company accepts demand, savings, and time deposits. It also provides small business loans; real estate mortgage loans, such as residential and commercial loans; consumer loans; commercial loans, including agricultural loans; and real estate construction loans. In addition, the company offers treasury management services; and other customary banking services, including safe deposit boxes; and independent financial and broker-dealer services. It operates 69 traditional branches, 7 in-store branches, and 2 loan production offices in northern and central California. TriCo Bancshares was incorporated in 1974 and is headquartered in Chico, California."
TCBK,2020-12-31,NA,87350000,NA,64814000,156989000,269543000,0,93935000,NA,22536000,269543000,175608000,0,-6585000,NA,64814000,64814000,18619000,income_statement,Banks—Regional,TriCo Bancshares,"TriCo Bancshares operates as a bank holding company for Tri Counties Bank that provides commercial banking services to individual and corporate customers. The company accepts demand, savings, and time deposits. It also provides small business loans; real estate mortgage loans, such as residential and commercial loans; consumer loans; commercial loans, including agricultural loans; and real estate construction loans. In addition, the company offers treasury management services; and other customary banking services, including safe deposit boxes; and independent financial and broker-dealer services. It operates 69 traditional branches, 7 in-store branches, and 2 loan production offices in northern and central California. TriCo Bancshares was incorporated in 1974 and is headquartered in Chico, California."
TCDA,2016-12-31,21820000,-28651000,NA,-28651000,5363000,0,-27183000,-27183000,-3137000,0,0,27183000,0,-1468000,NA,-28651000,-28651000,NA,income_statement,Drug Manufacturers—Specialty & Generic,"Tricida, Inc.","Tricida, Inc., a pharmaceutical company, focuses on the development and commercialization of its drug candidate, TRC101, a non-absorbed, orally-administered polymer designed as a potential treatment for metabolic acidosis in patients with chronic kidney disease (CKD). The company has completed a Phase 3, double-blind, placebo-controlled trial of TRC101 in patients with CKD and metabolic acidosis. Tricida, Inc. was founded in 2013 and is headquartered in South San Francisco, California."
TCDA,2017-12-31,35906000,-41290000,NA,-41290000,11216000,0,-47122000,-47122000,-3137000,0,0,47122000,0,5832000,NA,-41290000,-41290000,NA,income_statement,Drug Manufacturers—Specialty & Generic,"Tricida, Inc.","Tricida, Inc., a pharmaceutical company, focuses on the development and commercialization of its drug candidate, TRC101, a non-absorbed, orally-administered polymer designed as a potential treatment for metabolic acidosis in patients with chronic kidney disease (CKD). The company has completed a Phase 3, double-blind, placebo-controlled trial of TRC101 in patients with CKD and metabolic acidosis. Tricida, Inc. was founded in 2013 and is headquartered in South San Francisco, California."
TCDA,2018-12-31,85594000,-102808000,NA,-102808000,18001000,0,-103595000,-103595000,-3137000,0,0,103595000,0,787000,NA,-102808000,-102808000,NA,income_statement,Drug Manufacturers—Specialty & Generic,"Tricida, Inc.","Tricida, Inc., a pharmaceutical company, focuses on the development and commercialization of its drug candidate, TRC101, a non-absorbed, orally-administered polymer designed as a potential treatment for metabolic acidosis in patients with chronic kidney disease (CKD). The company has completed a Phase 3, double-blind, placebo-controlled trial of TRC101 in patients with CKD and metabolic acidosis. Tricida, Inc. was founded in 2013 and is headquartered in South San Francisco, California."
TCDA,2019-12-31,133028000,-176905000,NA,-176813000,45796000,0,-178824000,-178824000,-5744000,-92000,0,178824000,0,1919000,NA,-176813000,-176813000,NA,income_statement,Drug Manufacturers—Specialty & Generic,"Tricida, Inc.","Tricida, Inc., a pharmaceutical company, focuses on the development and commercialization of its drug candidate, TRC101, a non-absorbed, orally-administered polymer designed as a potential treatment for metabolic acidosis in patients with chronic kidney disease (CKD). The company has completed a Phase 3, double-blind, placebo-controlled trial of TRC101 in patients with CKD and metabolic acidosis. Tricida, Inc. was founded in 2013 and is headquartered in South San Francisco, California."
TCF,2017-12-31,NA,245160000,17827000,268637000,743359000,1305094000,0,336325000,NA,-33624000,1305094000,968769000,0,-91165000,NA,278784000,242912000,225410000,income_statement,Banks—Regional,TCF Financial Corporation,"TCF Financial Corporation operates as the financial holding company for TCF National Bank that provides various financial products and services in the United States and Canada. It operates through Consumer Banking, Wholesale Banking, and Enterprise Services segments. The company offers checking, savings, and money market accounts; certificates of deposit; and individual retirement accounts. It also provides consumer loans; loans secured by personal property, as well as unsecured personal loans; commercial and industrial loans; commercial real estate loans; lease and equipment financing products; inventory financing products; and residential, consumer, and small business lending products. In addition, the company offers investment management and custodial, trust, and financial and estate planning services; retirement planning and employee benefit programs; and cash management, international trade finance, foreign exchange management, and loan syndication services, as well as sells investment products, such as annuity products and mutual funds. Further, it provides treasury services comprising investment and borrowing portfolios, as well as manages capital, debt, and market risks; check cashing and remittance services; lines of credit, letters of credit, and capital market products; and credit and debit cards. As of December 31, 2019, the company had 520 branches, including 396 traditional branches, 121 supermarket branches, and three campus branches located in Michigan, Illinois, Minnesota, Colorado, Ohio, Wisconsin, Arizona, and South Dakota; and 1,099 ATMs. TCF Financial Corporation was founded in 1923 and is headquartered in Detroit, Michigan."
TCF,2018-12-31,NA,401724000,18459000,304358000,769984000,1416124000,0,450774000,NA,86096000,1416124000,965350000,0,-49050000,NA,315628000,289247000,195366000,income_statement,Banks—Regional,TCF Financial Corporation,"TCF Financial Corporation operates as the financial holding company for TCF National Bank that provides various financial products and services in the United States and Canada. It operates through Consumer Banking, Wholesale Banking, and Enterprise Services segments. The company offers checking, savings, and money market accounts; certificates of deposit; and individual retirement accounts. It also provides consumer loans; loans secured by personal property, as well as unsecured personal loans; commercial and industrial loans; commercial real estate loans; lease and equipment financing products; inventory financing products; and residential, consumer, and small business lending products. In addition, the company offers investment management and custodial, trust, and financial and estate planning services; retirement planning and employee benefit programs; and cash management, international trade finance, foreign exchange management, and loan syndication services, as well as sells investment products, such as annuity products and mutual funds. Further, it provides treasury services comprising investment and borrowing portfolios, as well as manages capital, debt, and market risks; check cashing and remittance services; lines of credit, letters of credit, and capital market products; and credit and debit cards. As of December 31, 2019, the company had 520 branches, including 396 traditional branches, 121 supermarket branches, and three campus branches located in Michigan, Illinois, Minnesota, Colorado, Ohio, Wisconsin, Arizona, and South Dakota; and 1,099 ATMs. TCF Financial Corporation was founded in 1923 and is headquartered in Detroit, Michigan."
TCF,2019-12-31,NA,357167000,20226000,295468000,871128000,1693164000,0,555924000,NA,50241000,1693164000,1137240000,0,-198757000,NA,306926000,285473000,266112000,income_statement,Banks—Regional,TCF Financial Corporation,"TCF Financial Corporation operates as the financial holding company for TCF National Bank that provides various financial products and services in the United States and Canada. It operates through Consumer Banking, Wholesale Banking, and Enterprise Services segments. The company offers checking, savings, and money market accounts; certificates of deposit; and individual retirement accounts. It also provides consumer loans; loans secured by personal property, as well as unsecured personal loans; commercial and industrial loans; commercial real estate loans; lease and equipment financing products; inventory financing products; and residential, consumer, and small business lending products. In addition, the company offers investment management and custodial, trust, and financial and estate planning services; retirement planning and employee benefit programs; and cash management, international trade finance, foreign exchange management, and loan syndication services, as well as sells investment products, such as annuity products and mutual funds. Further, it provides treasury services comprising investment and borrowing portfolios, as well as manages capital, debt, and market risks; check cashing and remittance services; lines of credit, letters of credit, and capital market products; and credit and debit cards. As of December 31, 2019, the company had 520 branches, including 396 traditional branches, 121 supermarket branches, and three campus branches located in Michigan, Illinois, Minnesota, Colorado, Ohio, Wisconsin, Arizona, and South Dakota; and 1,099 ATMs. TCF Financial Corporation was founded in 1923 and is headquartered in Detroit, Michigan."
TCF,2020-12-31,NA,269942000,18484000,222759000,985596000,1813518000,0,497122000,NA,39901000,1813518000,1316396000,0,-227180000,NA,230041000,212784000,330800000,income_statement,Banks—Regional,TCF Financial Corporation,"TCF Financial Corporation operates as the financial holding company for TCF National Bank that provides various financial products and services in the United States and Canada. It operates through Consumer Banking, Wholesale Banking, and Enterprise Services segments. The company offers checking, savings, and money market accounts; certificates of deposit; and individual retirement accounts. It also provides consumer loans; loans secured by personal property, as well as unsecured personal loans; commercial and industrial loans; commercial real estate loans; lease and equipment financing products; inventory financing products; and residential, consumer, and small business lending products. In addition, the company offers investment management and custodial, trust, and financial and estate planning services; retirement planning and employee benefit programs; and cash management, international trade finance, foreign exchange management, and loan syndication services, as well as sells investment products, such as annuity products and mutual funds. Further, it provides treasury services comprising investment and borrowing portfolios, as well as manages capital, debt, and market risks; check cashing and remittance services; lines of credit, letters of credit, and capital market products; and credit and debit cards. As of December 31, 2019, the company had 520 branches, including 396 traditional branches, 121 supermarket branches, and three campus branches located in Michigan, Illinois, Minnesota, Colorado, Ohio, Wisconsin, Arizona, and South Dakota; and 1,099 ATMs. TCF Financial Corporation was founded in 1923 and is headquartered in Detroit, Michigan."
TCFC,2017-12-31,NA,16365000,NA,7208000,25045000,46419000,0,18535000,NA,9157000,46419000,27884000,0,-2170000,NA,7208000,7208000,2839000,income_statement,Banks—Regional,The Community Financial Corpora,"The Community Financial Corporation operates as the bank holding company for Community Bank of the Chesapeake that provides commercial and retail banking services to individuals and businesses. Its deposit products include savings, money market, demand deposit, IRA, SEP, and time deposit accounts. The company provides loan products, such as commercial real estate and other non-residential real estate, residential first mortgage, residential rental mortgage, construction and land development, home equity and second mortgage, commercial, consumer, and commercial equipment loans. It also offers safe deposit box, night depository, cash vault, automated clearinghouse transaction, wire transfer, automated teller machine (ATM), online and telephone banking, retail and business mobile banking, remote deposit capture, reciprocal deposit, merchant card, credit monitoring, investment, positive pay, payroll, account reconciliation, bill pay, credit card, and lockbox services. As of December 31, 2019, it operated 12 banking centers in Waldorf, Bryans Road, Dunkirk, Leonardtown, La Plata, Charlotte Hall, Prince Frederick, Lusby, and California, Maryland, as well as Fredericksburg, Virginia; four loan production offices in La Plata, Prince Frederick, and Leonardtown, Maryland, as well as Fredericksburg, Virginia; and 15 ATMs. The company was formerly known as Tri-County Financial Corporation and changed its name to The Community Financial Corporation in October 2013. The Community Financial Corporation was founded in 1950 and is headquartered in Waldorf, Maryland."
TCFC,2018-12-31,NA,15401000,NA,11228000,29104000,53550000,0,21121000,NA,4173000,53550000,32429000,0,-5720000,NA,11228000,11228000,3325000,income_statement,Banks—Regional,The Community Financial Corpora,"The Community Financial Corporation operates as the bank holding company for Community Bank of the Chesapeake that provides commercial and retail banking services to individuals and businesses. Its deposit products include savings, money market, demand deposit, IRA, SEP, and time deposit accounts. The company provides loan products, such as commercial real estate and other non-residential real estate, residential first mortgage, residential rental mortgage, construction and land development, home equity and second mortgage, commercial, consumer, and commercial equipment loans. It also offers safe deposit box, night depository, cash vault, automated clearinghouse transaction, wire transfer, automated teller machine (ATM), online and telephone banking, retail and business mobile banking, remote deposit capture, reciprocal deposit, merchant card, credit monitoring, investment, positive pay, payroll, account reconciliation, bill pay, credit card, and lockbox services. As of December 31, 2019, it operated 12 banking centers in Waldorf, Bryans Road, Dunkirk, Leonardtown, La Plata, Charlotte Hall, Prince Frederick, Lusby, and California, Maryland, as well as Fredericksburg, Virginia; four loan production offices in La Plata, Prince Frederick, and Leonardtown, Maryland, as well as Fredericksburg, Virginia; and 15 ATMs. The company was formerly known as Tri-County Financial Corporation and changed its name to The Community Financial Corporation in October 2013. The Community Financial Corporation was founded in 1950 and is headquartered in Waldorf, Maryland."
TCFC,2019-12-31,NA,20937000,NA,15272000,30589000,57170000,0,22922000,NA,5665000,57170000,34248000,0,-1985000,NA,15272000,15272000,3659000,income_statement,Banks—Regional,The Community Financial Corpora,"The Community Financial Corporation operates as the bank holding company for Community Bank of the Chesapeake that provides commercial and retail banking services to individuals and businesses. Its deposit products include savings, money market, demand deposit, IRA, SEP, and time deposit accounts. The company provides loan products, such as commercial real estate and other non-residential real estate, residential first mortgage, residential rental mortgage, construction and land development, home equity and second mortgage, commercial, consumer, and commercial equipment loans. It also offers safe deposit box, night depository, cash vault, automated clearinghouse transaction, wire transfer, automated teller machine (ATM), online and telephone banking, retail and business mobile banking, remote deposit capture, reciprocal deposit, merchant card, credit monitoring, investment, positive pay, payroll, account reconciliation, bill pay, credit card, and lockbox services. As of December 31, 2019, it operated 12 banking centers in Waldorf, Bryans Road, Dunkirk, Leonardtown, La Plata, Charlotte Hall, Prince Frederick, Lusby, and California, Maryland, as well as Fredericksburg, Virginia; four loan production offices in La Plata, Prince Frederick, and Leonardtown, Maryland, as well as Fredericksburg, Virginia; and 15 ATMs. The company was formerly known as Tri-County Financial Corporation and changed its name to The Community Financial Corporation in October 2013. The Community Financial Corporation was founded in 1950 and is headquartered in Waldorf, Maryland."
TCFC,2020-12-31,NA,20630000,NA,16136000,30085000,58633000,0,25360000,NA,4494000,58633000,33273000,0,-4730000,NA,16136000,16136000,3188000,income_statement,Banks—Regional,The Community Financial Corpora,"The Community Financial Corporation operates as the bank holding company for Community Bank of the Chesapeake that provides commercial and retail banking services to individuals and businesses. Its deposit products include savings, money market, demand deposit, IRA, SEP, and time deposit accounts. The company provides loan products, such as commercial real estate and other non-residential real estate, residential first mortgage, residential rental mortgage, construction and land development, home equity and second mortgage, commercial, consumer, and commercial equipment loans. It also offers safe deposit box, night depository, cash vault, automated clearinghouse transaction, wire transfer, automated teller machine (ATM), online and telephone banking, retail and business mobile banking, remote deposit capture, reciprocal deposit, merchant card, credit monitoring, investment, positive pay, payroll, account reconciliation, bill pay, credit card, and lockbox services. As of December 31, 2019, it operated 12 banking centers in Waldorf, Bryans Road, Dunkirk, Leonardtown, La Plata, Charlotte Hall, Prince Frederick, Lusby, and California, Maryland, as well as Fredericksburg, Virginia; four loan production offices in La Plata, Prince Frederick, and Leonardtown, Maryland, as well as Fredericksburg, Virginia; and 15 ATMs. The company was formerly known as Tri-County Financial Corporation and changed its name to The Community Financial Corporation in October 2013. The Community Financial Corporation was founded in 1950 and is headquartered in Waldorf, Maryland."
TCFCP,2017-12-31,NA,245160000,17827000,268637000,743359000,1305094000,0,336325000,NA,-33624000,1305094000,968769000,0,-91165000,NA,278784000,242912000,225410000,income_statement,Banks—Regional,TCF Financial Corporation - Dep,"TCF Financial Corporation operates as the financial holding company for TCF National Bank that provides various financial products and services in the United States and Canada. It operates through Consumer Banking, Wholesale Banking, and Enterprise Services segments. The company offers checking, savings, and money market accounts; certificates of deposit; and individual retirement accounts. It also provides consumer loans; loans secured by personal property, as well as unsecured personal loans; commercial and industrial loans; commercial real estate loans; lease and equipment financing products; inventory financing products; and residential, consumer, and small business lending products. In addition, the company offers investment management and custodial, trust, and financial and estate planning services; retirement planning and employee benefit programs; and cash management, international trade finance, foreign exchange management, and loan syndication services, as well as sells investment products, such as annuity products and mutual funds. Further, it provides treasury services comprising investment and borrowing portfolios, as well as manages capital, debt, and market risks; check cashing and remittance services; lines of credit, letters of credit, and capital market products; and credit and debit cards. As of December 31, 2019, the company had 520 branches, including 396 traditional branches, 121 supermarket branches, and three campus branches located in Michigan, Illinois, Minnesota, Colorado, Ohio, Wisconsin, Arizona, and South Dakota; and 1,099 ATMs. TCF Financial Corporation was founded in 1923 and is headquartered in Detroit, Michigan."
TCFCP,2018-12-31,NA,401724000,18459000,304358000,769984000,1416124000,0,450774000,NA,86096000,1416124000,965350000,0,-49050000,NA,315628000,289247000,195366000,income_statement,Banks—Regional,TCF Financial Corporation - Dep,"TCF Financial Corporation operates as the financial holding company for TCF National Bank that provides various financial products and services in the United States and Canada. It operates through Consumer Banking, Wholesale Banking, and Enterprise Services segments. The company offers checking, savings, and money market accounts; certificates of deposit; and individual retirement accounts. It also provides consumer loans; loans secured by personal property, as well as unsecured personal loans; commercial and industrial loans; commercial real estate loans; lease and equipment financing products; inventory financing products; and residential, consumer, and small business lending products. In addition, the company offers investment management and custodial, trust, and financial and estate planning services; retirement planning and employee benefit programs; and cash management, international trade finance, foreign exchange management, and loan syndication services, as well as sells investment products, such as annuity products and mutual funds. Further, it provides treasury services comprising investment and borrowing portfolios, as well as manages capital, debt, and market risks; check cashing and remittance services; lines of credit, letters of credit, and capital market products; and credit and debit cards. As of December 31, 2019, the company had 520 branches, including 396 traditional branches, 121 supermarket branches, and three campus branches located in Michigan, Illinois, Minnesota, Colorado, Ohio, Wisconsin, Arizona, and South Dakota; and 1,099 ATMs. TCF Financial Corporation was founded in 1923 and is headquartered in Detroit, Michigan."
TCFCP,2019-12-31,NA,357167000,20226000,295468000,871128000,1693164000,0,555924000,NA,50241000,1693164000,1137240000,0,-198757000,NA,306926000,285473000,266112000,income_statement,Banks—Regional,TCF Financial Corporation - Dep,"TCF Financial Corporation operates as the financial holding company for TCF National Bank that provides various financial products and services in the United States and Canada. It operates through Consumer Banking, Wholesale Banking, and Enterprise Services segments. The company offers checking, savings, and money market accounts; certificates of deposit; and individual retirement accounts. It also provides consumer loans; loans secured by personal property, as well as unsecured personal loans; commercial and industrial loans; commercial real estate loans; lease and equipment financing products; inventory financing products; and residential, consumer, and small business lending products. In addition, the company offers investment management and custodial, trust, and financial and estate planning services; retirement planning and employee benefit programs; and cash management, international trade finance, foreign exchange management, and loan syndication services, as well as sells investment products, such as annuity products and mutual funds. Further, it provides treasury services comprising investment and borrowing portfolios, as well as manages capital, debt, and market risks; check cashing and remittance services; lines of credit, letters of credit, and capital market products; and credit and debit cards. As of December 31, 2019, the company had 520 branches, including 396 traditional branches, 121 supermarket branches, and three campus branches located in Michigan, Illinois, Minnesota, Colorado, Ohio, Wisconsin, Arizona, and South Dakota; and 1,099 ATMs. TCF Financial Corporation was founded in 1923 and is headquartered in Detroit, Michigan."
TCFCP,2020-12-31,NA,269942000,18484000,222759000,985596000,1813518000,0,497122000,NA,39901000,1813518000,1316396000,0,-227180000,NA,230041000,212784000,330800000,income_statement,Banks—Regional,TCF Financial Corporation - Dep,"TCF Financial Corporation operates as the financial holding company for TCF National Bank that provides various financial products and services in the United States and Canada. It operates through Consumer Banking, Wholesale Banking, and Enterprise Services segments. The company offers checking, savings, and money market accounts; certificates of deposit; and individual retirement accounts. It also provides consumer loans; loans secured by personal property, as well as unsecured personal loans; commercial and industrial loans; commercial real estate loans; lease and equipment financing products; inventory financing products; and residential, consumer, and small business lending products. In addition, the company offers investment management and custodial, trust, and financial and estate planning services; retirement planning and employee benefit programs; and cash management, international trade finance, foreign exchange management, and loan syndication services, as well as sells investment products, such as annuity products and mutual funds. Further, it provides treasury services comprising investment and borrowing portfolios, as well as manages capital, debt, and market risks; check cashing and remittance services; lines of credit, letters of credit, and capital market products; and credit and debit cards. As of December 31, 2019, the company had 520 branches, including 396 traditional branches, 121 supermarket branches, and three campus branches located in Michigan, Illinois, Minnesota, Colorado, Ohio, Wisconsin, Arizona, and South Dakota; and 1,099 ATMs. TCF Financial Corporation was founded in 1923 and is headquartered in Detroit, Michigan."
TCMD,2016-12-31,4476000,4310000,NA,2879000,52854000,61602000,4272000,4272000,NA,1431000,84542000,80270000,22940000,38000,NA,2879000,1632000,NA,income_statement,Medical Devices,"Tactile Systems Technology, Inc","Tactile Systems Technology, Inc., a medical technology company, develops and provides medical devices for chronic diseases in the United States. The company offers Flexitouch Plus system, a pneumatic compression device for the treatment of lymphedema; EntrÃ© System, a portable pneumatic compression device that is used for the at-home treatment of venous disorders, such as lymphedema and chronic venous insufficiency, including venous leg ulcers; and ACTitouch system, a medical device for the treatment of venous leg ulcers chronic venous insufficiency patients. It also provides Airwear Gradient Compression Wrap that is used in the management of venous insufficiency, venous hypertension, venous ulcerations, and lymphedema under the trade name Aero-Wrap. The company was founded in 1995 and is headquartered in Minneapolis, Minnesota."
TCMD,2017-12-31,5060000,4190000,NA,5855000,71310000,80268000,3898000,3898000,NA,-1665000,109283000,105385000,29015000,292000,NA,5855000,5855000,NA,income_statement,Medical Devices,"Tactile Systems Technology, Inc","Tactile Systems Technology, Inc., a medical technology company, develops and provides medical devices for chronic diseases in the United States. The company offers Flexitouch Plus system, a pneumatic compression device for the treatment of lymphedema; EntrÃ© System, a portable pneumatic compression device that is used for the at-home treatment of venous disorders, such as lymphedema and chronic venous insufficiency, including venous leg ulcers; and ACTitouch system, a medical device for the treatment of venous leg ulcers chronic venous insufficiency patients. It also provides Airwear Gradient Compression Wrap that is used in the management of venous insufficiency, venous hypertension, venous ulcerations, and lymphedema under the trade name Aero-Wrap. The company was founded in 1995 and is headquartered in Minneapolis, Minnesota."
TCMD,2018-12-31,5289000,3476000,NA,6623000,92179000,102258000,4790000,4790000,NA,-3147000,143751000,138961000,41493000,-1314000,NA,6623000,6623000,NA,income_statement,Medical Devices,"Tactile Systems Technology, Inc","Tactile Systems Technology, Inc., a medical technology company, develops and provides medical devices for chronic diseases in the United States. The company offers Flexitouch Plus system, a pneumatic compression device for the treatment of lymphedema; EntrÃ© System, a portable pneumatic compression device that is used for the at-home treatment of venous disorders, such as lymphedema and chronic venous insufficiency, including venous leg ulcers; and ACTitouch system, a medical device for the treatment of venous leg ulcers chronic venous insufficiency patients. It also provides Airwear Gradient Compression Wrap that is used in the management of venous insufficiency, venous hypertension, venous ulcerations, and lymphedema under the trade name Aero-Wrap. The company was founded in 1995 and is headquartered in Minneapolis, Minnesota."
TCMD,2019-12-31,5174000,11129000,NA,10971000,117416000,134236000,11646000,11646000,NA,158000,189492000,177846000,55256000,-517000,NA,10971000,10971000,NA,income_statement,Medical Devices,"Tactile Systems Technology, Inc","Tactile Systems Technology, Inc., a medical technology company, develops and provides medical devices for chronic diseases in the United States. The company offers Flexitouch Plus system, a pneumatic compression device for the treatment of lymphedema; EntrÃ© System, a portable pneumatic compression device that is used for the at-home treatment of venous disorders, such as lymphedema and chronic venous insufficiency, including venous leg ulcers; and ACTitouch system, a medical device for the treatment of venous leg ulcers chronic venous insufficiency patients. It also provides Airwear Gradient Compression Wrap that is used in the management of venous insufficiency, venous hypertension, venous ulcerations, and lymphedema under the trade name Aero-Wrap. The company was founded in 1995 and is headquartered in Minneapolis, Minnesota."
TCON,2016-12-31,6322000,-27008000,NA,-27008000,7859000,-11795000,-25976000,-25976000,-1119000,0,3449000,29425000,15244000,-1032000,NA,-27008000,-27008000,NA,income_statement,Biotechnology,"TRACON Pharmaceuticals, Inc.","TRACON Pharmaceuticals, Inc., a clinical stage biopharmaceutical company, focuses on the development and commercialization of therapeutics for cancer and wet age-related macular degeneration (AMD). Its lead clinical stage products include envafolimab (KN035), an investigational PD-L1 single-domain antibody for the treatment of soft tissue sarcoma. The company's clinical stage products also include DE-122, which is in randomized Phase IIa study for the treatment of wet AMD; TRC102, which is a small molecule that is in Phase II clinical trial for the treatment of mesothelioma, Phase I clinical trial to treat solid tumors, Phase I/II to treat solid tumors and lymphomas, and Phase I trial to treat lung cancer; TRC253, a small molecule, which is in a Phase II clinical trial for the treatment of metastatic castration-resistant prostate cancer; and TJ004309, a CD73 antibody that is in Phase I clinical development for the treatment of solid tumors. It has collaboration and license agreements with 3D Medicines Co., Ltd. and Jiangsu Alphamab Biopharmaceuticals Co., Ltd. for the development of envafolimab; I-Mab Biopharma for the development of CD73 antibody TJ004309; Janssen Pharmaceutica N.V. for the development of TRC253; Santen Pharmaceutical Co. Ltd. for the development of carotuximab products for ophthalmology indications; Roswell Park Cancer Institute and Health Research Inc.; Case Western Reserve University; and cooperative research and development agreement with National Cancer Institute. The company was formerly known as Lexington Pharmaceuticals, Inc. and changed its name to TRACON Pharmaceuticals, Inc. in March 2005. TRACON Pharmaceuticals, Inc. was founded in 2004 and is headquartered in San Diego, California."
TCON,2017-12-31,6719000,-19103000,NA,-19103000,7610000,-10600000,-18210000,-18210000,-886000,0,8755000,26965000,19355000,-893000,NA,-19103000,-19103000,NA,income_statement,Biotechnology,"TRACON Pharmaceuticals, Inc.","TRACON Pharmaceuticals, Inc., a clinical stage biopharmaceutical company, focuses on the development and commercialization of therapeutics for cancer and wet age-related macular degeneration (AMD). Its lead clinical stage products include envafolimab (KN035), an investigational PD-L1 single-domain antibody for the treatment of soft tissue sarcoma. The company's clinical stage products also include DE-122, which is in randomized Phase IIa study for the treatment of wet AMD; TRC102, which is a small molecule that is in Phase II clinical trial for the treatment of mesothelioma, Phase I clinical trial to treat solid tumors, Phase I/II to treat solid tumors and lymphomas, and Phase I trial to treat lung cancer; TRC253, a small molecule, which is in a Phase II clinical trial for the treatment of metastatic castration-resistant prostate cancer; and TJ004309, a CD73 antibody that is in Phase I clinical development for the treatment of solid tumors. It has collaboration and license agreements with 3D Medicines Co., Ltd. and Jiangsu Alphamab Biopharmaceuticals Co., Ltd. for the development of envafolimab; I-Mab Biopharma for the development of CD73 antibody TJ004309; Janssen Pharmaceutica N.V. for the development of TRC253; Santen Pharmaceutical Co. Ltd. for the development of carotuximab products for ophthalmology indications; Roswell Park Cancer Institute and Health Research Inc.; Case Western Reserve University; and cooperative research and development agreement with National Cancer Institute. The company was formerly known as Lexington Pharmaceuticals, Inc. and changed its name to TRACON Pharmaceuticals, Inc. in March 2005. TRACON Pharmaceuticals, Inc. was founded in 2004 and is headquartered in San Diego, California."
TCON,2018-12-31,6569000,-34959000,NA,-34959000,7280000,-27460000,-34740000,-34740000,-231000,0,3000000,37740000,30460000,-219000,NA,-34959000,-34959000,NA,income_statement,Biotechnology,"TRACON Pharmaceuticals, Inc.","TRACON Pharmaceuticals, Inc., a clinical stage biopharmaceutical company, focuses on the development and commercialization of therapeutics for cancer and wet age-related macular degeneration (AMD). Its lead clinical stage products include envafolimab (KN035), an investigational PD-L1 single-domain antibody for the treatment of soft tissue sarcoma. The company's clinical stage products also include DE-122, which is in randomized Phase IIa study for the treatment of wet AMD; TRC102, which is a small molecule that is in Phase II clinical trial for the treatment of mesothelioma, Phase I clinical trial to treat solid tumors, Phase I/II to treat solid tumors and lymphomas, and Phase I trial to treat lung cancer; TRC253, a small molecule, which is in a Phase II clinical trial for the treatment of metastatic castration-resistant prostate cancer; and TJ004309, a CD73 antibody that is in Phase I clinical development for the treatment of solid tumors. It has collaboration and license agreements with 3D Medicines Co., Ltd. and Jiangsu Alphamab Biopharmaceuticals Co., Ltd. for the development of envafolimab; I-Mab Biopharma for the development of CD73 antibody TJ004309; Janssen Pharmaceutica N.V. for the development of TRC253; Santen Pharmaceutical Co. Ltd. for the development of carotuximab products for ophthalmology indications; Roswell Park Cancer Institute and Health Research Inc.; Case Western Reserve University; and cooperative research and development agreement with National Cancer Institute. The company was formerly known as Lexington Pharmaceuticals, Inc. and changed its name to TRACON Pharmaceuticals, Inc. in March 2005. TRACON Pharmaceuticals, Inc. was founded in 2004 and is headquartered in San Diego, California."
TCON,2019-12-31,NA,-22674000,NA,-22674000,7766000,-14530000,-22296000,-22296000,-386000,0,0,22296000,14530000,-378000,NA,-22674000,-22674000,NA,income_statement,Biotechnology,"TRACON Pharmaceuticals, Inc.","TRACON Pharmaceuticals, Inc., a clinical stage biopharmaceutical company, focuses on the development and commercialization of therapeutics for cancer and wet age-related macular degeneration (AMD). Its lead clinical stage products include envafolimab (KN035), an investigational PD-L1 single-domain antibody for the treatment of soft tissue sarcoma. The company's clinical stage products also include DE-122, which is in randomized Phase IIa study for the treatment of wet AMD; TRC102, which is a small molecule that is in Phase II clinical trial for the treatment of mesothelioma, Phase I clinical trial to treat solid tumors, Phase I/II to treat solid tumors and lymphomas, and Phase I trial to treat lung cancer; TRC253, a small molecule, which is in a Phase II clinical trial for the treatment of metastatic castration-resistant prostate cancer; and TJ004309, a CD73 antibody that is in Phase I clinical development for the treatment of solid tumors. It has collaboration and license agreements with 3D Medicines Co., Ltd. and Jiangsu Alphamab Biopharmaceuticals Co., Ltd. for the development of envafolimab; I-Mab Biopharma for the development of CD73 antibody TJ004309; Janssen Pharmaceutica N.V. for the development of TRC253; Santen Pharmaceutical Co. Ltd. for the development of carotuximab products for ophthalmology indications; Roswell Park Cancer Institute and Health Research Inc.; Case Western Reserve University; and cooperative research and development agreement with National Cancer Institute. The company was formerly known as Lexington Pharmaceuticals, Inc. and changed its name to TRACON Pharmaceuticals, Inc. in March 2005. TRACON Pharmaceuticals, Inc. was founded in 2004 and is headquartered in San Diego, California."
TCPC,2016-12-31,NA,95937335,NA,76317159,27164942,148180765,121015823,121015823,-23903660,569511,148180765,27164942,0,-25078488,NA,95367824,76317159,NA,income_statement,Asset Management,BlackRock TCP Capital Corp.,"BlackRock TCP Capital Corp. is a business development company specializing in direct equity and debt investments in middle-market, senior secured loans, junior loans, originated loans, mezzanine, senior debt instruments, bonds, and secondary-market investments. It typically invests in communication services, public relations services, television, wireless telecommunication services, apparel, textile mills, restaurants, retailing, energy, oil and gas extraction, Patent owners and Lessors, Federal and Federally- Sponsored Credit agencies, insurance, hospital and healthcare centers, Biotechnology, engineering services, heavy electrical equipment, tax accounting, scientific and related consulting services, charter freight air transportation, Information technology consulting, application hosting services, software diagram and design, computer aided design, communication equipment, electronics manufacturing equipment, computer components, chemicals. It seeks to invest in the United States. The fund typically invests between $10 million and $35 million in companies with enterprise values between $100 million and $1500 million. It prefers to make equity investments in companies for an ownership stake."
TCPC,2017-12-31,NA,90647717,NA,67931014,29440357,175969500,146529143,146529143,-31516314,36380,175969500,29440357,0,-55881426,NA,90611337,67931014,NA,income_statement,Asset Management,BlackRock TCP Capital Corp.,"BlackRock TCP Capital Corp. is a business development company specializing in direct equity and debt investments in middle-market, senior secured loans, junior loans, originated loans, mezzanine, senior debt instruments, bonds, and secondary-market investments. It typically invests in communication services, public relations services, television, wireless telecommunication services, apparel, textile mills, restaurants, retailing, energy, oil and gas extraction, Patent owners and Lessors, Federal and Federally- Sponsored Credit agencies, insurance, hospital and healthcare centers, Biotechnology, engineering services, heavy electrical equipment, tax accounting, scientific and related consulting services, charter freight air transportation, Information technology consulting, application hosting services, software diagram and design, computer aided design, communication equipment, electronics manufacturing equipment, computer components, chemicals. It seeks to invest in the United States. The fund typically invests between $10 million and $35 million in companies with enterprise values between $100 million and $1500 million. It prefers to make equity investments in companies for an ownership stake."
TCPC,2018-12-31,NA,45568582,NA,45475882,56553068,190499184,133946116,133946116,-39470340,92700,190499184,56553068,0,-88377534,NA,45475882,45475882,NA,income_statement,Asset Management,BlackRock TCP Capital Corp.,"BlackRock TCP Capital Corp. is a business development company specializing in direct equity and debt investments in middle-market, senior secured loans, junior loans, originated loans, mezzanine, senior debt instruments, bonds, and secondary-market investments. It typically invests in communication services, public relations services, television, wireless telecommunication services, apparel, textile mills, restaurants, retailing, energy, oil and gas extraction, Patent owners and Lessors, Federal and Federally- Sponsored Credit agencies, insurance, hospital and healthcare centers, Biotechnology, engineering services, heavy electrical equipment, tax accounting, scientific and related consulting services, charter freight air transportation, Information technology consulting, application hosting services, software diagram and design, computer aided design, communication equipment, electronics manufacturing equipment, computer components, chemicals. It seeks to invest in the United States. The fund typically invests between $10 million and $35 million in companies with enterprise values between $100 million and $1500 million. It prefers to make equity investments in companies for an ownership stake."
TCPC,2019-12-31,NA,30580789,NA,30580789,53909027,195165915,141256888,141256888,-45301290,0,195165915,53909027,0,-110676099,NA,30580789,30580789,NA,income_statement,Asset Management,BlackRock TCP Capital Corp.,"BlackRock TCP Capital Corp. is a business development company specializing in direct equity and debt investments in middle-market, senior secured loans, junior loans, originated loans, mezzanine, senior debt instruments, bonds, and secondary-market investments. It typically invests in communication services, public relations services, television, wireless telecommunication services, apparel, textile mills, restaurants, retailing, energy, oil and gas extraction, Patent owners and Lessors, Federal and Federally- Sponsored Credit agencies, insurance, hospital and healthcare centers, Biotechnology, engineering services, heavy electrical equipment, tax accounting, scientific and related consulting services, charter freight air transportation, Information technology consulting, application hosting services, software diagram and design, computer aided design, communication equipment, electronics manufacturing equipment, computer components, chemicals. It seeks to invest in the United States. The fund typically invests between $10 million and $35 million in companies with enterprise values between $100 million and $1500 million. It prefers to make equity investments in companies for an ownership stake."
TCRR,2016-12-31,7670000,-9915000,NA,-9915000,2260000,0,-9930000,-9930000,NA,0,0,9930000,0,15000,NA,-9915000,-10702000,NA,income_statement,Biotechnology,TCR2 Therapeutics Inc.,"TCR2 Therapeutics Inc., a clinical-stage immunotherapy company, develops novel T cell receptor therapies for patients suffering from cancer. The company's lead product candidates include TC-210, mono TCR Fusion Construct T cells (TRuC-T cells) targeting mesothelin positive solid tumors, which initiated in phase I/II clinical trial for the treatment of non-small cell lung cancer (NSCLC), ovarian cancer, malignant pleural/peritoneal mesothelioma, and cholangiocarcinoma; and TC-110 a TRuC-T cell targeting CD19-positive B-Cell hematological malignancies. Its product candidates in pipeline focuses on adult acute lymphoblastic leukemia, diffuse large B-cell lymphoma, and follicular lymphoma areas. The company was formerly known as TCR2, Inc. and changed its name to TCR2 Therapeutics Inc. in November 2016. TCR2 Therapeutics Inc. was founded in 2015 and is headquartered in Cambridge, Massachusetts."
TCRR,2017-12-31,8147000,-13070000,NA,-13070000,5033000,0,-13180000,-13180000,NA,0,0,13180000,0,110000,NA,-13070000,-14864000,NA,income_statement,Biotechnology,TCR2 Therapeutics Inc.,"TCR2 Therapeutics Inc., a clinical-stage immunotherapy company, develops novel T cell receptor therapies for patients suffering from cancer. The company's lead product candidates include TC-210, mono TCR Fusion Construct T cells (TRuC-T cells) targeting mesothelin positive solid tumors, which initiated in phase I/II clinical trial for the treatment of non-small cell lung cancer (NSCLC), ovarian cancer, malignant pleural/peritoneal mesothelioma, and cholangiocarcinoma; and TC-110 a TRuC-T cell targeting CD19-positive B-Cell hematological malignancies. Its product candidates in pipeline focuses on adult acute lymphoblastic leukemia, diffuse large B-cell lymphoma, and follicular lymphoma areas. The company was formerly known as TCR2, Inc. and changed its name to TCR2 Therapeutics Inc. in November 2016. TCR2 Therapeutics Inc. was founded in 2015 and is headquartered in Cambridge, Massachusetts."
TCRR,2018-12-31,16977000,-24251000,NA,-24251000,9476000,0,-26453000,-26453000,NA,0,0,26453000,0,2202000,NA,-24251000,-61549000,NA,income_statement,Biotechnology,TCR2 Therapeutics Inc.,"TCR2 Therapeutics Inc., a clinical-stage immunotherapy company, develops novel T cell receptor therapies for patients suffering from cancer. The company's lead product candidates include TC-210, mono TCR Fusion Construct T cells (TRuC-T cells) targeting mesothelin positive solid tumors, which initiated in phase I/II clinical trial for the treatment of non-small cell lung cancer (NSCLC), ovarian cancer, malignant pleural/peritoneal mesothelioma, and cholangiocarcinoma; and TC-110 a TRuC-T cell targeting CD19-positive B-Cell hematological malignancies. Its product candidates in pipeline focuses on adult acute lymphoblastic leukemia, diffuse large B-cell lymphoma, and follicular lymphoma areas. The company was formerly known as TCR2, Inc. and changed its name to TCR2 Therapeutics Inc. in November 2016. TCR2 Therapeutics Inc. was founded in 2015 and is headquartered in Cambridge, Massachusetts."
TCRR,2019-12-31,33121000,-47497000,NA,-47599000,18261000,0,-51382000,-51382000,NA,102000,0,51382000,0,3885000,NA,-47599000,-97499000,NA,income_statement,Biotechnology,TCR2 Therapeutics Inc.,"TCR2 Therapeutics Inc., a clinical-stage immunotherapy company, develops novel T cell receptor therapies for patients suffering from cancer. The company's lead product candidates include TC-210, mono TCR Fusion Construct T cells (TRuC-T cells) targeting mesothelin positive solid tumors, which initiated in phase I/II clinical trial for the treatment of non-small cell lung cancer (NSCLC), ovarian cancer, malignant pleural/peritoneal mesothelioma, and cholangiocarcinoma; and TC-110 a TRuC-T cell targeting CD19-positive B-Cell hematological malignancies. Its product candidates in pipeline focuses on adult acute lymphoblastic leukemia, diffuse large B-cell lymphoma, and follicular lymphoma areas. The company was formerly known as TCR2, Inc. and changed its name to TCR2 Therapeutics Inc. in November 2016. TCR2 Therapeutics Inc. was founded in 2015 and is headquartered in Cambridge, Massachusetts."
TCX,2017-12-31,7258000,24075000,1136000,22327000,42717000,89497000,27395000,27395000,-3567000,1748000,329421000,302026000,239924000,-3320000,NA,22327000,22327000,NA,income_statement,Software—Infrastructure,Tucows Inc.,"Tucows Inc. provides network access, domain name registration, email, mobile telephony, and other Internet services in Canada, the United States, and Europe. It operates through two segments, Network Access Services and Domain Services. The Network Access Services segment offers mobile services under the Ting Mobile name, including the sale of retail telephony services, mobile phone hardware, and related accessories. It also provides roaming service to international travelers under the Zipsim and Always Online Wireless names; fixed high-speed Internet access services to consumer and business customers; network consulting services; and billing, provisioning, and customer care software solutions to Internet Service Providers (ISPs) through its Platypus billing software. This segment distributes its products and services through the Ting Website, as well as through third-party retail stores and online retailers. The Domain Services segment offers wholesale and retail domain name registration services; portfolio services; and value-added services, such as hosted email, Internet security services, Internet hosting, WHOIS privacy, publishing tools, and other value-added services for end-users under the OpenSRS, eNom, Ascio, and Hover brands. The company was formerly known as Infonautics, Inc. and changed its name to Tucows Inc. in August 2001. Tucows Inc. was incorporated in 1992 and is headquartered in Toronto, Canada."
TCX,2018-12-31,8748000,26155000,NA,17135000,50773000,104064000,29578000,29578000,-3687000,9020000,346013000,316435000,241949000,-3423000,NA,17135000,17135000,NA,income_statement,Software—Infrastructure,Tucows Inc.,"Tucows Inc. provides network access, domain name registration, email, mobile telephony, and other Internet services in Canada, the United States, and Europe. It operates through two segments, Network Access Services and Domain Services. The Network Access Services segment offers mobile services under the Ting Mobile name, including the sale of retail telephony services, mobile phone hardware, and related accessories. It also provides roaming service to international travelers under the Zipsim and Always Online Wireless names; fixed high-speed Internet access services to consumer and business customers; network consulting services; and billing, provisioning, and customer care software solutions to Internet Service Providers (ISPs) through its Platypus billing software. This segment distributes its products and services through the Ting Website, as well as through third-party retail stores and online retailers. The Domain Services segment offers wholesale and retail domain name registration services; portfolio services; and value-added services, such as hosted email, Internet security services, Internet hosting, WHOIS privacy, publishing tools, and other value-added services for end-users under the OpenSRS, eNom, Ascio, and Hover brands. The company was formerly known as Infonautics, Inc. and changed its name to Tucows Inc. in August 2001. Tucows Inc. was incorporated in 1992 and is headquartered in Toronto, Canada."
TCX,2019-12-31,9717000,24571000,NA,15398000,51850000,110376000,29515000,29515000,-4769000,9173000,337145000,307630000,226769000,-4944000,NA,15398000,15398000,NA,income_statement,Software—Infrastructure,Tucows Inc.,"Tucows Inc. provides network access, domain name registration, email, mobile telephony, and other Internet services in Canada, the United States, and Europe. It operates through two segments, Network Access Services and Domain Services. The Network Access Services segment offers mobile services under the Ting Mobile name, including the sale of retail telephony services, mobile phone hardware, and related accessories. It also provides roaming service to international travelers under the Zipsim and Always Online Wireless names; fixed high-speed Internet access services to consumer and business customers; network consulting services; and billing, provisioning, and customer care software solutions to Internet Service Providers (ISPs) through its Platypus billing software. This segment distributes its products and services through the Ting Website, as well as through third-party retail stores and online retailers. The Domain Services segment offers wholesale and retail domain name registration services; portfolio services; and value-added services, such as hosted email, Internet security services, Internet hosting, WHOIS privacy, publishing tools, and other value-added services for end-users under the OpenSRS, eNom, Ascio, and Hover brands. The company was formerly known as Infonautics, Inc. and changed its name to Tucows Inc. in August 2001. Tucows Inc. was incorporated in 1992 and is headquartered in Toronto, Canada."
TCX,2020-12-31,12427000,10760000,NA,5775000,54542000,100607000,9586000,9586000,-3611000,4985000,311202000,301616000,210595000,1174000,NA,5775000,5775000,NA,income_statement,Software—Infrastructure,Tucows Inc.,"Tucows Inc. provides network access, domain name registration, email, mobile telephony, and other Internet services in Canada, the United States, and Europe. It operates through two segments, Network Access Services and Domain Services. The Network Access Services segment offers mobile services under the Ting Mobile name, including the sale of retail telephony services, mobile phone hardware, and related accessories. It also provides roaming service to international travelers under the Zipsim and Always Online Wireless names; fixed high-speed Internet access services to consumer and business customers; network consulting services; and billing, provisioning, and customer care software solutions to Internet Service Providers (ISPs) through its Platypus billing software. This segment distributes its products and services through the Ting Website, as well as through third-party retail stores and online retailers. The Domain Services segment offers wholesale and retail domain name registration services; portfolio services; and value-added services, such as hosted email, Internet security services, Internet hosting, WHOIS privacy, publishing tools, and other value-added services for end-users under the OpenSRS, eNom, Ascio, and Hover brands. The company was formerly known as Infonautics, Inc. and changed its name to Tucows Inc. in August 2001. Tucows Inc. was incorporated in 1992 and is headquartered in Toronto, Canada."
TDAC,2016-12-31,NA,-2628,NA,-2628,2628,0,-2628,-2628,NA,0,0,2628,0,0,NA,-2628,-2628,NA,income_statement,Shell Companies,Trident Acquisitions Corp.,"Trident Acquisitions Corp. does not have significant operations. It intends to enter into a merger, share exchange, asset acquisition, stock purchase, recapitalization, reorganization or other similar business combination with one or more target businesses primarily in the oil and gas or other natural resource sector. The company was founded in 2016 and is headquartered in New York, New York."
TDAC,2017-12-31,NA,-387,NA,-387,387,0,-387,-387,NA,0,0,387,0,0,NA,-387,-387,NA,income_statement,Shell Companies,Trident Acquisitions Corp.,"Trident Acquisitions Corp. does not have significant operations. It intends to enter into a merger, share exchange, asset acquisition, stock purchase, recapitalization, reorganization or other similar business combination with one or more target businesses primarily in the oil and gas or other natural resource sector. The company was founded in 2016 and is headquartered in New York, New York."
TDAC,2018-12-31,NA,1778728,NA,1404083,699334,0,-699334,-699334,NA,374645,0,699334,0,2478062,NA,1404083,-476055,NA,income_statement,Shell Companies,Trident Acquisitions Corp.,"Trident Acquisitions Corp. does not have significant operations. It intends to enter into a merger, share exchange, asset acquisition, stock purchase, recapitalization, reorganization or other similar business combination with one or more target businesses primarily in the oil and gas or other natural resource sector. The company was founded in 2016 and is headquartered in New York, New York."
TDAC,2019-12-31,NA,3223922,NA,2533106,1100138,0,-1100138,-1100138,NA,690816,0,1100138,0,4324060,NA,2533106,-443675,NA,income_statement,Shell Companies,Trident Acquisitions Corp.,"Trident Acquisitions Corp. does not have significant operations. It intends to enter into a merger, share exchange, asset acquisition, stock purchase, recapitalization, reorganization or other similar business combination with one or more target businesses primarily in the oil and gas or other natural resource sector. The company was founded in 2016 and is headquartered in New York, New York."
TDG,2017-09-30,NA,837430000,10000000,596887000,414392000,2005248000,1501630000,1501630000,-602589000,208889000,3504286000,2002656000,1499038000,-664200000,-31654000,628541000,437630000,NA,income_statement,NA,NA,NA
TDG,2018-09-30,NA,986000000,10000000,957000000,450000000,2184000000,1662000000,1662000000,-663000000,24000000,3811000000,2149000000,1627000000,-676000000,-5000000,962000000,901000000,NA,income_statement,NA,NA,NA
TDG,2019-09-30,NA,1063000000,10000000,890000000,665000000,2899000000,2099000000,2099000000,-859000000,222000000,5223000000,3124000000,2324000000,-1036000000,51000000,841000000,779000000,NA,income_statement,NA,NA,NA
TDG,2020-09-30,NA,740000000,4000000,699000000,685000000,2694000000,1840000000,1840000000,-1029000000,87000000,5103000000,3263000000,2409000000,-1100000000,47000000,653000000,514000000,NA,income_statement,NA,NA,NA
TDY,2017-12-31,NA,287000000,NA,227200000,629800000,988300000,358500000,358500000,-33200000,59800000,2603800000,2245300000,1615500000,-71500000,NA,227200000,227200000,NA,income_statement,NA,NA,NA
TDY,2018-12-30,NA,393900000,NA,333800000,677800000,1115700000,437900000,437900000,-29200000,60100000,2901800000,2463900000,1786100000,-44000000,NA,333800000,333800000,NA,income_statement,NA,NA,NA
TDY,2019-12-29,NA,473700000,NA,402300000,741200000,1244100000,502900000,502900000,-22000000,71400000,3163600000,2660700000,1919500000,-29200000,NA,402300000,402300000,NA,income_statement,NA,NA,NA
TDY,2021-01-03,NA,469700000,NA,401900000,688700000,1180900000,492200000,492200000,-15300000,67800000,3086200000,2594000000,1905300000,-22500000,NA,401900000,401900000,NA,income_statement,NA,NA,NA
TEAM,2017-06-30,310169000,-52400000,NA,-37449000,253188000,507523000,-55834000,-55834000,-75000,-14951000,626684000,682518000,119161000,3434000,NA,-37449000,-37449000,NA,income_statement,Software—Application,Atlassian Corporation Plc,"Atlassian Corporation Plc, through its subsidiaries, designs, develops, licenses, and maintains various software products worldwide. It provides project tracking, content creation and sharing, and service management products. The company's products include JIRA, a workflow management system that enables teams to plan, organize, track, and manage their work and projects; Confluence, a content collaboration platform that is used to create, share, organize, and discuss projects; and Trello, a collaboration and organization product, which captures and adds structure to fluid fast-forming work for teams. Its products also comprise Bitbucket, a code management and collaboration product for teams using distributed version control systems; and Jira Service Desk, a service desk product for creating and managing service experiences for various service team providers, including IT, legal, and HR teams. In addition, the company offers Opsgenie, an incident management tool that enables IT teams to plan for and respond to service disruptions; Jira Align that enables enterprise organizations build and manage a master plan that maps strategic projects to the various work streams required to deliver them; and other tools comprising Atlassian Access, Bamboo, Crowd, Crucible, Fisheye, Jira Portfolio, Sourcetree, and Statuspage. Atlassian Corporation Plc was founded in 2002 and is headquartered in Sydney, Australia."
TEAM,2018-06-30,415776000,-58131000,NA,-113432000,338557000,708288000,-46045000,-46045000,-6806000,55301000,880978000,927023000,172690000,-12086000,NA,-113432000,-113432000,NA,income_statement,Software—Application,Atlassian Corporation Plc,"Atlassian Corporation Plc, through its subsidiaries, designs, develops, licenses, and maintains various software products worldwide. It provides project tracking, content creation and sharing, and service management products. The company's products include JIRA, a workflow management system that enables teams to plan, organize, track, and manage their work and projects; Confluence, a content collaboration platform that is used to create, share, organize, and discuss projects; and Trello, a collaboration and organization product, which captures and adds structure to fluid fast-forming work for teams. Its products also comprise Bitbucket, a code management and collaboration product for teams using distributed version control systems; and Jira Service Desk, a service desk product for creating and managing service experiences for various service team providers, including IT, legal, and HR teams. In addition, the company offers Opsgenie, an incident management tool that enables IT teams to plan for and respond to service disruptions; Jira Align that enables enterprise organizations build and manage a master plan that maps strategic projects to the various work streams required to deliver them; and other tools comprising Atlassian Access, Bamboo, Crowd, Crucible, Fisheye, Jira Portfolio, Sourcetree, and Statuspage. Atlassian Corporation Plc was founded in 2002 and is headquartered in Sydney, Australia."
TEAM,2019-06-30,579134000,-605556000,NA,-637621000,484070000,999842000,-63362000,-63362000,-40241000,32065000,1210127000,1273489000,210285000,-542194000,NA,-637621000,-637621000,NA,income_statement,Software—Application,Atlassian Corporation Plc,"Atlassian Corporation Plc, through its subsidiaries, designs, develops, licenses, and maintains various software products worldwide. It provides project tracking, content creation and sharing, and service management products. The company's products include JIRA, a workflow management system that enables teams to plan, organize, track, and manage their work and projects; Confluence, a content collaboration platform that is used to create, share, organize, and discuss projects; and Trello, a collaboration and organization product, which captures and adds structure to fluid fast-forming work for teams. Its products also comprise Bitbucket, a code management and collaboration product for teams using distributed version control systems; and Jira Service Desk, a service desk product for creating and managing service experiences for various service team providers, including IT, legal, and HR teams. In addition, the company offers Opsgenie, an incident management tool that enables IT teams to plan for and respond to service disruptions; Jira Align that enables enterprise organizations build and manage a master plan that maps strategic projects to the various work streams required to deliver them; and other tools comprising Atlassian Access, Bamboo, Crowd, Crucible, Fisheye, Jira Portfolio, Sourcetree, and Statuspage. Atlassian Corporation Plc was founded in 2002 and is headquartered in Sydney, Australia."
TEAM,2020-06-30,763188000,-346209000,NA,-350654000,568092000,1345366000,14086000,14086000,-49610000,4445000,1614173000,1600087000,268807000,-360295000,NA,-350654000,-350654000,NA,income_statement,Software—Application,Atlassian Corporation Plc,"Atlassian Corporation Plc, through its subsidiaries, designs, develops, licenses, and maintains various software products worldwide. It provides project tracking, content creation and sharing, and service management products. The company's products include JIRA, a workflow management system that enables teams to plan, organize, track, and manage their work and projects; Confluence, a content collaboration platform that is used to create, share, organize, and discuss projects; and Trello, a collaboration and organization product, which captures and adds structure to fluid fast-forming work for teams. Its products also comprise Bitbucket, a code management and collaboration product for teams using distributed version control systems; and Jira Service Desk, a service desk product for creating and managing service experiences for various service team providers, including IT, legal, and HR teams. In addition, the company offers Opsgenie, an incident management tool that enables IT teams to plan for and respond to service disruptions; Jira Align that enables enterprise organizations build and manage a master plan that maps strategic projects to the various work streams required to deliver them; and other tools comprising Atlassian Access, Bamboo, Crowd, Crucible, Fisheye, Jira Portfolio, Sourcetree, and Statuspage. Atlassian Corporation Plc was founded in 2002 and is headquartered in Sydney, Australia."
TECH,2017-06-30,53514000,111961000,NA,76086000,174654000,377578000,149410000,149410000,-7361000,35875000,563003000,413593000,185425000,-37449000,NA,76086000,76021000,NA,income_statement,Biotechnology,Bio-Techne Corp,"Bio-Techne Corporation, together with its subsidiaries, develops, manufactures, and sells life science reagents, instruments, and services for the research and clinical diagnostic markets worldwide. The company operates in two segments, Protein Sciences, and Diagnostics and Genomics. The Protein Sciences segment offers proteins and reagent solutions, including cytokines and growth factors, antibodies, immunoassays, biologically active small molecule compounds, tissue culture reagents, and T-Cell activation technologies. This segment also provides manual and automated protein analysis instruments and immunoassays for use in quantifying proteins in various biological fluids. The Diagnostics and Genomics segment develops and manufactures diagnostic products, including Food and Drug Administration -regulated controls, calibrators, blood gas and clinical chemistry controls, and other reagents for original equipment manufacturers and clinical customers, as well as a portfolio of clinical molecular diagnostic oncology assays comprising the ExoDx Prostate test for prostate cancer diagnosis. This segment also manufactures and sells tissue-based in-situ hybridization assays for research and clinical use. The company was formerly known as Techne Corporation and changed its name to Bio-Techne Corporation in November 2014. Bio-Techne Corporation was founded in 1976 and is headquartered in Minneapolis, Minnesota."
TECH,2018-06-30,55329000,125952000,NA,126150000,215831000,434598000,163438000,163438000,-10188000,-198000,642993000,479555000,208395000,-37486000,NA,126150000,126042000,NA,income_statement,Biotechnology,Bio-Techne Corp,"Bio-Techne Corporation, together with its subsidiaries, develops, manufactures, and sells life science reagents, instruments, and services for the research and clinical diagnostic markets worldwide. The company operates in two segments, Protein Sciences, and Diagnostics and Genomics. The Protein Sciences segment offers proteins and reagent solutions, including cytokines and growth factors, antibodies, immunoassays, biologically active small molecule compounds, tissue culture reagents, and T-Cell activation technologies. This segment also provides manual and automated protein analysis instruments and immunoassays for use in quantifying proteins in various biological fluids. The Diagnostics and Genomics segment develops and manufactures diagnostic products, including Food and Drug Administration -regulated controls, calibrators, blood gas and clinical chemistry controls, and other reagents for original equipment manufacturers and clinical customers, as well as a portfolio of clinical molecular diagnostic oncology assays comprising the ExoDx Prostate test for prostate cancer diagnosis. This segment also manufactures and sells tissue-based in-situ hybridization assays for research and clinical use. The company was formerly known as Techne Corporation and changed its name to Bio-Techne Corporation in November 2014. Bio-Techne Corporation was founded in 1976 and is headquartered in Minneapolis, Minnesota."
TECH,2019-06-30,62413000,112015000,NA,96072000,262077000,477230000,152740000,152740000,-21705000,15943000,714006000,561266000,236776000,-40725000,NA,96072000,95967000,NA,income_statement,Biotechnology,Bio-Techne Corp,"Bio-Techne Corporation, together with its subsidiaries, develops, manufactures, and sells life science reagents, instruments, and services for the research and clinical diagnostic markets worldwide. The company operates in two segments, Protein Sciences, and Diagnostics and Genomics. The Protein Sciences segment offers proteins and reagent solutions, including cytokines and growth factors, antibodies, immunoassays, biologically active small molecule compounds, tissue culture reagents, and T-Cell activation technologies. This segment also provides manual and automated protein analysis instruments and immunoassays for use in quantifying proteins in various biological fluids. The Diagnostics and Genomics segment develops and manufactures diagnostic products, including Food and Drug Administration -regulated controls, calibrators, blood gas and clinical chemistry controls, and other reagents for original equipment manufacturers and clinical customers, as well as a portfolio of clinical molecular diagnostic oncology assays comprising the ExoDx Prostate test for prostate cancer diagnosis. This segment also manufactures and sells tissue-based in-situ hybridization assays for research and clinical use. The company was formerly known as Techne Corporation and changed its name to Bio-Techne Corporation in November 2014. Bio-Techne Corporation was founded in 1976 and is headquartered in Minneapolis, Minnesota."
TECH,2020-06-30,65192000,276477000,NA,229296000,267240000,483194000,150762000,150762000,-19197000,47181000,738691000,587929000,255497000,125715000,NA,229296000,229072000,NA,income_statement,Biotechnology,Bio-Techne Corp,"Bio-Techne Corporation, together with its subsidiaries, develops, manufactures, and sells life science reagents, instruments, and services for the research and clinical diagnostic markets worldwide. The company operates in two segments, Protein Sciences, and Diagnostics and Genomics. The Protein Sciences segment offers proteins and reagent solutions, including cytokines and growth factors, antibodies, immunoassays, biologically active small molecule compounds, tissue culture reagents, and T-Cell activation technologies. This segment also provides manual and automated protein analysis instruments and immunoassays for use in quantifying proteins in various biological fluids. The Diagnostics and Genomics segment develops and manufactures diagnostic products, including Food and Drug Administration -regulated controls, calibrators, blood gas and clinical chemistry controls, and other reagents for original equipment manufacturers and clinical customers, as well as a portfolio of clinical molecular diagnostic oncology assays comprising the ExoDx Prostate test for prostate cancer diagnosis. This segment also manufactures and sells tissue-based in-situ hybridization assays for research and clinical use. The company was formerly known as Techne Corporation and changed its name to Bio-Techne Corporation in November 2014. Bio-Techne Corporation was founded in 1976 and is headquartered in Minneapolis, Minnesota."
TECTP,2016-12-31,NA,6180000,NA,3981000,7628400,22223000,0,6180000,NA,2199000,22223000,16043000,0,0,NA,3981000,3981000,8414600,income_statement,Banks—Regional,"Tectonic Financial, Inc. - 9.00","Tectonic Financial, Inc., a financial holding company, offers banking, trust, investment advisory, securities brokerage, and insurance services to high net worth individuals, small businesses, and institutions in the United States. Tectonic Financial, Inc. was formerly known as T Acquisition, Inc. and changed its name to Tectonic Financial, Inc. in May 2019. The company was founded in 2016 and is based in Dallas, Texas."
TECTP,2017-12-31,NA,3530000,NA,2932000,9434000,20637000,0,3962000,NA,598000,20637000,16675000,0,-432000,NA,2932000,2932000,7241000,income_statement,Banks—Regional,"Tectonic Financial, Inc. - 9.00","Tectonic Financial, Inc., a financial holding company, offers banking, trust, investment advisory, securities brokerage, and insurance services to high net worth individuals, small businesses, and institutions in the United States. Tectonic Financial, Inc. was formerly known as T Acquisition, Inc. and changed its name to Tectonic Financial, Inc. in May 2019. The company was founded in 2016 and is based in Dallas, Texas."
TECTP,2018-12-31,NA,10631000,NA,9620000,18456000,35137000,0,10631000,NA,1011000,35137000,24506000,0,0,NA,9620000,8818000,6050000,income_statement,Banks—Regional,"Tectonic Financial, Inc. - 9.00","Tectonic Financial, Inc., a financial holding company, offers banking, trust, investment advisory, securities brokerage, and insurance services to high net worth individuals, small businesses, and institutions in the United States. Tectonic Financial, Inc. was formerly known as T Acquisition, Inc. and changed its name to Tectonic Financial, Inc. in May 2019. The company was founded in 2016 and is based in Dallas, Texas."
TECTP,2019-12-31,NA,9781000,NA,7879000,23854000,40300000,0,9801000,NA,1902000,40300000,30499000,0,-20000,NA,7879000,6458000,6645000,income_statement,Banks—Regional,"Tectonic Financial, Inc. - 9.00","Tectonic Financial, Inc., a financial holding company, offers banking, trust, investment advisory, securities brokerage, and insurance services to high net worth individuals, small businesses, and institutions in the United States. Tectonic Financial, Inc. was formerly known as T Acquisition, Inc. and changed its name to Tectonic Financial, Inc. in May 2019. The company was founded in 2016 and is based in Dallas, Texas."
TEL,2017-09-29,611000000,1720000000,112000000,1683000000,1577000000,4183000000,1994000000,1994000000,-130000000,180000000,12185000000,10191000000,8002000000,-274000000,143000000,1540000000,1683000000,1000000,income_statement,NA,NA,NA
TEL,2018-09-28,680000000,2240000000,112000000,2565000000,1591000000,4745000000,2486000000,2486000000,-107000000,-344000000,13988000000,11502000000,9243000000,-246000000,-19000000,2584000000,2565000000,-12000000,income_statement,NA,NA,NA
TEL,2019-09-27,644000000,1931000000,112000000,1844000000,1489000000,4394000000,2261000000,2261000000,-68000000,-15000000,13448000000,11187000000,9054000000,-330000000,-102000000,1946000000,1844000000,NA,income_statement,NA,NA,NA
TEL,2020-09-25,613000000,524000000,112000000,-241000000,1377000000,3735000000,1745000000,1745000000,-48000000,783000000,12172000000,10427000000,8437000000,-1221000000,18000000,-259000000,-241000000,NA,income_statement,NA,NA,NA
TELA,2017-12-31,5786000,-21334000,NA,-21334000,13670000,2532000,-16924000,-16924000,-4558000,0,4245000,21169000,1713000,-4410000,NA,-21334000,-27227000,NA,income_statement,Medical Devices,"TELA Bio, Inc.","TELA Bio, Inc., a medical technology company, focuses on the design, development, and marketing of tissue reinforcement materials to address unmet needs in soft tissue reconstruction. The company provides a portfolio of OviTex Reinforced Tissue Matrix (OviTex) products for hernia repair and abdominal wall reconstruction; and OviTex PRS Reinforced Tissue Matrix products to address the unmet needs in plastic and reconstructive surgery, as well as OviTex for Laparoscopic and Robotic Procedures, a sterile reinforced tissue matrix derived from ovine rumen with polypropylene fiber intended to be used in laparoscopic and robotic-assisted hernia surgical repairs. It markets its products through a single direct sales force, principally in the United States. The company was founded in 2012 and is headquartered in Malvern, Pennsylvania."
TELA,2018-12-31,4339000,-21092000,NA,-21092000,18545000,3727000,-19942000,-19942000,-1802000,0,8274000,28216000,4547000,-1150000,NA,-21092000,-29915000,NA,income_statement,Medical Devices,"TELA Bio, Inc.","TELA Bio, Inc., a medical technology company, focuses on the design, development, and marketing of tissue reinforcement materials to address unmet needs in soft tissue reconstruction. The company provides a portfolio of OviTex Reinforced Tissue Matrix (OviTex) products for hernia repair and abdominal wall reconstruction; and OviTex PRS Reinforced Tissue Matrix products to address the unmet needs in plastic and reconstructive surgery, as well as OviTex for Laparoscopic and Robotic Procedures, a sterile reinforced tissue matrix derived from ovine rumen with polypropylene fiber intended to be used in laparoscopic and robotic-assisted hernia surgical repairs. It markets its products through a single direct sales force, principally in the United States. The company was founded in 2012 and is headquartered in Malvern, Pennsylvania."
TELA,2019-12-31,4151000,-22425000,NA,-22425000,24283000,9576000,-19162000,-19162000,-3609000,0,15446000,34608000,5870000,-3263000,NA,-22425000,-30208000,NA,income_statement,Medical Devices,"TELA Bio, Inc.","TELA Bio, Inc., a medical technology company, focuses on the design, development, and marketing of tissue reinforcement materials to address unmet needs in soft tissue reconstruction. The company provides a portfolio of OviTex Reinforced Tissue Matrix (OviTex) products for hernia repair and abdominal wall reconstruction; and OviTex PRS Reinforced Tissue Matrix products to address the unmet needs in plastic and reconstructive surgery, as well as OviTex for Laparoscopic and Robotic Procedures, a sterile reinforced tissue matrix derived from ovine rumen with polypropylene fiber intended to be used in laparoscopic and robotic-assisted hernia surgical repairs. It markets its products through a single direct sales force, principally in the United States. The company was founded in 2012 and is headquartered in Malvern, Pennsylvania."
TENB,2017-12-31,57673000,-40851000,NA,-41022000,145226000,162139000,-40760000,-40760000,-75000,171000,187727000,228487000,25588000,-91000,NA,-41022000,-41785000,NA,income_statement,Software—Infrastructure,"Tenable Holdings, Inc.","Tenable Holdings, Inc. provides cybersecurity solutions in the Americas, Europe, the Middle East, Africa, and the Asia Pacific. The company enterprise software platform enables visibility into an organization's cyber exposure across the attack surface and deep insights that help organizations translate vulnerability data into business insights to understand and reduce their cybersecurity risk. It offers Tenable.io, a software as a service that manages and measures cyber exposure across a range of traditional information technology (IT) assets, such as networking infrastructure, desktops, and on-premises servers, as well as modern IT assets, such as cloud workloads, containers, Web applications, and Internet of Things and operational technology assets; and Tenable.sc, a solution to manage and measure cyber exposure across traditional information technology assets and can be run on-premises. The company was founded in 2002 and is headquartered in Columbia, Maryland."
TENB,2018-12-31,76698000,-71157000,NA,-73521000,220076000,224193000,-72581000,-72581000,NA,2364000,267360000,339941000,43167000,1424000,NA,-73521000,-73955000,NA,income_statement,Software—Infrastructure,"Tenable Holdings, Inc.","Tenable Holdings, Inc. provides cybersecurity solutions in the Americas, Europe, the Middle East, Africa, and the Asia Pacific. The company enterprise software platform enables visibility into an organization's cyber exposure across the attack surface and deep insights that help organizations translate vulnerability data into business insights to understand and reduce their cybersecurity risk. It offers Tenable.io, a software as a service that manages and measures cyber exposure across a range of traditional information technology (IT) assets, such as networking infrastructure, desktops, and on-premises servers, as well as modern IT assets, such as cloud workloads, containers, Web applications, and Internet of Things and operational technology assets; and Tenable.sc, a solution to manage and measure cyber exposure across traditional information technology assets and can be run on-premises. The company was founded in 2002 and is headquartered in Columbia, Maryland."
TENB,2019-12-31,87064000,-85649000,NA,-99013000,297503000,293768000,-90799000,-90799000,NA,13364000,354586000,445385000,60818000,1180000,NA,-99013000,-99013000,NA,income_statement,Software—Infrastructure,"Tenable Holdings, Inc.","Tenable Holdings, Inc. provides cybersecurity solutions in the Americas, Europe, the Middle East, Africa, and the Asia Pacific. The company enterprise software platform enables visibility into an organization's cyber exposure across the attack surface and deep insights that help organizations translate vulnerability data into business insights to understand and reduce their cybersecurity risk. It offers Tenable.io, a software as a service that manages and measures cyber exposure across a range of traditional information technology (IT) assets, such as networking infrastructure, desktops, and on-premises servers, as well as modern IT assets, such as cloud workloads, containers, Web applications, and Internet of Things and operational technology assets; and Tenable.sc, a solution to manage and measure cyber exposure across traditional information technology assets and can be run on-premises. The company was founded in 2002 and is headquartered in Columbia, Maryland."
TENB,2020-12-31,101687000,-37074000,NA,-42731000,297074000,362667000,-36094000,-36094000,NA,5657000,440221000,476315000,77554000,-980000,NA,-42731000,-42731000,NA,income_statement,Software—Infrastructure,"Tenable Holdings, Inc.","Tenable Holdings, Inc. provides cybersecurity solutions in the Americas, Europe, the Middle East, Africa, and the Asia Pacific. The company enterprise software platform enables visibility into an organization's cyber exposure across the attack surface and deep insights that help organizations translate vulnerability data into business insights to understand and reduce their cybersecurity risk. It offers Tenable.io, a software as a service that manages and measures cyber exposure across a range of traditional information technology (IT) assets, such as networking infrastructure, desktops, and on-premises servers, as well as modern IT assets, such as cloud workloads, containers, Web applications, and Internet of Things and operational technology assets; and Tenable.sc, a solution to manage and measure cyber exposure across traditional information technology assets and can be run on-premises. The company was founded in 2002 and is headquartered in Columbia, Maryland."
TENX,2016-12-31,12983681,-51886004,NA,-43923904,6245958,0,-19229639,-19229639,NA,-7962100,0,19229639,0,-32656365,NA,-43923904,-43923904,NA,income_statement,Biotechnology,"Tenax Therapeutics, Inc.","Tenax Therapeutics, Inc., a specialty pharmaceutical company, focuses on identifying, developing, and commercializing products for cardiovascular and pulmonary diseases in the United States and Canada. The company focuses on the development and commercialization of pharmaceutical products containing levosimendan, 2.5 mg/ml concentrate for solution for infusion/5ml vial for use in the reduction of morbidity and mortality in cardiac surgery patients at risk for developing low cardiac output syndrome. It is also involved in initiating a Phase 2 clinical trial of levosimendan for the treatment of patients with pulmonary hypertension associated with heart failure with preserved ejection fraction. The company was formerly known as Oxygen Biotherapeutics, Inc. and changed its name to Tenax Therapeutics, Inc. in September 2014. Tenax Therapeutics, Inc. was founded in 1967 and is headquartered in Morrisville, North Carolina."
TENX,2017-12-31,3527317,-8839682,NA,-8839682,5678581,0,-9205898,-9205898,NA,0,0,9205898,0,366216,NA,-8839682,-8839682,NA,income_statement,Biotechnology,"Tenax Therapeutics, Inc.","Tenax Therapeutics, Inc., a specialty pharmaceutical company, focuses on identifying, developing, and commercializing products for cardiovascular and pulmonary diseases in the United States and Canada. The company focuses on the development and commercialization of pharmaceutical products containing levosimendan, 2.5 mg/ml concentrate for solution for infusion/5ml vial for use in the reduction of morbidity and mortality in cardiac surgery patients at risk for developing low cardiac output syndrome. It is also involved in initiating a Phase 2 clinical trial of levosimendan for the treatment of patients with pulmonary hypertension associated with heart failure with preserved ejection fraction. The company was formerly known as Oxygen Biotherapeutics, Inc. and changed its name to Tenax Therapeutics, Inc. in September 2014. Tenax Therapeutics, Inc. was founded in 1967 and is headquartered in Morrisville, North Carolina."
TENX,2018-12-31,1239300,-6813445,NA,-6813445,5653980,0,-6893280,-6893280,NA,0,0,6893280,0,79835,NA,-6813445,-14144049,NA,income_statement,Biotechnology,"Tenax Therapeutics, Inc.","Tenax Therapeutics, Inc., a specialty pharmaceutical company, focuses on identifying, developing, and commercializing products for cardiovascular and pulmonary diseases in the United States and Canada. The company focuses on the development and commercialization of pharmaceutical products containing levosimendan, 2.5 mg/ml concentrate for solution for infusion/5ml vial for use in the reduction of morbidity and mortality in cardiac surgery patients at risk for developing low cardiac output syndrome. It is also involved in initiating a Phase 2 clinical trial of levosimendan for the treatment of patients with pulmonary hypertension associated with heart failure with preserved ejection fraction. The company was formerly known as Oxygen Biotherapeutics, Inc. and changed its name to Tenax Therapeutics, Inc. in September 2014. Tenax Therapeutics, Inc. was founded in 1967 and is headquartered in Morrisville, North Carolina."
TENX,2019-12-31,3471153,-8394363,NA,-8394363,5084111,0,-8555264,-8555264,NA,0,0,8555264,0,160901,NA,-8394363,-8394363,NA,income_statement,Biotechnology,"Tenax Therapeutics, Inc.","Tenax Therapeutics, Inc., a specialty pharmaceutical company, focuses on identifying, developing, and commercializing products for cardiovascular and pulmonary diseases in the United States and Canada. The company focuses on the development and commercialization of pharmaceutical products containing levosimendan, 2.5 mg/ml concentrate for solution for infusion/5ml vial for use in the reduction of morbidity and mortality in cardiac surgery patients at risk for developing low cardiac output syndrome. It is also involved in initiating a Phase 2 clinical trial of levosimendan for the treatment of patients with pulmonary hypertension associated with heart failure with preserved ejection fraction. The company was formerly known as Oxygen Biotherapeutics, Inc. and changed its name to Tenax Therapeutics, Inc. in September 2014. Tenax Therapeutics, Inc. was founded in 1967 and is headquartered in Morrisville, North Carolina."
TER,2017-12-31,307305000,524412000,NA,257692000,343791000,1221453000,539917000,539917000,-21663000,266720000,2136606000,1596689000,915153000,-15505000,NA,257692000,257692000,-90000,income_statement,NA,NA,NA
TER,2018-12-31,301505000,467801000,NA,451779000,387945000,1220394000,490793000,490793000,-31269000,16022000,2100802000,1610009000,880408000,-22992000,NA,451779000,451779000,960000,income_statement,NA,NA,NA
TER,2019-12-31,322824000,525772000,NA,467468000,446351000,1339829000,529743000,529743000,-23145000,58304000,2294965000,1765222000,955136000,-3971000,NA,467468000,467468000,764000,income_statement,NA,NA,NA
TER,2020-12-31,374964000,901015000,NA,784147000,475053000,1786117000,904053000,904053000,-14426000,116868000,3121469000,2217416000,1335352000,-3038000,NA,784147000,784147000,1244000,income_statement,NA,NA,NA
TERN,2018-12-31,14554000,-18085000,14325000,-17711000,3901000,0,-18455000,-18455000,NA,-67000,0,18455000,0,370000,NA,-18018000,-17711000,NA,income_statement,Biotechnology,"Terns Pharmaceuticals, Inc.","Terns Pharmaceuticals, Inc., a clinical-stage biopharmaceutical company, develops small-molecule single-agent and combination therapy candidates for the treatment of non-alcoholic steatohepatitis (NASH) and other chronic liver diseases. It develops TERN-101, a liver-distributed and non-bile acid farnesoid X receptor agonist, which is in Phase 2a clinical trial for the treatment of NASH; and TERN-201, a vascular adhesion protein-1 inhibitor that is in Phase 1 clinical trial for the treatment of NASH. The company also develops TERN-501, a thyroid hormone receptor beta agonist with enhanced liver distribution and metabolic stability; and GLP-1R, a small-molecule Glucagon-Like Peptide-1 receptor agonist program that is intended to address metabolic processes involved in the pathogenesis of NASH. Terns Pharmaceuticals, Inc. was founded in 2016 and is headquartered in Foster City, California."
TERN,2019-12-31,26534000,-68839000,14117000,-68611000,8663000,0,-35197000,-35197000,NA,-20000,0,35197000,0,-33642000,NA,-68819000,-68611000,NA,income_statement,Biotechnology,"Terns Pharmaceuticals, Inc.","Terns Pharmaceuticals, Inc., a clinical-stage biopharmaceutical company, develops small-molecule single-agent and combination therapy candidates for the treatment of non-alcoholic steatohepatitis (NASH) and other chronic liver diseases. It develops TERN-101, a liver-distributed and non-bile acid farnesoid X receptor agonist, which is in Phase 2a clinical trial for the treatment of NASH; and TERN-201, a vascular adhesion protein-1 inhibitor that is in Phase 1 clinical trial for the treatment of NASH. The company also develops TERN-501, a thyroid hormone receptor beta agonist with enhanced liver distribution and metabolic stability; and GLP-1R, a small-molecule Glucagon-Like Peptide-1 receptor agonist program that is intended to address metabolic processes involved in the pathogenesis of NASH. Terns Pharmaceuticals, Inc. was founded in 2016 and is headquartered in Foster City, California."
TESS,2017-03-26,NA,2486300,NA,1445100,107742100,111767800,3351500,3351500,-58600,1041200,533295100,529943600,421527300,-865200,NA,1445100,1445100,NA,income_statement,Communication Equipment,TESSCO Technologies Incorporate,"TESSCO Technologies Incorporated architects and delivers product and value chain solutions to support wireless systems in the United States. The company offers base station infrastructure products, including base station antennas, cable and transmission lines, small towers, lightning protection devices, connectors, power systems, enclosures, grounding products, jumpers, miscellaneous hardware products, and mobile antennas to build, repair, and upgrade wireless broadband systems, as well as connector installation, custom jumper assembly, site kitting, and logistics integration services. It also provides network systems products, such as fixed and mobile broadband radio equipment, wireless networking filtering and distributed antenna systems, two-way radios, and security and surveillance products, as well as training classes, technical support, and engineering design services. In addition, the company offers installation, test, and maintenance products comprising analysis equipment; and various frequency, voltage, and power-measuring devices, as well as tools, hardware, GPS and safety products, and replacement and component parts and supplies to install, tune, and maintain wireless communications equipment. Further, it provides mobile devices, such as cellular and smart phones; and data device accessories, including power supplies, cases, screen protectors, speakers, mobile amplifiers, bluetooth and corded headsets, mounts, car antennas, music accessories, and data and memory cards. The company sells its products to carrier and public network operators, tower owners, program managers, contractors and integrators, private system operators, federal governments, state and local governments, manufacturers, value-added resellers, retail carrier stores and their independent agents, and other retailers under the Ventev brand. TESSCO Technologies Incorporated was founded in 1982 and is headquartered in Hunt Valley, Maryland."
TESS,2018-04-01,NA,7472600,NA,5195400,111529600,120228400,7901700,7901700,-429100,2277200,580274700,572373000,460046300,-429100,NA,5195400,5195400,NA,income_statement,Communication Equipment,TESSCO Technologies Incorporate,"TESSCO Technologies Incorporated architects and delivers product and value chain solutions to support wireless systems in the United States. The company offers base station infrastructure products, including base station antennas, cable and transmission lines, small towers, lightning protection devices, connectors, power systems, enclosures, grounding products, jumpers, miscellaneous hardware products, and mobile antennas to build, repair, and upgrade wireless broadband systems, as well as connector installation, custom jumper assembly, site kitting, and logistics integration services. It also provides network systems products, such as fixed and mobile broadband radio equipment, wireless networking filtering and distributed antenna systems, two-way radios, and security and surveillance products, as well as training classes, technical support, and engineering design services. In addition, the company offers installation, test, and maintenance products comprising analysis equipment; and various frequency, voltage, and power-measuring devices, as well as tools, hardware, GPS and safety products, and replacement and component parts and supplies to install, tune, and maintain wireless communications equipment. Further, it provides mobile devices, such as cellular and smart phones; and data device accessories, including power supplies, cases, screen protectors, speakers, mobile amplifiers, bluetooth and corded headsets, mounts, car antennas, music accessories, and data and memory cards. The company sells its products to carrier and public network operators, tower owners, program managers, contractors and integrators, private system operators, federal governments, state and local governments, manufacturers, value-added resellers, retail carrier stores and their independent agents, and other retailers under the Ventev brand. TESSCO Technologies Incorporated was founded in 1982 and is headquartered in Hunt Valley, Maryland."
TESS,2019-03-31,NA,7291200,NA,5545800,111492500,121358700,8145000,8145000,-853800,1745400,606813800,598668800,485455100,-853800,NA,5545800,5545800,NA,income_statement,Communication Equipment,TESSCO Technologies Incorporate,"TESSCO Technologies Incorporated architects and delivers product and value chain solutions to support wireless systems in the United States. The company offers base station infrastructure products, including base station antennas, cable and transmission lines, small towers, lightning protection devices, connectors, power systems, enclosures, grounding products, jumpers, miscellaneous hardware products, and mobile antennas to build, repair, and upgrade wireless broadband systems, as well as connector installation, custom jumper assembly, site kitting, and logistics integration services. It also provides network systems products, such as fixed and mobile broadband radio equipment, wireless networking filtering and distributed antenna systems, two-way radios, and security and surveillance products, as well as training classes, technical support, and engineering design services. In addition, the company offers installation, test, and maintenance products comprising analysis equipment; and various frequency, voltage, and power-measuring devices, as well as tools, hardware, GPS and safety products, and replacement and component parts and supplies to install, tune, and maintain wireless communications equipment. Further, it provides mobile devices, such as cellular and smart phones; and data device accessories, including power supplies, cases, screen protectors, speakers, mobile amplifiers, bluetooth and corded headsets, mounts, car antennas, music accessories, and data and memory cards. The company sells its products to carrier and public network operators, tower owners, program managers, contractors and integrators, private system operators, federal governments, state and local governments, manufacturers, value-added resellers, retail carrier stores and their independent agents, and other retailers under the Ventev brand. TESSCO Technologies Incorporated was founded in 1982 and is headquartered in Hunt Valley, Maryland."
TESS,2020-03-29,NA,-29273700,NA,-21568900,105714700,91823000,-15991700,-15991700,-1116300,-7704800,540298300,556290000,448475300,-13282000,NA,-21568900,-21568900,NA,income_statement,Communication Equipment,TESSCO Technologies Incorporate,"TESSCO Technologies Incorporated architects and delivers product and value chain solutions to support wireless systems in the United States. The company offers base station infrastructure products, including base station antennas, cable and transmission lines, small towers, lightning protection devices, connectors, power systems, enclosures, grounding products, jumpers, miscellaneous hardware products, and mobile antennas to build, repair, and upgrade wireless broadband systems, as well as connector installation, custom jumper assembly, site kitting, and logistics integration services. It also provides network systems products, such as fixed and mobile broadband radio equipment, wireless networking filtering and distributed antenna systems, two-way radios, and security and surveillance products, as well as training classes, technical support, and engineering design services. In addition, the company offers installation, test, and maintenance products comprising analysis equipment; and various frequency, voltage, and power-measuring devices, as well as tools, hardware, GPS and safety products, and replacement and component parts and supplies to install, tune, and maintain wireless communications equipment. Further, it provides mobile devices, such as cellular and smart phones; and data device accessories, including power supplies, cases, screen protectors, speakers, mobile amplifiers, bluetooth and corded headsets, mounts, car antennas, music accessories, and data and memory cards. The company sells its products to carrier and public network operators, tower owners, program managers, contractors and integrators, private system operators, federal governments, state and local governments, manufacturers, value-added resellers, retail carrier stores and their independent agents, and other retailers under the Ventev brand. TESSCO Technologies Incorporated was founded in 1982 and is headquartered in Hunt Valley, Maryland."
TFC,2017-12-31,NA,3326000000,47000000,2394000000,5835000000,10770000000,0,4128000000,NA,911000000,10770000000,6642000000,0,-802000000,NA,2415000000,2220000000,807000000,income_statement,NA,NA,NA
TFC,2018-12-31,NA,4060000000,56000000,3237000000,5930000000,10992000000,0,4471000000,NA,803000000,10992000000,6521000000,0,-411000000,NA,3257000000,3063000000,591000000,income_statement,NA,NA,NA
TFC,2019-12-31,NA,4019000000,174000000,3224000000,6664000000,11953000000,0,4624000000,NA,782000000,11953000000,7329000000,0,-605000000,NA,3237000000,3028000000,665000000,income_statement,NA,NA,NA
TFC,2020-12-31,NA,5473000000,105000000,4482000000,12179000000,20370000000,0,7378000000,NA,981000000,20370000000,12992000000,0,-1905000000,NA,4492000000,4184000000,813000000,income_statement,NA,NA,NA
TFFP,2016-12-31,229259,-370370,NA,-370370,141111,0,-370370,-370370,NA,0,0,370370,0,0,NA,-370370,-370370,NA,income_statement,Biotechnology,"TFF Pharmaceuticals, Inc.","TFF Pharmaceuticals, Inc., an early-stage biopharmaceutical company, focuses on developing and commercializing drug products based on its patented Thin Film Freezing, or TFF, technology platform. It intends to initially focus on the development of inhaled dry powder drugs for the treatment of pulmonary diseases and conditions. The company has a research collaboration with the University of Georgia's Center for Vaccines and Immunology (CVI), along with the University of Texas at Austin (UT Austin), to evaluate the immunogenicity of universal influenza vaccines; and cooperative research and development agreement with United States Army Medical Research Institute of Infectious Diseases for use of its thin film freezing technology platform. TFF Pharmaceuticals, Inc. also has a joint development and collaboration agreement with Augmenta Bioworks, Inc. to develop commercial products incorporating Augmenta's human-derived monoclonal antibodies for COVID-19 therapeutics. The company was founded in 2018 and is based in Austin, Texas."
TFFP,2017-12-31,848809,-178605,NA,-178605,178605,0,-178605,-178605,NA,0,0,178605,0,0,NA,-178605,-178605,NA,income_statement,Biotechnology,"TFF Pharmaceuticals, Inc.","TFF Pharmaceuticals, Inc., an early-stage biopharmaceutical company, focuses on developing and commercializing drug products based on its patented Thin Film Freezing, or TFF, technology platform. It intends to initially focus on the development of inhaled dry powder drugs for the treatment of pulmonary diseases and conditions. The company has a research collaboration with the University of Georgia's Center for Vaccines and Immunology (CVI), along with the University of Texas at Austin (UT Austin), to evaluate the immunogenicity of universal influenza vaccines; and cooperative research and development agreement with United States Army Medical Research Institute of Infectious Diseases for use of its thin film freezing technology platform. TFF Pharmaceuticals, Inc. also has a joint development and collaboration agreement with Augmenta Bioworks, Inc. to develop commercial products incorporating Augmenta's human-derived monoclonal antibodies for COVID-19 therapeutics. The company was founded in 2018 and is based in Austin, Texas."
TFFP,2018-12-31,848809,-3842186,NA,-3842186,3049337,0,-3898146,-3898146,NA,0,0,3898146,0,55960,NA,-3842186,-4570536,NA,income_statement,Biotechnology,"TFF Pharmaceuticals, Inc.","TFF Pharmaceuticals, Inc., an early-stage biopharmaceutical company, focuses on developing and commercializing drug products based on its patented Thin Film Freezing, or TFF, technology platform. It intends to initially focus on the development of inhaled dry powder drugs for the treatment of pulmonary diseases and conditions. The company has a research collaboration with the University of Georgia's Center for Vaccines and Immunology (CVI), along with the University of Texas at Austin (UT Austin), to evaluate the immunogenicity of universal influenza vaccines; and cooperative research and development agreement with United States Army Medical Research Institute of Infectious Diseases for use of its thin film freezing technology platform. TFF Pharmaceuticals, Inc. also has a joint development and collaboration agreement with Augmenta Bioworks, Inc. to develop commercial products incorporating Augmenta's human-derived monoclonal antibodies for COVID-19 therapeutics. The company was founded in 2018 and is based in Austin, Texas."
TFFP,2019-12-31,8822226,-11870228,NA,-11870228,3165331,0,-11987557,-11987557,NA,0,0,11987557,0,117329,NA,-11870228,-36675338,NA,income_statement,Biotechnology,"TFF Pharmaceuticals, Inc.","TFF Pharmaceuticals, Inc., an early-stage biopharmaceutical company, focuses on developing and commercializing drug products based on its patented Thin Film Freezing, or TFF, technology platform. It intends to initially focus on the development of inhaled dry powder drugs for the treatment of pulmonary diseases and conditions. The company has a research collaboration with the University of Georgia's Center for Vaccines and Immunology (CVI), along with the University of Texas at Austin (UT Austin), to evaluate the immunogenicity of universal influenza vaccines; and cooperative research and development agreement with United States Army Medical Research Institute of Infectious Diseases for use of its thin film freezing technology platform. TFF Pharmaceuticals, Inc. also has a joint development and collaboration agreement with Augmenta Bioworks, Inc. to develop commercial products incorporating Augmenta's human-derived monoclonal antibodies for COVID-19 therapeutics. The company was founded in 2018 and is based in Austin, Texas."
TFSL,2017-09-30,NA,133341000,NA,88877000,138866000,315745000,0,143396000,NA,44464000,315745000,172349000,0,-10055000,NA,88877000,87976000,33483000,income_statement,Banks—Regional,TFS Financial Corporation,"TFS Financial Corporation, through its subsidiaries, provides retail consumer banking services in the United States. Its deposit products include savings, money market, checking, individual retirement, and other qualified plan accounts, as well as certificates of deposit. The company also provides residential real estate mortgage loans, residential construction loans, and home equity loans and lines of credit, as well as purchase mortgages and first mortgage refinance loans. In addition, it offers escrow and settlement services. The company provides its products and services through its main office in Cleveland, Ohio; and 37 full-service branches and 7 loan production offices located throughout the states of Ohio and Florida. The company was founded in 1938 and is headquartered in Cleveland, Ohio. TFS Financial Corporation is a subsidiary of Third Federal Savings and Loan Association of Cleveland, MHC."
TFSL,2018-09-30,NA,121164000,NA,85407000,147465000,313477000,0,132353000,NA,35757000,313477000,181124000,0,-11189000,NA,85407000,84196000,33659000,income_statement,Banks—Regional,TFS Financial Corporation,"TFS Financial Corporation, through its subsidiaries, provides retail consumer banking services in the United States. Its deposit products include savings, money market, checking, individual retirement, and other qualified plan accounts, as well as certificates of deposit. The company also provides residential real estate mortgage loans, residential construction loans, and home equity loans and lines of credit, as well as purchase mortgages and first mortgage refinance loans. In addition, it offers escrow and settlement services. The company provides its products and services through its main office in Cleveland, Ohio; and 37 full-service branches and 7 loan production offices located throughout the states of Ohio and Florida. The company was founded in 1938 and is headquartered in Cleveland, Ohio. TFS Financial Corporation is a subsidiary of Third Federal Savings and Loan Association of Cleveland, MHC."
TFSL,2019-09-30,NA,102212000,NA,80237000,149787000,295885000,0,112644000,NA,21975000,295885000,183241000,0,-10432000,NA,80237000,78715000,33454000,income_statement,Banks—Regional,TFS Financial Corporation,"TFS Financial Corporation, through its subsidiaries, provides retail consumer banking services in the United States. Its deposit products include savings, money market, checking, individual retirement, and other qualified plan accounts, as well as certificates of deposit. The company also provides residential real estate mortgage loans, residential construction loans, and home equity loans and lines of credit, as well as purchase mortgages and first mortgage refinance loans. In addition, it offers escrow and settlement services. The company provides its products and services through its main office in Cleveland, Ohio; and 37 full-service branches and 7 loan production offices located throughout the states of Ohio and Florida. The company was founded in 1938 and is headquartered in Cleveland, Ohio. TFS Financial Corporation is a subsidiary of Third Federal Savings and Loan Association of Cleveland, MHC."
TFSL,2020-09-30,NA,100245000,NA,83317000,145816000,292519000,0,110870000,NA,16928000,292519000,181649000,0,-10625000,NA,83317000,81738000,35833000,income_statement,Banks—Regional,TFS Financial Corporation,"TFS Financial Corporation, through its subsidiaries, provides retail consumer banking services in the United States. Its deposit products include savings, money market, checking, individual retirement, and other qualified plan accounts, as well as certificates of deposit. The company also provides residential real estate mortgage loans, residential construction loans, and home equity loans and lines of credit, as well as purchase mortgages and first mortgage refinance loans. In addition, it offers escrow and settlement services. The company provides its products and services through its main office in Cleveland, Ohio; and 37 full-service branches and 7 loan production offices located throughout the states of Ohio and Florida. The company was founded in 1938 and is headquartered in Cleveland, Ohio. TFS Financial Corporation is a subsidiary of Third Federal Savings and Loan Association of Cleveland, MHC."
TFX,2016-12-31,58579000,245725000,NA,237377000,569753000,1004700000,376368000,376368000,-54941000,8074000,1868027000,1491659000,863327000,-130643000,190000,237651000,237377000,NA,income_statement,NA,NA,NA
TFX,2017-12-31,84770000,284911000,NA,152530000,696388000,1171802000,390644000,390644000,-82546000,129648000,2146303000,1755659000,974501000,-105733000,-2733000,155263000,152530000,NA,income_statement,NA,NA,NA
TFX,2018-12-31,106208000,219628000,NA,200802000,825711000,1384442000,452523000,452523000,-103020000,23196000,2448383000,1995860000,1063941000,-232895000,4370000,196432000,200802000,NA,income_statement,NA,NA,NA
TFX,2019-12-31,113857000,339903000,NA,461466000,880458000,1491612000,497297000,497297000,-80270000,-122078000,2595362000,2098065000,1103750000,-157394000,-515000,461981000,461466000,NA,income_statement,NA,NA,NA
TGA,2016-12-31,NA,-75219000,NA,-87665000,18430000,22799000,-66217000,-66217000,-6068000,12446000,63134000,129351000,40335000,-9002000,NA,-87665000,-87665000,7983000,income_statement,NA,NA,NA
TGA,2017-12-31,NA,-56917000,NA,-78736000,17748000,97459000,-50598000,-50598000,-6233000,21819000,148464000,199062000,51005000,-6319000,NA,-78736000,-78736000,11248000,income_statement,NA,NA,NA
TGA,2018-12-31,NA,42017000,NA,15677000,20791000,122929000,46026000,46026000,-5075000,26340000,176227000,130201000,53298000,-4009000,NA,15677000,15677000,7321000,income_statement,NA,NA,NA
TGA,2019-12-31,NA,22103000,NA,-3995000,17898000,89470000,25627000,25627000,-4256000,26098000,140096000,114469000,50626000,-3524000,NA,-3995000,-3995000,3060000,income_statement,NA,NA,NA
TGLS,2016-12-31,NA,39252000,1417000,23180000,63497000,112647000,47848000,47848000,-16814000,16072000,305016000,257168000,192369000,-8596000,NA,23180000,23180000,1302000,income_statement,Building Products & Equipment,Tecnoglass Inc.,"Tecnoglass Inc., through its subsidiaries, manufactures, supplies, and installs architectural glass, windows, and associated aluminum products for the commercial and residential construction industries in North, Central, and South America. The company offers low emissivity, laminated/thermo-laminated, thermo-acoustic, tempered, silk-screened, curved, and digital print glass products. It also produces, exports, imports, and markets aluminum products, including bars, plates, profiles, rods, tubes, and other hardware used in the manufacture of architectural glass settings, such as windows, doors, spatial separators, and similar products. In addition, the company provides curtain wall/floating facades, windows and doors, interior dividers and commercial display windows, hurricane-proof windows, stick facade systems, and other products, such as awnings, structures, automatic doors, and other components of architectural systems. It markets and sells its products under the Tecnoglass, ES Windows, and Alutions brands through internal and independent sales representatives, as wells as directly to distributors. The company was founded in 1984 and is headquartered in Barranquilla, Colombia. Tecnoglass Inc. is a subsidiary of Energy Holding Corporation."
TGLS,2017-12-31,NA,11518000,1417000,5449000,63923000,99182000,34364000,34364000,-19872000,5793000,314456000,280092000,215274000,-22846000,NA,5725000,5449000,895000,income_statement,Building Products & Equipment,Tecnoglass Inc.,"Tecnoglass Inc., through its subsidiaries, manufactures, supplies, and installs architectural glass, windows, and associated aluminum products for the commercial and residential construction industries in North, Central, and South America. The company offers low emissivity, laminated/thermo-laminated, thermo-acoustic, tempered, silk-screened, curved, and digital print glass products. It also produces, exports, imports, and markets aluminum products, including bars, plates, profiles, rods, tubes, and other hardware used in the manufacture of architectural glass settings, such as windows, doors, spatial separators, and similar products. In addition, the company provides curtain wall/floating facades, windows and doors, interior dividers and commercial display windows, hurricane-proof windows, stick facade systems, and other products, such as awnings, structures, automatic doors, and other components of architectural systems. It markets and sells its products under the Tecnoglass, ES Windows, and Alutions brands through internal and independent sales representatives, as wells as directly to distributors. The company was founded in 1984 and is headquartered in Barranquilla, Colombia. Tecnoglass Inc. is a subsidiary of Energy Holding Corporation."
TGLS,2018-12-31,NA,14462000,872000,9031000,72177000,120217000,47195000,47195000,-21187000,5976000,370984000,323789000,250767000,-32733000,NA,8486000,9031000,845000,income_statement,Building Products & Equipment,Tecnoglass Inc.,"Tecnoglass Inc., through its subsidiaries, manufactures, supplies, and installs architectural glass, windows, and associated aluminum products for the commercial and residential construction industries in North, Central, and South America. The company offers low emissivity, laminated/thermo-laminated, thermo-acoustic, tempered, silk-screened, curved, and digital print glass products. It also produces, exports, imports, and markets aluminum products, including bars, plates, profiles, rods, tubes, and other hardware used in the manufacture of architectural glass settings, such as windows, doors, spatial separators, and similar products. In addition, the company provides curtain wall/floating facades, windows and doors, interior dividers and commercial display windows, hurricane-proof windows, stick facade systems, and other products, such as awnings, structures, automatic doors, and other components of architectural systems. It markets and sells its products under the Tecnoglass, ES Windows, and Alutions brands through internal and independent sales representatives, as wells as directly to distributors. The company was founded in 1984 and is headquartered in Barranquilla, Colombia. Tecnoglass Inc. is a subsidiary of Energy Holding Corporation."
TGLS,2019-12-31,NA,37197000,606000,24535000,75706000,135809000,58815000,58815000,-22806000,12928000,430912000,372097000,295103000,-21618000,NA,24269000,24535000,1288000,income_statement,Building Products & Equipment,Tecnoglass Inc.,"Tecnoglass Inc., through its subsidiaries, manufactures, supplies, and installs architectural glass, windows, and associated aluminum products for the commercial and residential construction industries in North, Central, and South America. The company offers low emissivity, laminated/thermo-laminated, thermo-acoustic, tempered, silk-screened, curved, and digital print glass products. It also produces, exports, imports, and markets aluminum products, including bars, plates, profiles, rods, tubes, and other hardware used in the manufacture of architectural glass settings, such as windows, doors, spatial separators, and similar products. In addition, the company provides curtain wall/floating facades, windows and doors, interior dividers and commercial display windows, hurricane-proof windows, stick facade systems, and other products, such as awnings, structures, automatic doors, and other components of architectural systems. It markets and sells its products under the Tecnoglass, ES Windows, and Alutions brands through internal and independent sales representatives, as wells as directly to distributors. The company was founded in 1984 and is headquartered in Barranquilla, Colombia. Tecnoglass Inc. is a subsidiary of Energy Holding Corporation."
TGT,2017-01-28,NA,3961000000,NA,2734000000,14086000000,21126000000,4995000000,4995000000,-569000000,1295000000,70271000000,65276000000,49145000000,-1034000000,68000000,2666000000,2734000000,NA,income_statement,NA,NA,NA
TGT,2018-02-03,NA,3630000000,NA,2914000000,14990000000,21589000000,4374000000,4374000000,-530000000,722000000,72714000000,68340000000,51125000000,-744000000,6000000,2908000000,2914000000,NA,income_statement,NA,NA,NA
TGT,2019-02-02,NA,3676000000,NA,2937000000,15606000000,22057000000,4227000000,4227000000,-461000000,746000000,75356000000,71129000000,53299000000,-551000000,7000000,2930000000,2937000000,NA,income_statement,NA,NA,NA
TGT,2020-02-01,NA,4190000000,NA,3281000000,16163000000,23248000000,4728000000,4728000000,-467000000,921000000,78112000000,73384000000,54864000000,-538000000,12000000,3269000000,3281000000,NA,income_statement,NA,NA,NA
TGTX,2016-12-31,69232000,-78253000,NA,-78253000,9889000,152000,-78969000,-78969000,-845000,0,152000,79121000,0,716000,NA,-78253000,-78253000,NA,income_statement,Biotechnology,"TG Therapeutics, Inc.","TG Therapeutics, Inc., a biopharmaceutical company, focuses on the acquisition, development, and commercialization of various treatments for B-cell malignancies and autoimmune diseases. The company develops a robust B-cell directed research and development platform for identification of key B-cell pathways of interest and rapid clinical testing. Its lead therapies include Umbralisib, an investigational dual inhibitor of PI3K delta and CK1 epsilon is being evaluated in phase 2b and phase 3 trials in patients with non-hodgkin lymphoma (NHL) and chronic lymphocytic leukemia (CLL); and Ublituximab, an investigational glycoengineered monoclonal antibody that targets a epitope on CD20-expressing B cells for patients with NHL, CLL, and relapsing forms of multiple sclerosis. In addition, the company develops Cosibelimab, a human monoclonal antibody of IgG1 subtype that binds to programmed death-ligand 1 (PD-L1) and blocks its interactions with PD-1 and B7.1 receptors; TG-1701 is an orally available and covalently-bound Bruton's tyrosine kinase (BTK) inhibitor that exhibits selectivity to BTK compared to ibrutinib in in vitro kinase screening; and TG-1801, a bispecific CD47 and CD19 antibody. It is also has various licensed preclinical programs for BET, interleukin-1 receptor associated kinase-4, and GITR. The company has strategic alliances with LFB Biotechnologies S.A.S; GTC Biotherapeutics; LFB/GTC LLC; Ildong Pharmaceutical Co. Ltd.; Rhizen Pharmaceuticals, S A; Checkpoint Therapeutics, Inc.; Jiangsu Hengrui Medicine Co.; Novimmune SA; Ligand Pharmaceuticals Incorporated; and Jubilant Biosys. TG Therapeutics, Inc. is headquartered in New York, New York."
TGTX,2017-12-31,102533000,-118476000,NA,-118476000,16331000,152000,-118712000,-118712000,-845000,0,152000,118864000,0,236000,NA,-118476000,-118476000,NA,income_statement,Biotechnology,"TG Therapeutics, Inc.","TG Therapeutics, Inc., a biopharmaceutical company, focuses on the acquisition, development, and commercialization of various treatments for B-cell malignancies and autoimmune diseases. The company develops a robust B-cell directed research and development platform for identification of key B-cell pathways of interest and rapid clinical testing. Its lead therapies include Umbralisib, an investigational dual inhibitor of PI3K delta and CK1 epsilon is being evaluated in phase 2b and phase 3 trials in patients with non-hodgkin lymphoma (NHL) and chronic lymphocytic leukemia (CLL); and Ublituximab, an investigational glycoengineered monoclonal antibody that targets a epitope on CD20-expressing B cells for patients with NHL, CLL, and relapsing forms of multiple sclerosis. In addition, the company develops Cosibelimab, a human monoclonal antibody of IgG1 subtype that binds to programmed death-ligand 1 (PD-L1) and blocks its interactions with PD-1 and B7.1 receptors; TG-1701 is an orally available and covalently-bound Bruton's tyrosine kinase (BTK) inhibitor that exhibits selectivity to BTK compared to ibrutinib in in vitro kinase screening; and TG-1801, a bispecific CD47 and CD19 antibody. It is also has various licensed preclinical programs for BET, interleukin-1 receptor associated kinase-4, and GITR. The company has strategic alliances with LFB Biotechnologies S.A.S; GTC Biotherapeutics; LFB/GTC LLC; Ildong Pharmaceutical Co. Ltd.; Rhizen Pharmaceuticals, S A; Checkpoint Therapeutics, Inc.; Jiangsu Hengrui Medicine Co.; Novimmune SA; Ligand Pharmaceuticals Incorporated; and Jubilant Biosys. TG Therapeutics, Inc. is headquartered in New York, New York."
TGTX,2018-12-31,159391000,-173482000,NA,-173482000,15161000,152000,-174400000,-174400000,-877000,0,152000,174552000,0,918000,NA,-173482000,-173482000,NA,income_statement,Biotechnology,"TG Therapeutics, Inc.","TG Therapeutics, Inc., a biopharmaceutical company, focuses on the acquisition, development, and commercialization of various treatments for B-cell malignancies and autoimmune diseases. The company develops a robust B-cell directed research and development platform for identification of key B-cell pathways of interest and rapid clinical testing. Its lead therapies include Umbralisib, an investigational dual inhibitor of PI3K delta and CK1 epsilon is being evaluated in phase 2b and phase 3 trials in patients with non-hodgkin lymphoma (NHL) and chronic lymphocytic leukemia (CLL); and Ublituximab, an investigational glycoengineered monoclonal antibody that targets a epitope on CD20-expressing B cells for patients with NHL, CLL, and relapsing forms of multiple sclerosis. In addition, the company develops Cosibelimab, a human monoclonal antibody of IgG1 subtype that binds to programmed death-ligand 1 (PD-L1) and blocks its interactions with PD-1 and B7.1 receptors; TG-1701 is an orally available and covalently-bound Bruton's tyrosine kinase (BTK) inhibitor that exhibits selectivity to BTK compared to ibrutinib in in vitro kinase screening; and TG-1801, a bispecific CD47 and CD19 antibody. It is also has various licensed preclinical programs for BET, interleukin-1 receptor associated kinase-4, and GITR. The company has strategic alliances with LFB Biotechnologies S.A.S; GTC Biotherapeutics; LFB/GTC LLC; Ildong Pharmaceutical Co. Ltd.; Rhizen Pharmaceuticals, S A; Checkpoint Therapeutics, Inc.; Jiangsu Hengrui Medicine Co.; Novimmune SA; Ligand Pharmaceuticals Incorporated; and Jubilant Biosys. TG Therapeutics, Inc. is headquartered in New York, New York."
TGTX,2019-12-31,154180000,-172871000,NA,-172871000,15027000,152000,-169055000,-169055000,-5287000,0,152000,169207000,0,-3816000,NA,-172871000,-172871000,NA,income_statement,Biotechnology,"TG Therapeutics, Inc.","TG Therapeutics, Inc., a biopharmaceutical company, focuses on the acquisition, development, and commercialization of various treatments for B-cell malignancies and autoimmune diseases. The company develops a robust B-cell directed research and development platform for identification of key B-cell pathways of interest and rapid clinical testing. Its lead therapies include Umbralisib, an investigational dual inhibitor of PI3K delta and CK1 epsilon is being evaluated in phase 2b and phase 3 trials in patients with non-hodgkin lymphoma (NHL) and chronic lymphocytic leukemia (CLL); and Ublituximab, an investigational glycoengineered monoclonal antibody that targets a epitope on CD20-expressing B cells for patients with NHL, CLL, and relapsing forms of multiple sclerosis. In addition, the company develops Cosibelimab, a human monoclonal antibody of IgG1 subtype that binds to programmed death-ligand 1 (PD-L1) and blocks its interactions with PD-1 and B7.1 receptors; TG-1701 is an orally available and covalently-bound Bruton's tyrosine kinase (BTK) inhibitor that exhibits selectivity to BTK compared to ibrutinib in in vitro kinase screening; and TG-1801, a bispecific CD47 and CD19 antibody. It is also has various licensed preclinical programs for BET, interleukin-1 receptor associated kinase-4, and GITR. The company has strategic alliances with LFB Biotechnologies S.A.S; GTC Biotherapeutics; LFB/GTC LLC; Ildong Pharmaceutical Co. Ltd.; Rhizen Pharmaceuticals, S A; Checkpoint Therapeutics, Inc.; Jiangsu Hengrui Medicine Co.; Novimmune SA; Ligand Pharmaceuticals Incorporated; and Jubilant Biosys. TG Therapeutics, Inc. is headquartered in New York, New York."
TH,2016-12-31,NA,44219000,NA,26909000,15793000,97437000,40313000,40313000,-2846000,17310000,149467000,109154000,52030000,3906000,NA,26909000,26909000,2000,income_statement,Oil & Gas Equipment & Services,Target Hospitality Corp.,"Target Hospitality Corp. operates as a specialty rental and hospitality services company in the United States. The company operates through three segments: Permian Basin, Bakken Basin, and Government. It owns a network of specialty rental accommodation units with approximately 13,800 beds across 25 sites. The company owns and operates 26 communities in the Permian and Bakken Basins. It serves investment grade oil and gas companies, energy infrastructure companies, and U.S. government and government contractors. The company is headquartered in The Woodlands, Texas."
TH,2017-12-31,NA,26565000,NA,981000,15537000,77510000,32416000,32416000,-2846000,25584000,134235000,101819000,56725000,-5851000,NA,981000,981000,-588000,income_statement,Oil & Gas Equipment & Services,Target Hospitality Corp.,"Target Hospitality Corp. operates as a specialty rental and hospitality services company in the United States. The company operates through three segments: Permian Basin, Bakken Basin, and Government. It owns a network of specialty rental accommodation units with approximately 13,800 beds across 25 sites. The company owns and operates 26 communities in the Permian and Bakken Basins. It serves investment grade oil and gas companies, energy infrastructure companies, and U.S. government and government contractors. The company is headquartered in The Woodlands, Texas."
TH,2018-12-31,NA,16711000,NA,4956000,19629000,137164000,85604000,85604000,-26961000,11755000,240600000,154996000,103436000,-68893000,NA,4956000,4956000,-7197000,income_statement,Oil & Gas Equipment & Services,Target Hospitality Corp.,"Target Hospitality Corp. operates as a specialty rental and hospitality services company in the United States. The company operates through three segments: Permian Basin, Bakken Basin, and Government. It owns a network of specialty rental accommodation units with approximately 13,800 beds across 25 sites. The company owns and operates 26 communities in the Permian and Bakken Basins. It serves investment grade oil and gas companies, energy infrastructure companies, and U.S. government and government contractors. The company is headquartered in The Woodlands, Texas."
TH,2019-12-31,NA,13843000,NA,6236000,37794000,190434000,93860000,93860000,-33401000,7607000,321096000,227236000,130662000,-80017000,NA,6236000,6236000,-122000,income_statement,Oil & Gas Equipment & Services,Target Hospitality Corp.,"Target Hospitality Corp. operates as a specialty rental and hospitality services company in the United States. The company operates through three segments: Permian Basin, Bakken Basin, and Government. It owns a network of specialty rental accommodation units with approximately 13,800 beds across 25 sites. The company owns and operates 26 communities in the Permian and Bakken Basins. It serves investment grade oil and gas companies, energy infrastructure companies, and U.S. government and government contractors. The company is headquartered in The Woodlands, Texas."
THBR,2019-12-31,NA,2270726,NA,2270726,413839,0,-413839,-413839,NA,0,0,413839,0,2684565,NA,2270726,-288512,NA,income_statement,Shell Companies,"Thunder Bridge Acquisition II,","Thunder Bridge Acquisition II, Ltd. does not have significant operations. It intends to seek a merger, share exchange, asset acquisition, stock purchase, reorganization, or similar business combination with one or more businesses. Thunder Bridge Acquisition II, Ltd. was founded in 2019 and is based in Great Falls, Virginia."
THCA,2019-12-31,NA,1355578,NA,1070906,550339,0,-550339,-550339,NA,284671,0,550339,0,1905917,NA,1070906,-60889,NA,income_statement,Shell Companies,Tuscan Holdings Corp. II,"Tuscan Holdings Corp. II does not have significant operations. It intends to enter into a merger, share exchange, asset acquisition, stock purchase, recapitalization, reorganization, or other similar business combination with one or more businesses or entities. The company was founded in 2019 and is based in New York, New York."
THCB,2018-12-31,NA,-4752,NA,-4752,NA,0,0,NA,NA,0,0,0,0,-4752,NA,-4752,-4752,NA,income_statement,Shell Companies,Tuscan Holdings Corp.,"Tuscan Holdings Corp. does not have significant operations. It intends to enter into a merger, share exchange, asset acquisition, stock purchase, recapitalization, reorganization, or other similar business combination with businesses and entities. The company was founded in 2018 and is based in New York, New York."
THCB,2019-12-31,NA,4262430,NA,3367179,NA,0,0,NA,NA,895251,0,0,0,4262430,NA,3367179,-544754,NA,income_statement,Shell Companies,Tuscan Holdings Corp.,"Tuscan Holdings Corp. does not have significant operations. It intends to enter into a merger, share exchange, asset acquisition, stock purchase, recapitalization, reorganization, or other similar business combination with businesses and entities. The company was founded in 2018 and is based in New York, New York."
THFF,2017-12-31,NA,49753000,NA,29131000,64199000,138500000,0,50668000,NA,20622000,138500000,87832000,0,-915000,NA,29131000,29131000,23633000,income_statement,Banks—Regional,First Financial Corporation Ind,"First Financial Corporation, through its subsidiaries, provides various financial services. It offers non-interest-bearing demand, interest-bearing demand, savings, time, and other time deposits. The company also provides commercial loans primarily to expand a business or finance asset purchases; residential real estate and residential real estate construction loans; and home equity loans and lines, secured loans, and cash/CD secured and unsecured loans. In addition, it offers lease financing, trust account, depositor, and insurance services. The company operates 82 branches in west-central Indiana, east-central Illinois, western Kentucky, and middle and western Tennessee. It also rents an office building. First Financial Corporation was founded in 1984 and is headquartered in Terre Haute, Indiana."
THFF,2018-12-31,NA,57728000,NA,46583000,64515000,149017000,0,58657000,NA,11145000,149017000,90360000,0,-929000,NA,46583000,46583000,25845000,income_statement,Banks—Regional,First Financial Corporation Ind,"First Financial Corporation, through its subsidiaries, provides various financial services. It offers non-interest-bearing demand, interest-bearing demand, savings, time, and other time deposits. The company also provides commercial loans primarily to expand a business or finance asset purchases; residential real estate and residential real estate construction loans; and home equity loans and lines, secured loans, and cash/CD secured and unsecured loans. In addition, it offers lease financing, trust account, depositor, and insurance services. The company operates 82 branches in west-central Indiana, east-central Illinois, western Kentucky, and middle and western Tennessee. It also rents an office building. First Financial Corporation was founded in 1984 and is headquartered in Terre Haute, Indiana."
THFF,2019-12-31,NA,60999000,NA,48872000,70671000,165404000,0,61692000,NA,12127000,165404000,103712000,0,-693000,NA,48872000,48872000,33041000,income_statement,Banks—Regional,First Financial Corporation Ind,"First Financial Corporation, through its subsidiaries, provides various financial services. It offers non-interest-bearing demand, interest-bearing demand, savings, time, and other time deposits. The company also provides commercial loans primarily to expand a business or finance asset purchases; residential real estate and residential real estate construction loans; and home equity loans and lines, secured loans, and cash/CD secured and unsecured loans. In addition, it offers lease financing, trust account, depositor, and insurance services. The company operates 82 branches in west-central Indiana, east-central Illinois, western Kentucky, and middle and western Tennessee. It also rents an office building. First Financial Corporation was founded in 1984 and is headquartered in Terre Haute, Indiana."
THFF,2020-12-31,NA,65536000,NA,53844000,80701000,178294000,0,65852000,NA,11692000,178294000,112442000,0,-316000,NA,53844000,53844000,31741000,income_statement,Banks—Regional,First Financial Corporation Ind,"First Financial Corporation, through its subsidiaries, provides various financial services. It offers non-interest-bearing demand, interest-bearing demand, savings, time, and other time deposits. The company also provides commercial loans primarily to expand a business or finance asset purchases; residential real estate and residential real estate construction loans; and home equity loans and lines, secured loans, and cash/CD secured and unsecured loans. In addition, it offers lease financing, trust account, depositor, and insurance services. The company operates 82 branches in west-central Indiana, east-central Illinois, western Kentucky, and middle and western Tennessee. It also rents an office building. First Financial Corporation was founded in 1984 and is headquartered in Terre Haute, Indiana."
THMO,2017-06-30,2497000,-29768000,-487000,-29095000,12401000,5839000,-9059000,-9059000,-20519000,-673000,14525000,23584000,8686000,-20709000,NA,-29095000,-29095000,NA,income_statement,Medical Devices,"ThermoGenesis Holdings, Inc.","ThermoGenesis Holdings, Inc. develops, commercializes, and markets a range of automated technologies for chimeric antigen receptor (CAR)-T and other cell-based therapies. It markets a suite of solutions for automated clinical biobanking, point-of-care applications, and automation for immuno-oncology, including its semi-automated, functionally closed CAR-TXpress platform, which streamlines the manufacturing process for the emerging CAR-T immunotherapy market. The company operates through two segments, Device and Clinical Development. It manufactures and markets products for clinical bio-banking applications, including AXP Automated Cell Separation System, an automated cell separation system for isolating and retrieving stem and progenitor cells from umbilical cord blood; and BioArchive Automated Cryopreservation System, an automated, robotic, liquid nitrogen controlled-rate-freezing, and cryogenic storage system for cord blood samples and cell therapeutic products used in clinical applications. The company also offers PXP Point-of-Care System, an automated sterile system that allows for the automated processing of autologous peripheral blood or bone marrow aspirate derived stem cells at the point-of-care, such as surgical centers or clinics; and X-Series products, such as X-Lab for cell isolation, X-Wash System for cell washing and reformulation, X-Mini for small scale cell purification, and X-BACS System under development for large scale cell purification using the company's proprietary buoyance-activated cell sorting (BACS) technology. In addition, it provides AR-TXpress Platform that addresses the critical unmet need for large scale cellular processing and chemistry, manufacturing, and controls needs. The company was formerly known as Cesca Therapeutics Inc. and changed its name to ThermoGenesis Holdings, Inc. in November 2019. ThermoGenesis Holdings, Inc. was founded in 1986 and is headquartered in Rancho Cordova, California."
THMO,2017-12-31,3379000,-8932000,-487000,-5534000,9609000,5060000,-7928000,-7928000,-672000,-2911000,12766000,20694000,7706000,-1004000,NA,-6021000,-5534000,NA,income_statement,Medical Devices,"ThermoGenesis Holdings, Inc.","ThermoGenesis Holdings, Inc. develops, commercializes, and markets a range of automated technologies for chimeric antigen receptor (CAR)-T and other cell-based therapies. It markets a suite of solutions for automated clinical biobanking, point-of-care applications, and automation for immuno-oncology, including its semi-automated, functionally closed CAR-TXpress platform, which streamlines the manufacturing process for the emerging CAR-T immunotherapy market. The company operates through two segments, Device and Clinical Development. It manufactures and markets products for clinical bio-banking applications, including AXP Automated Cell Separation System, an automated cell separation system for isolating and retrieving stem and progenitor cells from umbilical cord blood; and BioArchive Automated Cryopreservation System, an automated, robotic, liquid nitrogen controlled-rate-freezing, and cryogenic storage system for cord blood samples and cell therapeutic products used in clinical applications. The company also offers PXP Point-of-Care System, an automated sterile system that allows for the automated processing of autologous peripheral blood or bone marrow aspirate derived stem cells at the point-of-care, such as surgical centers or clinics; and X-Series products, such as X-Lab for cell isolation, X-Wash System for cell washing and reformulation, X-Mini for small scale cell purification, and X-BACS System under development for large scale cell purification using the company's proprietary buoyance-activated cell sorting (BACS) technology. In addition, it provides AR-TXpress Platform that addresses the critical unmet need for large scale cellular processing and chemistry, manufacturing, and controls needs. The company was formerly known as Cesca Therapeutics Inc. and changed its name to ThermoGenesis Holdings, Inc. in November 2019. ThermoGenesis Holdings, Inc. was founded in 1986 and is headquartered in Rancho Cordova, California."
THMO,2018-12-31,3012000,-45670000,-1711000,-39716000,8970000,2193000,-9789000,-9789000,-2697000,-4730000,9672000,19461000,7479000,-35881000,NA,-40940000,-39716000,NA,income_statement,Medical Devices,"ThermoGenesis Holdings, Inc.","ThermoGenesis Holdings, Inc. develops, commercializes, and markets a range of automated technologies for chimeric antigen receptor (CAR)-T and other cell-based therapies. It markets a suite of solutions for automated clinical biobanking, point-of-care applications, and automation for immuno-oncology, including its semi-automated, functionally closed CAR-TXpress platform, which streamlines the manufacturing process for the emerging CAR-T immunotherapy market. The company operates through two segments, Device and Clinical Development. It manufactures and markets products for clinical bio-banking applications, including AXP Automated Cell Separation System, an automated cell separation system for isolating and retrieving stem and progenitor cells from umbilical cord blood; and BioArchive Automated Cryopreservation System, an automated, robotic, liquid nitrogen controlled-rate-freezing, and cryogenic storage system for cord blood samples and cell therapeutic products used in clinical applications. The company also offers PXP Point-of-Care System, an automated sterile system that allows for the automated processing of autologous peripheral blood or bone marrow aspirate derived stem cells at the point-of-care, such as surgical centers or clinics; and X-Series products, such as X-Lab for cell isolation, X-Wash System for cell washing and reformulation, X-Mini for small scale cell purification, and X-BACS System under development for large scale cell purification using the company's proprietary buoyance-activated cell sorting (BACS) technology. In addition, it provides AR-TXpress Platform that addresses the critical unmet need for large scale cellular processing and chemistry, manufacturing, and controls needs. The company was formerly known as Cesca Therapeutics Inc. and changed its name to ThermoGenesis Holdings, Inc. in November 2019. ThermoGenesis Holdings, Inc. was founded in 1986 and is headquartered in Rancho Cordova, California."
THMO,2019-12-31,2298000,-10099000,530000,-9497000,6731000,5696000,-3333000,-3333000,-4479000,0,13047000,16380000,7351000,-6766000,NA,-10099000,-9497000,NA,income_statement,Medical Devices,"ThermoGenesis Holdings, Inc.","ThermoGenesis Holdings, Inc. develops, commercializes, and markets a range of automated technologies for chimeric antigen receptor (CAR)-T and other cell-based therapies. It markets a suite of solutions for automated clinical biobanking, point-of-care applications, and automation for immuno-oncology, including its semi-automated, functionally closed CAR-TXpress platform, which streamlines the manufacturing process for the emerging CAR-T immunotherapy market. The company operates through two segments, Device and Clinical Development. It manufactures and markets products for clinical bio-banking applications, including AXP Automated Cell Separation System, an automated cell separation system for isolating and retrieving stem and progenitor cells from umbilical cord blood; and BioArchive Automated Cryopreservation System, an automated, robotic, liquid nitrogen controlled-rate-freezing, and cryogenic storage system for cord blood samples and cell therapeutic products used in clinical applications. The company also offers PXP Point-of-Care System, an automated sterile system that allows for the automated processing of autologous peripheral blood or bone marrow aspirate derived stem cells at the point-of-care, such as surgical centers or clinics; and X-Series products, such as X-Lab for cell isolation, X-Wash System for cell washing and reformulation, X-Mini for small scale cell purification, and X-BACS System under development for large scale cell purification using the company's proprietary buoyance-activated cell sorting (BACS) technology. In addition, it provides AR-TXpress Platform that addresses the critical unmet need for large scale cellular processing and chemistry, manufacturing, and controls needs. The company was formerly known as Cesca Therapeutics Inc. and changed its name to ThermoGenesis Holdings, Inc. in November 2019. ThermoGenesis Holdings, Inc. was founded in 1986 and is headquartered in Rancho Cordova, California."
THRM,2016-12-31,72923000,110563000,NA,76598000,113252000,299037000,112862000,112862000,-3257000,33965000,917600000,804738000,618563000,-2299000,NA,76598000,76598000,NA,income_statement,Auto Parts,Gentherm Inc,"Gentherm Incorporated designs, develops, manufactures, and markets thermal management technologies. The company operates through two segments, Automotive and Industrial. The Automotive segment offers climate comfort system solutions, which include seat heaters, blowers, and thermoelectric devices for variable temperature climate control seats that are designed to provide thermal comfort to automobile passengers; integrated electronic components, such as electronic control units that utilize proprietary electronics technology and software; and other climate comfort system solutions, including steering wheel heaters, neck conditioners, and climate control system products for door panels, armrests, cupholders, and storage bins. This segment also provides battery thermal management system solutions, which consist battery cooling modules for 12V and 48V automotive batteries; and automotive electronic and software systems, consisting electronic control units for climate and comfort system solutions and proprietary electronic control units for memory seat modules, as well as specialized automotive cable systems. This segment serves light vehicle original equipment manufacturers (OEMs), commercial vehicle OEMs, and automotive seat manufacturers, as well as aftermarket seat distributors and installers. The Industrial segment offers patient temperature management systems. The company provides its products and services in the United States, Germany, Canada, China, Hungary, Japan, Korea, North Macedonia, Malta, Mexico, the United Kingdom, Ukraine, and Vietnam. The company was formerly known as Amerigon Incorporated and changed its name to Gentherm Incorporated in September 2012. Gentherm Incorporated was incorporated in 1991 and is headquartered in Northville, Michigan."
THRM,2017-12-31,82478000,69255000,NA,35227000,139619000,319195000,97098000,97098000,-4885000,34028000,993991000,896893000,674796000,-27843000,NA,35227000,35227000,NA,income_statement,Auto Parts,Gentherm Inc,"Gentherm Incorporated designs, develops, manufactures, and markets thermal management technologies. The company operates through two segments, Automotive and Industrial. The Automotive segment offers climate comfort system solutions, which include seat heaters, blowers, and thermoelectric devices for variable temperature climate control seats that are designed to provide thermal comfort to automobile passengers; integrated electronic components, such as electronic control units that utilize proprietary electronics technology and software; and other climate comfort system solutions, including steering wheel heaters, neck conditioners, and climate control system products for door panels, armrests, cupholders, and storage bins. This segment also provides battery thermal management system solutions, which consist battery cooling modules for 12V and 48V automotive batteries; and automotive electronic and software systems, consisting electronic control units for climate and comfort system solutions and proprietary electronic control units for memory seat modules, as well as specialized automotive cable systems. This segment serves light vehicle original equipment manufacturers (OEMs), commercial vehicle OEMs, and automotive seat manufacturers, as well as aftermarket seat distributors and installers. The Industrial segment offers patient temperature management systems. The company provides its products and services in the United States, Germany, Canada, China, Hungary, Japan, Korea, North Macedonia, Malta, Mexico, the United Kingdom, Ukraine, and Vietnam. The company was formerly known as Amerigon Incorporated and changed its name to Gentherm Incorporated in September 2012. Gentherm Incorporated was incorporated in 1991 and is headquartered in Northville, Michigan."
THRM,2018-12-31,79900000,58119000,NA,41899000,137398000,304858000,87560000,87560000,-4942000,16220000,1048505000,960945000,743647000,-29441000,NA,41899000,41899000,NA,income_statement,Auto Parts,Gentherm Inc,"Gentherm Incorporated designs, develops, manufactures, and markets thermal management technologies. The company operates through two segments, Automotive and Industrial. The Automotive segment offers climate comfort system solutions, which include seat heaters, blowers, and thermoelectric devices for variable temperature climate control seats that are designed to provide thermal comfort to automobile passengers; integrated electronic components, such as electronic control units that utilize proprietary electronics technology and software; and other climate comfort system solutions, including steering wheel heaters, neck conditioners, and climate control system products for door panels, armrests, cupholders, and storage bins. This segment also provides battery thermal management system solutions, which consist battery cooling modules for 12V and 48V automotive batteries; and automotive electronic and software systems, consisting electronic control units for climate and comfort system solutions and proprietary electronic control units for memory seat modules, as well as specialized automotive cable systems. This segment serves light vehicle original equipment manufacturers (OEMs), commercial vehicle OEMs, and automotive seat manufacturers, as well as aftermarket seat distributors and installers. The Industrial segment offers patient temperature management systems. The company provides its products and services in the United States, Germany, Canada, China, Hungary, Japan, Korea, North Macedonia, Malta, Mexico, the United Kingdom, Ukraine, and Vietnam. The company was formerly known as Amerigon Incorporated and changed its name to Gentherm Incorporated in September 2012. Gentherm Incorporated was incorporated in 1991 and is headquartered in Northville, Michigan."
THRM,2019-12-31,72476000,59151000,NA,37506000,118680000,288335000,97179000,97179000,-4763000,21645000,971684000,874505000,683349000,-38028000,NA,37506000,37506000,NA,income_statement,Auto Parts,Gentherm Inc,"Gentherm Incorporated designs, develops, manufactures, and markets thermal management technologies. The company operates through two segments, Automotive and Industrial. The Automotive segment offers climate comfort system solutions, which include seat heaters, blowers, and thermoelectric devices for variable temperature climate control seats that are designed to provide thermal comfort to automobile passengers; integrated electronic components, such as electronic control units that utilize proprietary electronics technology and software; and other climate comfort system solutions, including steering wheel heaters, neck conditioners, and climate control system products for door panels, armrests, cupholders, and storage bins. This segment also provides battery thermal management system solutions, which consist battery cooling modules for 12V and 48V automotive batteries; and automotive electronic and software systems, consisting electronic control units for climate and comfort system solutions and proprietary electronic control units for memory seat modules, as well as specialized automotive cable systems. This segment serves light vehicle original equipment manufacturers (OEMs), commercial vehicle OEMs, and automotive seat manufacturers, as well as aftermarket seat distributors and installers. The Industrial segment offers patient temperature management systems. The company provides its products and services in the United States, Germany, Canada, China, Hungary, Japan, Korea, North Macedonia, Malta, Mexico, the United Kingdom, Ukraine, and Vietnam. The company was formerly known as Amerigon Incorporated and changed its name to Gentherm Incorporated in September 2012. Gentherm Incorporated was incorporated in 1991 and is headquartered in Northville, Michigan."
THRY,2016-12-31,NA,828856000,NA,674080000,376084000,541634000,-113851000,-113851000,-162337000,154776000,942969000,1056820000,401335000,942707000,NA,674080000,-622515000,NA,income_statement,Internet Content & Information,"Thryv Holdings, Inc.","Thryv Holdings, Inc. provides print and digital marketing services, and Software as a Service (SaaS) business management tools for small-to-medium sized businesses (SMBs). The company operates in two segments, Marketing Services and SaaS. It prints yellow pages that are co-branded with various local telephone service providers. The company also offers Internet yellow pages services, including the creation of clients' business profile that primarily displayed and operated on Yellowpages.com, Superpages.com, and Dexknows.com platforms; search engine marketing solutions; and other digital media solutions, such as online display advertising, search engine optimization (SEO), and websites. In addition, it provides Thryv, a SMB business management platform; Thryv Leads that recommends an appropriate dollar budget for each SMB based on the SMB's business vertical and market geography; and add-ons, such as website development and SEO tools. The company was formerly known as Dex Media Holdings, Inc. and changed its name to Thryv Holdings, Inc. in July 2019. Thryv Holdings, Inc. is based in DFW Airport, Texas."
THRY,2017-12-31,NA,-238865000,NA,-171324000,569594000,764873000,-106156000,-106156000,-67815000,-67541000,1318166000,1424322000,553293000,-132709000,NA,-171324000,-171324000,NA,income_statement,Internet Content & Information,"Thryv Holdings, Inc.","Thryv Holdings, Inc. provides print and digital marketing services, and Software as a Service (SaaS) business management tools for small-to-medium sized businesses (SMBs). The company operates in two segments, Marketing Services and SaaS. It prints yellow pages that are co-branded with various local telephone service providers. The company also offers Internet yellow pages services, including the creation of clients' business profile that primarily displayed and operated on Yellowpages.com, Superpages.com, and Dexknows.com platforms; search engine marketing solutions; and other digital media solutions, such as online display advertising, search engine optimization (SEO), and websites. In addition, it provides Thryv, a SMB business management platform; Thryv Leads that recommends an appropriate dollar budget for each SMB based on the SMB's business vertical and market geography; and add-ons, such as website development and SEO tools. The company was formerly known as Dex Media Holdings, Inc. and changed its name to Thryv Holdings, Inc. in July 2019. Thryv Holdings, Inc. is based in DFW Airport, Texas."
THRY,2018-12-31,NA,60758000,NA,52271000,621001000,1137113000,249137000,249137000,-82697000,8487000,1784401000,1535264000,647288000,-188379000,NA,52271000,52271000,NA,income_statement,Internet Content & Information,"Thryv Holdings, Inc.","Thryv Holdings, Inc. provides print and digital marketing services, and Software as a Service (SaaS) business management tools for small-to-medium sized businesses (SMBs). The company operates in two segments, Marketing Services and SaaS. It prints yellow pages that are co-branded with various local telephone service providers. The company also offers Internet yellow pages services, including the creation of clients' business profile that primarily displayed and operated on Yellowpages.com, Superpages.com, and Dexknows.com platforms; search engine marketing solutions; and other digital media solutions, such as online display advertising, search engine optimization (SEO), and websites. In addition, it provides Thryv, a SMB business management platform; Thryv Leads that recommends an appropriate dollar budget for each SMB based on the SMB's business vertical and market geography; and add-ons, such as website development and SEO tools. The company was formerly known as Dex Media Holdings, Inc. and changed its name to Thryv Holdings, Inc. in July 2019. Thryv Holdings, Inc. is based in DFW Airport, Texas."
THRY,2019-12-31,NA,53566000,NA,35504000,534227000,945019000,204522000,204522000,-92951000,18062000,1421374000,1216852000,476355000,-150956000,NA,35504000,35504000,NA,income_statement,Internet Content & Information,"Thryv Holdings, Inc.","Thryv Holdings, Inc. provides print and digital marketing services, and Software as a Service (SaaS) business management tools for small-to-medium sized businesses (SMBs). The company operates in two segments, Marketing Services and SaaS. It prints yellow pages that are co-branded with various local telephone service providers. The company also offers Internet yellow pages services, including the creation of clients' business profile that primarily displayed and operated on Yellowpages.com, Superpages.com, and Dexknows.com platforms; search engine marketing solutions; and other digital media solutions, such as online display advertising, search engine optimization (SEO), and websites. In addition, it provides Thryv, a SMB business management platform; Thryv Leads that recommends an appropriate dollar budget for each SMB based on the SMB's business vertical and market geography; and add-ons, such as website development and SEO tools. The company was formerly known as Dex Media Holdings, Inc. and changed its name to Thryv Holdings, Inc. in July 2019. Thryv Holdings, Inc. is based in DFW Airport, Texas."
THTX,2016-11-30,NA,1049000,NA,410000,19521000,23459000,3938000,3938000,-2114000,639000,37072000,33134000,13613000,-2889000,NA,410000,410000,NA,income_statement,Drug Manufacturers—Specialty & Generic,Theratechnologies Inc.,"Theratechnologies Inc., a biopharmaceutical company, markets prescription products in the United States, Europe, and Canada. It offers EGRIFTA and EGRIFTA SV, for the reduction of excess abdominal fat in human immunodeficiency virus (HIV)-infected patients with lipodystrophy; and Trogarzo, an injection refers to ibalizumab for the treatment of multidrug resistant HIV-1 infected patients. The company's pipeline products include F8 Formulation that could be used for the treatment of HIV-associated lipodystrophy; TH-1902 for the treatment of triple negative breast cancer; and TH-1904 for the treatment of ovarian cancer. The company was founded in 1993 and is headquartered in Montreal, Canada."
THTX,2017-11-30,NA,-18450000,NA,-18450000,31833000,20735000,-11098000,-11098000,-2114000,0,42864000,53962000,22129000,-7352000,NA,-18450000,-18450000,NA,income_statement,Drug Manufacturers—Specialty & Generic,Theratechnologies Inc.,"Theratechnologies Inc., a biopharmaceutical company, markets prescription products in the United States, Europe, and Canada. It offers EGRIFTA and EGRIFTA SV, for the reduction of excess abdominal fat in human immunodeficiency virus (HIV)-infected patients with lipodystrophy; and Trogarzo, an injection refers to ibalizumab for the treatment of multidrug resistant HIV-1 infected patients. The company's pipeline products include F8 Formulation that could be used for the treatment of HIV-associated lipodystrophy; TH-1902 for the treatment of triple negative breast cancer; and TH-1904 for the treatment of ovarian cancer. The company was founded in 1993 and is headquartered in Montreal, Canada."
THTX,2018-11-30,NA,-5969000,NA,-4700000,27521000,26402000,-3561000,-3561000,-2114000,-1269000,45217000,48778000,18815000,-2408000,NA,-4700000,-4700000,NA,income_statement,Drug Manufacturers—Specialty & Generic,Theratechnologies Inc.,"Theratechnologies Inc., a biopharmaceutical company, markets prescription products in the United States, Europe, and Canada. It offers EGRIFTA and EGRIFTA SV, for the reduction of excess abdominal fat in human immunodeficiency virus (HIV)-infected patients with lipodystrophy; and Trogarzo, an injection refers to ibalizumab for the treatment of multidrug resistant HIV-1 infected patients. The company's pipeline products include F8 Formulation that could be used for the treatment of HIV-associated lipodystrophy; TH-1902 for the treatment of triple negative breast cancer; and TH-1904 for the treatment of ovarian cancer. The company was founded in 1993 and is headquartered in Montreal, Canada."
THTX,2019-11-30,NA,-12496000,NA,-12496000,34812000,31183000,-8513000,-8513000,-4825000,0,63216000,71729000,32033000,-3983000,NA,-12496000,-12496000,NA,income_statement,Drug Manufacturers—Specialty & Generic,Theratechnologies Inc.,"Theratechnologies Inc., a biopharmaceutical company, markets prescription products in the United States, Europe, and Canada. It offers EGRIFTA and EGRIFTA SV, for the reduction of excess abdominal fat in human immunodeficiency virus (HIV)-infected patients with lipodystrophy; and Trogarzo, an injection refers to ibalizumab for the treatment of multidrug resistant HIV-1 infected patients. The company's pipeline products include F8 Formulation that could be used for the treatment of HIV-associated lipodystrophy; TH-1902 for the treatment of triple negative breast cancer; and TH-1904 for the treatment of ovarian cancer. The company was founded in 1993 and is headquartered in Montreal, Canada."
TIG,2018-12-31,NA,25068000,NA,19522000,15706000,42774000,27068000,27068000,-1557000,5546000,78503000,51435000,35729000,-2000000,NA,19522000,19267000,NA,income_statement,Insurance—Specialty,"Trean Insurance Group, Inc.","Trean Insurance Group, Inc. provides insurance products and services focused on specialty casualty lines in the United States. The company underwrites specialty casualty insurance products through its program partners and owned managing general agents. Its insurance product offerings include workers' compensation, medical professional liability, accident and health, and other lines of business. The company also provides program partners with various services, including issuing carrier services, claims administration, and reinsurance brokerage. The company was founded in 1996 and is headquartered in Wayzata, Minnesota."
TIG,2019-12-31,NA,38359000,NA,31285000,21005000,57854000,36849000,36849000,-2169000,7074000,102515000,65666000,44661000,1510000,NA,31285000,31031000,NA,income_statement,Insurance—Specialty,"Trean Insurance Group, Inc.","Trean Insurance Group, Inc. provides insurance products and services focused on specialty casualty lines in the United States. The company underwrites specialty casualty insurance products through its program partners and owned managing general agents. Its insurance product offerings include workers' compensation, medical professional liability, accident and health, and other lines of business. The company also provides program partners with various services, including issuing carrier services, claims administration, and reinsurance brokerage. The company was founded in 1996 and is headquartered in Wayzata, Minnesota."
TIGO,2017-12-31,NA,172000000,185000000,87000000,1531000000,2767000000,441000000,441000000,-311000000,162000000,3936000000,3495000000,1169000000,-269000000,60000000,10000000,87000000,-17000000,income_statement,Telecom Services,Millicom International Cellular,"Millicom International Cellular S.A. provides cable and mobile services in Latin America and Africa. The company offers mobile services, including mobile data and voice; short message service; and mobile financial services, such as payments, money transfers, international remittances, savings, real-time loans, and micro-insurance. It also fixed services, including broadband, fixed voice, and pay-TV to residential consumers; and mobile, fixed, and value-added services to large, small, and medium businesses, as well as governmental entities. As of December 31, 2019, the company served 37.1 million business-to-consumer mobile customers; and 4.3 million connected homes. It markets its products and services under Tigo and Tigo Business brands. The company was founded in 1990 and is headquartered in Luxembourg."
TIGO,2018-12-31,NA,119000000,251000000,-10000000,1566000000,2829000000,474000000,474000000,-325000000,112000000,3946000000,3472000000,1117000000,-355000000,-33000000,7000000,-10000000,-13000000,income_statement,Telecom Services,Millicom International Cellular,"Millicom International Cellular S.A. provides cable and mobile services in Latin America and Africa. The company offers mobile services, including mobile data and voice; short message service; and mobile financial services, such as payments, money transfers, international remittances, savings, real-time loans, and micro-insurance. It also fixed services, including broadband, fixed voice, and pay-TV to residential consumers; and mobile, fixed, and value-added services to large, small, and medium businesses, as well as governmental entities. As of December 31, 2019, the company served 37.1 million business-to-consumer mobile customers; and 4.3 million connected homes. It markets its products and services under Tigo and Tigo Business brands. The company was founded in 1990 and is headquartered in Luxembourg."
TIGO,2019-12-31,NA,217000000,271000000,149000000,1588000000,3135000000,448000000,448000000,-505000000,120000000,4336000000,3888000000,1201000000,-231000000,57000000,97000000,149000000,-1000000,income_statement,Telecom Services,Millicom International Cellular,"Millicom International Cellular S.A. provides cable and mobile services in Latin America and Africa. The company offers mobile services, including mobile data and voice; short message service; and mobile financial services, such as payments, money transfers, international remittances, savings, real-time loans, and micro-insurance. It also fixed services, including broadband, fixed voice, and pay-TV to residential consumers; and mobile, fixed, and value-added services to large, small, and medium businesses, as well as governmental entities. As of December 31, 2019, the company served 37.1 million business-to-consumer mobile customers; and 4.3 million connected homes. It markets its products and services under Tigo and Tigo Business brands. The company was founded in 1990 and is headquartered in Luxembourg."
TIGO,2020-12-31,NA,-271000000,215000000,-344000000,1505000000,3000000000,255000000,255000000,-542000000,102000000,4171000000,3916000000,1171000000,-526000000,-12000000,-373000000,-344000000,32000000,income_statement,Telecom Services,Millicom International Cellular,"Millicom International Cellular S.A. provides cable and mobile services in Latin America and Africa. The company offers mobile services, including mobile data and voice; short message service; and mobile financial services, such as payments, money transfers, international remittances, savings, real-time loans, and micro-insurance. It also fixed services, including broadband, fixed voice, and pay-TV to residential consumers; and mobile, fixed, and value-added services to large, small, and medium businesses, as well as governmental entities. As of December 31, 2019, the company served 37.1 million business-to-consumer mobile customers; and 4.3 million connected homes. It markets its products and services under Tigo and Tigo Business brands. The company was founded in 1990 and is headquartered in Luxembourg."
TIGR,2016-12-31,NA,-13372997,110816,-10758453,15894076,3555796,0,-12338280,NA,-2561709,5475837,17814117,1920041,-1034717,NA,-10811288,-10758453,NA,income_statement,Capital Markets,UP Fintech Holding Limited,"UP Fintech Holding Limited provides online brokerage services focusing on Chinese investors. The company has developed a brokerage platform, which allows investor to trade stocks, options, warrants, and other financial instruments that can be accessed through its APP and website. It offers brokerage and value-added services, including trade order placement and execution, margin financing, account management, investor education, community discussion, and customer support. The company also provides asset management and wealth management; ESOP management; fund license application, product design, asset custody, transaction execution, and funding allocation; fund structuring and management; and IPO underwriting services. In addition, it offers market information, community engagement, investor education, and simulated trading services. UP Fintech Holding Limited was founded in 2014 and is based in Beijing, China."
TIGR,2017-12-31,NA,-9111192,-464878,-7510049,22983052,13967842,0,-9015210,NA,-1183698,16949184,25964394,2981342,-95982,NA,-7927494,-7510049,NA,income_statement,Capital Markets,UP Fintech Holding Limited,"UP Fintech Holding Limited provides online brokerage services focusing on Chinese investors. The company has developed a brokerage platform, which allows investor to trade stocks, options, warrants, and other financial instruments that can be accessed through its APP and website. It offers brokerage and value-added services, including trade order placement and execution, margin financing, account management, investor education, community discussion, and customer support. The company also provides asset management and wealth management; ESOP management; fund license application, product design, asset custody, transaction execution, and funding allocation; fund structuring and management; and IPO underwriting services. In addition, it offers market information, community engagement, investor education, and simulated trading services. UP Fintech Holding Limited was founded in 2014 and is based in Beijing, China."
TIGR,2018-12-31,NA,-46166668,733206,-43207732,44236718,29744604,0,-14492114,NA,-1873113,33560265,48052379,3815661,-31674554,NA,-44293555,-43207732,NA,income_statement,Capital Markets,UP Fintech Holding Limited,"UP Fintech Holding Limited provides online brokerage services focusing on Chinese investors. The company has developed a brokerage platform, which allows investor to trade stocks, options, warrants, and other financial instruments that can be accessed through its APP and website. It offers brokerage and value-added services, including trade order placement and execution, margin financing, account management, investor education, community discussion, and customer support. The company also provides asset management and wealth management; ESOP management; fund license application, product design, asset custody, transaction execution, and funding allocation; fund structuring and management; and IPO underwriting services. In addition, it offers market information, community engagement, investor education, and simulated trading services. UP Fintech Holding Limited was founded in 2014 and is based in Beijing, China."
TIGR,2019-12-31,NA,-9305224,3084122,-6589431,55345141,45548128,0,-9797013,NA,-3355366,54561372,64358385,9013244,491789,NA,-5949858,-6589431,NA,income_statement,Capital Markets,UP Fintech Holding Limited,"UP Fintech Holding Limited provides online brokerage services focusing on Chinese investors. The company has developed a brokerage platform, which allows investor to trade stocks, options, warrants, and other financial instruments that can be accessed through its APP and website. It offers brokerage and value-added services, including trade order placement and execution, margin financing, account management, investor education, community discussion, and customer support. The company also provides asset management and wealth management; ESOP management; fund license application, product design, asset custody, transaction execution, and funding allocation; fund structuring and management; and IPO underwriting services. In addition, it offers market information, community engagement, investor education, and simulated trading services. UP Fintech Holding Limited was founded in 2014 and is based in Beijing, China."
TILE,2017-01-01,14300000,79136000,NA,54162000,247403000,368644000,106941000,106941000,-6130000,24974000,958617000,851676000,589973000,-27805000,NA,54162000,54162000,5003000,income_statement,"Furnishings, Fixtures & Appliances","Interface, Inc.","Interface, Inc., a modular flooring company, designs, produces, and sells modular carpet products primarily in the Americas, Europe, and the Asia-Pacific. The company offers modular carpets under the Interface and FLOR band names; carpet tiles under the GlasBacRE name for use in commercial interiors, including offices, healthcare facilities, airports, educational and other institutions, hospitality spaces, and retail facilities, as well as residential interiors; modular resilient flooring products; rubber flooring under the norament and noraplan brand names ; and luxury vinyl tile products. It also produces and sells an adapted version of its carpet tile for the healthcare facilities market; and two-meter roll goods that are structure-backed for use in education, healthcare, and government markets, as well as carpet replacement, installation, and maintenance services. In addition, the company sells and licenses a proprietary antimicrobial chemical compound under the Intersept name for use in interior finishes; sells TacTiles, a carpet tile installation system, as well as various adhesives and products; and provides turnkey project management services for global accounts and other customers through its InterfaceSERVICES business. It sells its products directly to end-users, as well as indirectly through independent contractors or distributors; and FLOR line of products through Internet sales and commercial sales force. The company has product showrooms or design studios in the United States, Canada, Mexico, Brazil, Denmark, England, France, Germany, Spain, the Netherlands, India, Australia, Norway, the United Arab Emirates, Russia, Singapore, Hong Kong, Thailand, China, and others. Interface, Inc. was founded in 1973 and is headquartered in Atlanta, Georgia."
TILE,2017-12-31,14000000,100539000,NA,53246000,253151000,386021000,118870000,118870000,-7128000,47293000,996443000,877573000,610422000,-18331000,NA,53246000,53246000,5003000,income_statement,"Furnishings, Fixtures & Appliances","Interface, Inc.","Interface, Inc., a modular flooring company, designs, produces, and sells modular carpet products primarily in the Americas, Europe, and the Asia-Pacific. The company offers modular carpets under the Interface and FLOR band names; carpet tiles under the GlasBacRE name for use in commercial interiors, including offices, healthcare facilities, airports, educational and other institutions, hospitality spaces, and retail facilities, as well as residential interiors; modular resilient flooring products; rubber flooring under the norament and noraplan brand names ; and luxury vinyl tile products. It also produces and sells an adapted version of its carpet tile for the healthcare facilities market; and two-meter roll goods that are structure-backed for use in education, healthcare, and government markets, as well as carpet replacement, installation, and maintenance services. In addition, the company sells and licenses a proprietary antimicrobial chemical compound under the Intersept name for use in interior finishes; sells TacTiles, a carpet tile installation system, as well as various adhesives and products; and provides turnkey project management services for global accounts and other customers through its InterfaceSERVICES business. It sells its products directly to end-users, as well as indirectly through independent contractors or distributors; and FLOR line of products through Internet sales and commercial sales force. The company has product showrooms or design studios in the United States, Canada, Mexico, Brazil, Denmark, England, France, Germany, Spain, the Netherlands, India, Australia, Norway, the United Arab Emirates, Russia, Singapore, Hong Kong, Thailand, China, and others. Interface, Inc. was founded in 1973 and is headquartered in Atlanta, Georgia."
TILE,2018-12-30,16400000,54991000,NA,50253000,305749000,451023000,128874000,128874000,-15436000,4738000,1179573000,1050699000,728550000,-73883000,NA,50253000,50253000,5003000,income_statement,"Furnishings, Fixtures & Appliances","Interface, Inc.","Interface, Inc., a modular flooring company, designs, produces, and sells modular carpet products primarily in the Americas, Europe, and the Asia-Pacific. The company offers modular carpets under the Interface and FLOR band names; carpet tiles under the GlasBacRE name for use in commercial interiors, including offices, healthcare facilities, airports, educational and other institutions, hospitality spaces, and retail facilities, as well as residential interiors; modular resilient flooring products; rubber flooring under the norament and noraplan brand names ; and luxury vinyl tile products. It also produces and sells an adapted version of its carpet tile for the healthcare facilities market; and two-meter roll goods that are structure-backed for use in education, healthcare, and government markets, as well as carpet replacement, installation, and maintenance services. In addition, the company sells and licenses a proprietary antimicrobial chemical compound under the Intersept name for use in interior finishes; sells TacTiles, a carpet tile installation system, as well as various adhesives and products; and provides turnkey project management services for global accounts and other customers through its InterfaceSERVICES business. It sells its products directly to end-users, as well as indirectly through independent contractors or distributors; and FLOR line of products through Internet sales and commercial sales force. The company has product showrooms or design studios in the United States, Canada, Mexico, Brazil, Denmark, England, France, Germany, Spain, the Netherlands, India, Australia, Norway, the United Arab Emirates, Russia, Singapore, Hong Kong, Thailand, China, and others. Interface, Inc. was founded in 1973 and is headquartered in Atlanta, Georgia."
TILE,2019-12-29,17800000,101816000,NA,79200000,363804000,525454000,138847000,138847000,-25656000,22616000,1343029000,1204182000,817575000,-37031000,NA,79200000,79200000,5003000,income_statement,"Furnishings, Fixtures & Appliances","Interface, Inc.","Interface, Inc., a modular flooring company, designs, produces, and sells modular carpet products primarily in the Americas, Europe, and the Asia-Pacific. The company offers modular carpets under the Interface and FLOR band names; carpet tiles under the GlasBacRE name for use in commercial interiors, including offices, healthcare facilities, airports, educational and other institutions, hospitality spaces, and retail facilities, as well as residential interiors; modular resilient flooring products; rubber flooring under the norament and noraplan brand names ; and luxury vinyl tile products. It also produces and sells an adapted version of its carpet tile for the healthcare facilities market; and two-meter roll goods that are structure-backed for use in education, healthcare, and government markets, as well as carpet replacement, installation, and maintenance services. In addition, the company sells and licenses a proprietary antimicrobial chemical compound under the Intersept name for use in interior finishes; sells TacTiles, a carpet tile installation system, as well as various adhesives and products; and provides turnkey project management services for global accounts and other customers through its InterfaceSERVICES business. It sells its products directly to end-users, as well as indirectly through independent contractors or distributors; and FLOR line of products through Internet sales and commercial sales force. The company has product showrooms or design studios in the United States, Canada, Mexico, Brazil, Denmark, England, France, Germany, Spain, the Netherlands, India, Australia, Norway, the United Arab Emirates, Russia, Singapore, Hong Kong, Thailand, China, and others. Interface, Inc. was founded in 1973 and is headquartered in Atlanta, Georgia."
TIPT,2016-12-31,NA,49140000,96713000,25320000,125727000,303673000,100870000,100870000,-52043000,12515000,557710000,456840000,254037000,-51730000,-4287000,36625000,25096000,62631000,income_statement,Insurance—Specialty,Tiptree Inc.,"Tiptree Inc., through its subsidiaries, underwrites and administers specialty insurance products primarily in the United States. The company provides credit protection insurance, warranty and service contract products, and niche commercial and consumer insurance lines, as well as offers value-add services, including premium finance and business processing services. It also offers mortgage loans for institutional investors; and maritime transportation services, as well as invests in securities and other assets. Tiptree Inc. markets its products through a network of independent insurance brokers and managing general agencies. The company was formerly known as Tiptree Financial Inc. and changed its name to Tiptree Inc. in December 2016. Tiptree Inc. was founded in 2007 and is based in New York, New York."
TIPT,2017-12-31,NA,-3330000,96697000,3604000,126328000,237853000,37979000,37979000,-38948000,-12562000,603647000,565668000,365794000,-41309000,-3998000,9232000,3537000,59705000,income_statement,Insurance—Specialty,Tiptree Inc.,"Tiptree Inc., through its subsidiaries, underwrites and administers specialty insurance products primarily in the United States. The company provides credit protection insurance, warranty and service contract products, and niche commercial and consumer insurance lines, as well as offers value-add services, including premium finance and business processing services. It also offers mortgage loans for institutional investors; and maritime transportation services, as well as invests in securities and other assets. Tiptree Inc. markets its products through a network of independent insurance brokers and managing general agencies. The company was formerly known as Tiptree Financial Inc. and changed its name to Tiptree Inc. in December 2016. Tiptree Inc. was founded in 2007 and is based in New York, New York."
TIPT,2018-12-31,NA,-19796000,12158000,23933000,124671000,211271000,7645000,7645000,-27013000,-5909000,625826000,618181000,414555000,-27441000,43770000,-13887000,23933000,66359000,income_statement,Insurance—Specialty,Tiptree Inc.,"Tiptree Inc., through its subsidiaries, underwrites and administers specialty insurance products primarily in the United States. The company provides credit protection insurance, warranty and service contract products, and niche commercial and consumer insurance lines, as well as offers value-add services, including premium finance and business processing services. It also offers mortgage loans for institutional investors; and maritime transportation services, as well as invests in securities and other assets. Tiptree Inc. markets its products through a network of independent insurance brokers and managing general agencies. The company was formerly known as Tiptree Financial Inc. and changed its name to Tiptree Inc. in December 2016. Tiptree Inc. was founded in 2007 and is based in New York, New York."
TIPT,2019-12-31,NA,29139000,13353000,18361000,142121000,291392000,49841000,49841000,-27059000,9017000,765130000,715289000,473738000,-20702000,NA,20122000,17889000,85861000,income_statement,Insurance—Specialty,Tiptree Inc.,"Tiptree Inc., through its subsidiaries, underwrites and administers specialty insurance products primarily in the United States. The company provides credit protection insurance, warranty and service contract products, and niche commercial and consumer insurance lines, as well as offers value-add services, including premium finance and business processing services. It also offers mortgage loans for institutional investors; and maritime transportation services, as well as invests in securities and other assets. Tiptree Inc. markets its products through a network of independent insurance brokers and managing general agencies. The company was formerly known as Tiptree Financial Inc. and changed its name to Tiptree Inc. in December 2016. Tiptree Inc. was founded in 2007 and is based in New York, New York."
TIRX,2017-10-31,NA,1131576,478,963324,278361,1394173,1115812,1115812,-22891,168252,1531223,415411,137050,15764,NA,963324,963324,NA,income_statement,Insurance Brokers,TIAN RUIXIANG Holdings Ltd,"TIAN RUIXIANG Holdings Ltd, headquartered in Beijing, China, is an insurance broker operating in China. It distributes a wide range of insurance products, which are categorized into two major groups: (1) property and casualty insurance, such as automobile insurance, commercial property insurance, liability insurance; and (2) life insurance, such as individual and group life insurances. For more information, visit the Company's website at http://ir.tianrx.com/."
TIRX,2018-10-31,NA,1486630,478,1121429,1462444,2921661,1459217,1459217,-22891,365192,3087708,1628491,166047,27413,NA,1121438,1121429,NA,income_statement,Insurance Brokers,TIAN RUIXIANG Holdings Ltd,"TIAN RUIXIANG Holdings Ltd, headquartered in Beijing, China, is an insurance broker operating in China. It distributes a wide range of insurance products, which are categorized into two major groups: (1) property and casualty insurance, such as automobile insurance, commercial property insurance, liability insurance; and (2) life insurance, such as individual and group life insurances. For more information, visit the Company's website at http://ir.tianrx.com/."
TIRX,2019-10-31,NA,413995,474,175787,1248057,1350727,102670,102670,-18831,238208,2002217,1899547,651490,311325,NA,175787,175787,NA,income_statement,Insurance Brokers,TIAN RUIXIANG Holdings Ltd,"TIAN RUIXIANG Holdings Ltd, headquartered in Beijing, China, is an insurance broker operating in China. It distributes a wide range of insurance products, which are categorized into two major groups: (1) property and casualty insurance, such as automobile insurance, commercial property insurance, liability insurance; and (2) life insurance, such as individual and group life insurances. For more information, visit the Company's website at http://ir.tianrx.com/."
TJX,2017-01-28,NA,3723043000,NA,2298234000,5768467000,9617990000,3849523000,3849523000,-61671000,1424809000,33183744000,29334221000,23565754000,-126480000,NA,2298234000,2298234000,NA,income_statement,NA,NA,NA
TJX,2018-02-03,NA,3856588000,NA,2607948000,6375071000,10362497000,3987426000,3987426000,-64295000,1248640000,35864664000,31877238000,25502167000,-130838000,NA,2607948000,2607948000,NA,income_statement,NA,NA,NA
TJX,2019-02-02,NA,4173211000,NA,3059798000,6923564000,11141757000,4218193000,4218193000,-64839000,1113413000,38972934000,34754741000,27831177000,-44982000,NA,3059798000,3059798000,NA,income_statement,NA,NA,NA
TJX,2020-02-01,NA,4406183000,NA,3272193000,10433826000,14850035000,4416209000,4416209000,-59086000,1133990000,41716977000,37300768000,26866942000,-10026000,NA,3272193000,3272193000,NA,income_statement,NA,NA,NA
TLC,2017-12-31,813252000,-873011000,425405000,-873962000,134869000,49635000,-898486000,-898486000,-3385000,951000,49635000,948121000,0,25475000,NA,-873962000,-873962000,NA,income_statement,Biotechnology,"Taiwan Liposome Company, Ltd.","Taiwan Liposome Company, Ltd., a clinical-stage specialty pharmaceutical company, engages in the development and commercialization of nanomedicines that combine its proprietary lipid-assembled drug delivery platform with approved active pharmaceutical ingredients (APIs). Its BioSeizer lipid formulation technology enables pharmacokinetic (PK) control and local sustained release of APIs at the site of disease or injury; and NanoX active drug loading technology enables the potential for reduced dosing frequency and enhanced distribution of liposome-encapsulated APIs to the desired site. The company provides various product candidates that target various areas of unmet medical need in pain management, ophthalmology, and oncology. Its lead product candidate is TLC599, an intraarticular injectable BioSeizer formulation of the API steroid dexamethasone sodium phosphate (DSP), which is in Phase III trial for knee osteoarthritis pain. The company's product candidates also comprises TLC590, a non-opioid BioSeizer formulation of the API ropivacaine that is in Phase II clinical trial for post-surgical pain management; TLC399, a multilamellar and multivesicular BioSeizer formulation of DSP, which is in Phase II clinical trial for ophthalmology indications; and TLC178, an API that is in Phase I/II dose escalation trial to treat rhabdomyosarcoma. Taiwan Liposome Company, Ltd. was founded in 1997 and is headquartered in Taipei, Taiwan."
TLC,2018-12-31,832575000,-900707000,425405000,-901574000,147743000,62324000,-917994000,-917994000,-9886000,867000,62324000,980318000,0,17287000,NA,-901574000,-901574000,NA,income_statement,Biotechnology,"Taiwan Liposome Company, Ltd.","Taiwan Liposome Company, Ltd., a clinical-stage specialty pharmaceutical company, engages in the development and commercialization of nanomedicines that combine its proprietary lipid-assembled drug delivery platform with approved active pharmaceutical ingredients (APIs). Its BioSeizer lipid formulation technology enables pharmacokinetic (PK) control and local sustained release of APIs at the site of disease or injury; and NanoX active drug loading technology enables the potential for reduced dosing frequency and enhanced distribution of liposome-encapsulated APIs to the desired site. The company provides various product candidates that target various areas of unmet medical need in pain management, ophthalmology, and oncology. Its lead product candidate is TLC599, an intraarticular injectable BioSeizer formulation of the API steroid dexamethasone sodium phosphate (DSP), which is in Phase III trial for knee osteoarthritis pain. The company's product candidates also comprises TLC590, a non-opioid BioSeizer formulation of the API ropivacaine that is in Phase II clinical trial for post-surgical pain management; TLC399, a multilamellar and multivesicular BioSeizer formulation of DSP, which is in Phase II clinical trial for ophthalmology indications; and TLC178, an API that is in Phase I/II dose escalation trial to treat rhabdomyosarcoma. Taiwan Liposome Company, Ltd. was founded in 1997 and is headquartered in Taipei, Taiwan."
TLC,2019-12-31,860419000,-803402000,425405000,-807522000,166377000,209140000,-817656000,-817656000,-23656000,4120000,209140000,1026796000,0,14254000,NA,-807522000,-807522000,NA,income_statement,Biotechnology,"Taiwan Liposome Company, Ltd.","Taiwan Liposome Company, Ltd., a clinical-stage specialty pharmaceutical company, engages in the development and commercialization of nanomedicines that combine its proprietary lipid-assembled drug delivery platform with approved active pharmaceutical ingredients (APIs). Its BioSeizer lipid formulation technology enables pharmacokinetic (PK) control and local sustained release of APIs at the site of disease or injury; and NanoX active drug loading technology enables the potential for reduced dosing frequency and enhanced distribution of liposome-encapsulated APIs to the desired site. The company provides various product candidates that target various areas of unmet medical need in pain management, ophthalmology, and oncology. Its lead product candidate is TLC599, an intraarticular injectable BioSeizer formulation of the API steroid dexamethasone sodium phosphate (DSP), which is in Phase III trial for knee osteoarthritis pain. The company's product candidates also comprises TLC590, a non-opioid BioSeizer formulation of the API ropivacaine that is in Phase II clinical trial for post-surgical pain management; TLC399, a multilamellar and multivesicular BioSeizer formulation of DSP, which is in Phase II clinical trial for ophthalmology indications; and TLC178, an API that is in Phase I/II dose escalation trial to treat rhabdomyosarcoma. Taiwan Liposome Company, Ltd. was founded in 1997 and is headquartered in Taipei, Taiwan."
TLC,2020-12-31,967503000,-982177000,425405000,-981517000,145769000,101928000,-1011344000,-1011344000,-17051000,1132000,101928000,1113272000,0,29167000,NA,-983309000,-981517000,NA,income_statement,Biotechnology,"Taiwan Liposome Company, Ltd.","Taiwan Liposome Company, Ltd., a clinical-stage specialty pharmaceutical company, engages in the development and commercialization of nanomedicines that combine its proprietary lipid-assembled drug delivery platform with approved active pharmaceutical ingredients (APIs). Its BioSeizer lipid formulation technology enables pharmacokinetic (PK) control and local sustained release of APIs at the site of disease or injury; and NanoX active drug loading technology enables the potential for reduced dosing frequency and enhanced distribution of liposome-encapsulated APIs to the desired site. The company provides various product candidates that target various areas of unmet medical need in pain management, ophthalmology, and oncology. Its lead product candidate is TLC599, an intraarticular injectable BioSeizer formulation of the API steroid dexamethasone sodium phosphate (DSP), which is in Phase III trial for knee osteoarthritis pain. The company's product candidates also comprises TLC590, a non-opioid BioSeizer formulation of the API ropivacaine that is in Phase II clinical trial for post-surgical pain management; TLC399, a multilamellar and multivesicular BioSeizer formulation of DSP, which is in Phase II clinical trial for ophthalmology indications; and TLC178, an API that is in Phase I/II dose escalation trial to treat rhabdomyosarcoma. Taiwan Liposome Company, Ltd. was founded in 1997 and is headquartered in Taipei, Taiwan."
TLGT,2016-12-31,NA,-11698000,NA,-11985000,15005000,17547000,2542000,2542000,-13304000,287000,63012000,60470000,45465000,-14240000,NA,-11985000,-11985000,NA,income_statement,Drug Manufacturers—Specialty & Generic,"Teligent, Inc.","Teligent, Inc., a specialty generic pharmaceutical company, develops, manufactures, markets, and sells generic topical, branded generic, and generic injectable pharmaceutical products in the United States and Canada. The company offers generic pharmaceutical products in topical, injectable, complex, and ophthalmic dosage forms. It is also involved in contract manufacturing and development business, including the development, manufacturing, filling, and package of topical semi-solid and liquid products for branded and generic pharmaceutical customers, as well as for over-the-counter and cosmetic markets. The company's topical semi-solid and liquid products are used in various applications that range from cosmetics and cosmeceuticals; and the prescription treatment of conditions, such as dermatitis, psoriasis, and eczema. It sells its products through national chain drug stores, drug wholesalers, distributors, and group purchasing organizations. The company was formerly known as IGI Laboratories, Inc. and changed its name to Teligent, Inc. in October 2015. Teligent, Inc. was founded in 1977 and is based in Buena, New Jersey."
TLGT,2017-12-31,NA,-15276000,NA,-15191000,19791000,8107000,-11684000,-11684000,-11198000,-85000,60202000,71886000,52095000,-3592000,NA,-15191000,-15191000,NA,income_statement,Drug Manufacturers—Specialty & Generic,"Teligent, Inc.","Teligent, Inc., a specialty generic pharmaceutical company, develops, manufactures, markets, and sells generic topical, branded generic, and generic injectable pharmaceutical products in the United States and Canada. The company offers generic pharmaceutical products in topical, injectable, complex, and ophthalmic dosage forms. It is also involved in contract manufacturing and development business, including the development, manufacturing, filling, and package of topical semi-solid and liquid products for branded and generic pharmaceutical customers, as well as for over-the-counter and cosmetic markets. The company's topical semi-solid and liquid products are used in various applications that range from cosmetics and cosmeceuticals; and the prescription treatment of conditions, such as dermatitis, psoriasis, and eczema. It sells its products through national chain drug stores, drug wholesalers, distributors, and group purchasing organizations. The company was formerly known as IGI Laboratories, Inc. and changed its name to Teligent, Inc. in October 2015. Teligent, Inc. was founded in 1977 and is based in Buena, New Jersey."
TLGT,2018-12-31,NA,-36318000,NA,-36256000,21484000,8309000,-13175000,-13175000,-12298000,-62000,65865000,79040000,57556000,-23143000,NA,-36256000,-36256000,NA,income_statement,Drug Manufacturers—Specialty & Generic,"Teligent, Inc.","Teligent, Inc., a specialty generic pharmaceutical company, develops, manufactures, markets, and sells generic topical, branded generic, and generic injectable pharmaceutical products in the United States and Canada. The company offers generic pharmaceutical products in topical, injectable, complex, and ophthalmic dosage forms. It is also involved in contract manufacturing and development business, including the development, manufacturing, filling, and package of topical semi-solid and liquid products for branded and generic pharmaceutical customers, as well as for over-the-counter and cosmetic markets. The company's topical semi-solid and liquid products are used in various applications that range from cosmetics and cosmeceuticals; and the prescription treatment of conditions, such as dermatitis, psoriasis, and eczema. It sells its products through national chain drug stores, drug wholesalers, distributors, and group purchasing organizations. The company was formerly known as IGI Laboratories, Inc. and changed its name to Teligent, Inc. in October 2015. Teligent, Inc. was founded in 1977 and is based in Buena, New Jersey."
TLGT,2019-12-31,NA,-25033000,NA,-25124000,20785000,12765000,-8020000,-8020000,-21154000,91000,65896000,73916000,53131000,-17013000,NA,-25124000,-25124000,NA,income_statement,Drug Manufacturers—Specialty & Generic,"Teligent, Inc.","Teligent, Inc., a specialty generic pharmaceutical company, develops, manufactures, markets, and sells generic topical, branded generic, and generic injectable pharmaceutical products in the United States and Canada. The company offers generic pharmaceutical products in topical, injectable, complex, and ophthalmic dosage forms. It is also involved in contract manufacturing and development business, including the development, manufacturing, filling, and package of topical semi-solid and liquid products for branded and generic pharmaceutical customers, as well as for over-the-counter and cosmetic markets. The company's topical semi-solid and liquid products are used in various applications that range from cosmetics and cosmeceuticals; and the prescription treatment of conditions, such as dermatitis, psoriasis, and eczema. It sells its products through national chain drug stores, drug wholesalers, distributors, and group purchasing organizations. The company was formerly known as IGI Laboratories, Inc. and changed its name to Teligent, Inc. in October 2015. Teligent, Inc. was founded in 1977 and is based in Buena, New Jersey."
TLIS,2018-12-31,NA,-21337000,NA,-21337000,5432000,-15998000,-21430000,-21430000,NA,0,2390000,23820000,18388000,93000,NA,-21337000,-21337000,NA,income_statement,Medical Devices,Talis Biomedical Corporation,"Talis Biomedical Corporation develops a diagnostic platform that offers senior care facilities and laboratory testing services. Talis Biomedical Corporation was formerly known as Talis Biomedical, Inc. and changed its name to Talis Biomedical Corporation in February 2018. The company was founded in 2010 and is based in Menlo Park, California with an additional office in Chicago, Illinois."
TLIS,2019-12-31,NA,-27474000,NA,-27474000,6864000,-19835000,-26699000,-26699000,NA,0,3977000,30676000,23812000,-775000,NA,-27474000,26382000,NA,income_statement,Medical Devices,Talis Biomedical Corporation,"Talis Biomedical Corporation develops a diagnostic platform that offers senior care facilities and laboratory testing services. Talis Biomedical Corporation was formerly known as Talis Biomedical, Inc. and changed its name to Talis Biomedical Corporation in February 2018. The company was founded in 2010 and is based in Menlo Park, California with an additional office in Chicago, Illinois."
TLMD,2018-12-31,1778000,-19824000,NA,-18064000,30525000,23383000,-8920000,-8920000,-7607000,-1760000,53712000,62632000,30329000,-10904000,NA,-18064000,-22197000,NA,income_statement,Medical Care Facilities,"SOC Telemed, Inc.","SOC Telemed, Inc. provides telemedicine technology and solutions to hospitals, health systems, post-acute providers, physician networks, and value-based care organizations in the United States. The company's technology platform, Telemed IQ, provides telemedicine programs. Its telemedicine solutions include teleNeurology, telePsychiatry, and teleICU. The company was founded in 2004 and is based in Reston, Virginia."
TLMD,2019-12-31,1099000,-18234000,NA,-18242000,31445000,26187000,-6357000,-6357000,-10308000,8000,66200000,72557000,40013000,-11877000,NA,-18242000,-23756000,NA,income_statement,Medical Care Facilities,"SOC Telemed, Inc.","SOC Telemed, Inc. provides telemedicine technology and solutions to hospitals, health systems, post-acute providers, physician networks, and value-based care organizations in the United States. The company's technology platform, Telemed IQ, provides telemedicine programs. Its telemedicine solutions include teleNeurology, telePsychiatry, and teleICU. The company was founded in 2004 and is based in Reston, Virginia."
TLND,2017-12-31,26835000,-30884000,NA,-31208000,116338000,114436000,-28737000,-28737000,-2540000,324000,148595000,177332000,34159000,-2147000,NA,-31208000,-31208000,NA,income_statement,Software—Infrastructure,Talend S.A.,"Talend S.A. provides data integration and integrity solutions for various industries in the Americas, Europe, the Middle East, Africa, and the Asia Pacific. It designs and develops Talend Data Fabric, a software platform that integrates data and applications in real time across big data and cloud environments, as well as traditional systems, which allows organizations to develop a unified view of their business and customers. The company's Talend Data Fabric platform includes data ingestion, data integration, big data integration, application and cloud integration, data catalogue, and API design and testing, as well as self-service data preparation products; and Stitch Data Loader, a cloud-based data ingestion engine. It also provides professional services, such as strategic enterprise architecture advisory services, implementation support, and private technical training courses. The company sells its products directly to customers through its sales force, as well as through indirectly channel partners. Talend S.A. has a strategic partnership with HVR for integrating data for business operations and analytics. The company was founded in 2005 and is headquartered in Suresnes, France."
TLND,2018-12-31,42359000,-39350000,NA,-39027000,153451000,156305000,-39505000,-39505000,-2540000,-323000,205799000,245304000,49494000,155000,NA,-39027000,-39027000,NA,income_statement,Software—Infrastructure,Talend S.A.,"Talend S.A. provides data integration and integrity solutions for various industries in the Americas, Europe, the Middle East, Africa, and the Asia Pacific. It designs and develops Talend Data Fabric, a software platform that integrates data and applications in real time across big data and cloud environments, as well as traditional systems, which allows organizations to develop a unified view of their business and customers. The company's Talend Data Fabric platform includes data ingestion, data integration, big data integration, application and cloud integration, data catalogue, and API design and testing, as well as self-service data preparation products; and Stitch Data Loader, a cloud-based data ingestion engine. It also provides professional services, such as strategic enterprise architecture advisory services, implementation support, and private technical training courses. The company sells its products directly to customers through its sales force, as well as through indirectly channel partners. Talend S.A. has a strategic partnership with HVR for integrating data for business operations and analytics. The company was founded in 2005 and is headquartered in Suresnes, France."
TLND,2019-12-31,63017000,-61320000,NA,-61469000,182488000,186981000,-58524000,-58524000,-2540000,149000,247861000,306385000,60880000,-2796000,NA,-61469000,-61469000,NA,income_statement,Software—Infrastructure,Talend S.A.,"Talend S.A. provides data integration and integrity solutions for various industries in the Americas, Europe, the Middle East, Africa, and the Asia Pacific. It designs and develops Talend Data Fabric, a software platform that integrates data and applications in real time across big data and cloud environments, as well as traditional systems, which allows organizations to develop a unified view of their business and customers. The company's Talend Data Fabric platform includes data ingestion, data integration, big data integration, application and cloud integration, data catalogue, and API design and testing, as well as self-service data preparation products; and Stitch Data Loader, a cloud-based data ingestion engine. It also provides professional services, such as strategic enterprise architecture advisory services, implementation support, and private technical training courses. The company sells its products directly to customers through its sales force, as well as through indirectly channel partners. Talend S.A. has a strategic partnership with HVR for integrating data for business operations and analytics. The company was founded in 2005 and is headquartered in Suresnes, France."
TLND,2020-12-31,69503000,-79009000,NA,-79582000,225662000,224323000,-70842000,-70842000,-7882000,573000,287471000,358313000,63148000,-8167000,NA,-79582000,-79582000,NA,income_statement,Software—Infrastructure,Talend S.A.,"Talend S.A. provides data integration and integrity solutions for various industries in the Americas, Europe, the Middle East, Africa, and the Asia Pacific. It designs and develops Talend Data Fabric, a software platform that integrates data and applications in real time across big data and cloud environments, as well as traditional systems, which allows organizations to develop a unified view of their business and customers. The company's Talend Data Fabric platform includes data ingestion, data integration, big data integration, application and cloud integration, data catalogue, and API design and testing, as well as self-service data preparation products; and Stitch Data Loader, a cloud-based data ingestion engine. It also provides professional services, such as strategic enterprise architecture advisory services, implementation support, and private technical training courses. The company sells its products directly to customers through its sales force, as well as through indirectly channel partners. Talend S.A. has a strategic partnership with HVR for integrating data for business operations and analytics. The company was founded in 2005 and is headquartered in Suresnes, France."
TLRY,2017-12-31,3171000,-7809000,NA,-7809000,14663000,11377000,-7498000,-7498000,-1686000,0,20538000,28036000,9161000,-311000,NA,-7809000,-7809000,NA,income_statement,Drug Manufacturers—Specialty & Generic,"Tilray, Inc. - Class 2","Tilray, Inc. engages in the research, cultivation, processing, and distribution of medical cannabis. The company offers its products to patients, physicians, pharmacies, governments, and hospitals; and for researchers for commercial purposes, as well as compassionate access and clinical research applications. It operates in Argentina, Australia, Canada, Chile, Croatia, Cyprus, the Czech Republic, Germany, Israel, Ireland, New Zealand, South Africa, Switzerland, the United States, and the United Kingdom. The company was incorporated in 2018 and is headquartered in Nanaimo, Canada."
TLRY,2018-12-31,4264000,-72174000,NA,-67723000,44827000,14275000,-57402000,-57402000,-9110000,-4451000,41930000,99332000,27655000,-14772000,NA,-67723000,-67723000,NA,income_statement,Drug Manufacturers—Specialty & Generic,"Tilray, Inc. - Class 2","Tilray, Inc. engages in the research, cultivation, processing, and distribution of medical cannabis. The company offers its products to patients, physicians, pharmacies, governments, and hospitals; and for researchers for commercial purposes, as well as compassionate access and clinical research applications. It operates in Argentina, Australia, Canada, Chile, Croatia, Cyprus, the Czech Republic, Germany, Israel, Ireland, New Zealand, South Africa, Switzerland, the United States, and the United Kingdom. The company was incorporated in 2018 and is headquartered in Nanaimo, Canada."
TLRY,2019-12-31,6558000,-329619000,NA,-321169000,136462000,-21455000,-207924000,-207924000,-34690000,-8450000,153843000,361767000,175298000,-121695000,NA,-321169000,-321169000,NA,income_statement,Drug Manufacturers—Specialty & Generic,"Tilray, Inc. - Class 2","Tilray, Inc. engages in the research, cultivation, processing, and distribution of medical cannabis. The company offers its products to patients, physicians, pharmacies, governments, and hospitals; and for researchers for commercial purposes, as well as compassionate access and clinical research applications. It operates in Argentina, Australia, Canada, Chile, Croatia, Cyprus, the Czech Republic, Germany, Israel, Ireland, New Zealand, South Africa, Switzerland, the United States, and the United Kingdom. The company was incorporated in 2018 and is headquartered in Nanaimo, Canada."
TLRY,2020-12-31,4411000,-276675000,NA,-271073000,140549000,24655000,-134027000,-134027000,-39219000,-5602000,210482000,344509000,185827000,-142648000,NA,-271073000,-271073000,NA,income_statement,Drug Manufacturers—Specialty & Generic,"Tilray, Inc. - Class 2","Tilray, Inc. engages in the research, cultivation, processing, and distribution of medical cannabis. The company offers its products to patients, physicians, pharmacies, governments, and hospitals; and for researchers for commercial purposes, as well as compassionate access and clinical research applications. It operates in Argentina, Australia, Canada, Chile, Croatia, Cyprus, the Czech Republic, Germany, Israel, Ireland, New Zealand, South Africa, Switzerland, the United States, and the United Kingdom. The company was incorporated in 2018 and is headquartered in Nanaimo, Canada."
TLS,2016-12-31,NA,-3335000,2229000,-7175000,41334000,43446000,2112000,2112000,-5465000,334000,134868000,132756000,91422000,-5447000,NA,-3669000,-7175000,NA,income_statement,Information Technology Services,Telos Corporation,"Telos Corporation, together with its subsidiaries, provides information technology (IT) solutions and services worldwide. The company offers solutions that secure cyberspace, the cloud environment, and the people and operations of the enterprise. It provides Xacta, a premier solution for continuous assessment and authorization, which is used by the department of defense (DoD), intelligence communities, and civilian government, as well as by commercial businesses; enterprise cloud services, including engineering, migration, security, and managed services; and Telos Ghost, a cybersecurity solution that gives organizations an anonymous way to do business, connect with global resources, and conduct research online for intelligence gathering, cyber threat protection, securing critical infrastructure, and protecting communications and applications. The company also streamlines and automates the process of selecting, applying, and monitoring security controls for cloud-based systems and applications; assesses, designs, and delivers identity and access solutions to protect national security assets, people, and facilities; and issues smart card-based secure credentials for active duty uniformed service personnel, selected reserve, DoD civilian employees, and eligible contractor personnel. In addition, it offers secure mobility solutions that reduce the risk and assures safe communication across the enterprise and world; Telos Automated Message Handling System, which protects and enhances the communications; real-time data collection on personnel movement and location information for operating forces, government civil servants, and government contractors; and nationwide identity verification, fingerprinting, and photo services. The company was incorporated in 1971 and is based in Ashburn, Virginia."
TLS,2017-12-31,NA,-6265000,913000,-5833000,40152000,40566000,414000,414000,-6690000,-2767000,107727000,107313000,67161000,-6679000,NA,-3498000,-5833000,NA,income_statement,Information Technology Services,Telos Corporation,"Telos Corporation, together with its subsidiaries, provides information technology (IT) solutions and services worldwide. The company offers solutions that secure cyberspace, the cloud environment, and the people and operations of the enterprise. It provides Xacta, a premier solution for continuous assessment and authorization, which is used by the department of defense (DoD), intelligence communities, and civilian government, as well as by commercial businesses; enterprise cloud services, including engineering, migration, security, and managed services; and Telos Ghost, a cybersecurity solution that gives organizations an anonymous way to do business, connect with global resources, and conduct research online for intelligence gathering, cyber threat protection, securing critical infrastructure, and protecting communications and applications. The company also streamlines and automates the process of selecting, applying, and monitoring security controls for cloud-based systems and applications; assesses, designs, and delivers identity and access solutions to protect national security assets, people, and facilities; and issues smart card-based secure credentials for active duty uniformed service personnel, selected reserve, DoD civilian employees, and eligible contractor personnel. In addition, it offers secure mobility solutions that reduce the risk and assures safe communication across the enterprise and world; Telos Automated Message Handling System, which protects and enhances the communications; real-time data collection on personnel movement and location information for operating forces, government civil servants, and government contractors; and nationwide identity verification, fingerprinting, and photo services. The company was incorporated in 1971 and is based in Ashburn, Virginia."
TLS,2018-12-31,NA,1768000,2621000,-1640000,44048000,53062000,9014000,9014000,-7258000,31000,138016000,129002000,84954000,-7246000,NA,1737000,-1640000,NA,income_statement,Information Technology Services,Telos Corporation,"Telos Corporation, together with its subsidiaries, provides information technology (IT) solutions and services worldwide. The company offers solutions that secure cyberspace, the cloud environment, and the people and operations of the enterprise. It provides Xacta, a premier solution for continuous assessment and authorization, which is used by the department of defense (DoD), intelligence communities, and civilian government, as well as by commercial businesses; enterprise cloud services, including engineering, migration, security, and managed services; and Telos Ghost, a cybersecurity solution that gives organizations an anonymous way to do business, connect with global resources, and conduct research online for intelligence gathering, cyber threat protection, securing critical infrastructure, and protecting communications and applications. The company also streamlines and automates the process of selecting, applying, and monitoring security controls for cloud-based systems and applications; assesses, designs, and delivers identity and access solutions to protect national security assets, people, and facilities; and issues smart card-based secure credentials for active duty uniformed service personnel, selected reserve, DoD civilian employees, and eligible contractor personnel. In addition, it offers secure mobility solutions that reduce the risk and assures safe communication across the enterprise and world; Telos Automated Message Handling System, which protects and enhances the communications; real-time data collection on personnel movement and location information for operating forces, government civil servants, and government contractors; and nationwide identity verification, fingerprinting, and photo services. The company was incorporated in 1971 and is based in Ashburn, Virginia."
TLS,2019-12-31,NA,-2241000,4514000,-6401000,47319000,52344000,5025000,5025000,-7467000,-104000,159218000,154193000,106874000,-7266000,NA,-2137000,-6401000,NA,income_statement,Information Technology Services,Telos Corporation,"Telos Corporation, together with its subsidiaries, provides information technology (IT) solutions and services worldwide. The company offers solutions that secure cyberspace, the cloud environment, and the people and operations of the enterprise. It provides Xacta, a premier solution for continuous assessment and authorization, which is used by the department of defense (DoD), intelligence communities, and civilian government, as well as by commercial businesses; enterprise cloud services, including engineering, migration, security, and managed services; and Telos Ghost, a cybersecurity solution that gives organizations an anonymous way to do business, connect with global resources, and conduct research online for intelligence gathering, cyber threat protection, securing critical infrastructure, and protecting communications and applications. The company also streamlines and automates the process of selecting, applying, and monitoring security controls for cloud-based systems and applications; assesses, designs, and delivers identity and access solutions to protect national security assets, people, and facilities; and issues smart card-based secure credentials for active duty uniformed service personnel, selected reserve, DoD civilian employees, and eligible contractor personnel. In addition, it offers secure mobility solutions that reduce the risk and assures safe communication across the enterprise and world; Telos Automated Message Handling System, which protects and enhances the communications; real-time data collection on personnel movement and location information for operating forces, government civil servants, and government contractors; and nationwide identity verification, fingerprinting, and photo services. The company was incorporated in 1971 and is based in Ashburn, Virginia."
TLSA,2016-12-31,2956000,-7297000,NA,-7208000,4332000,0,-7288000,-7288000,-9000,-89000,0,7288000,0,-9000,NA,-7208000,-7208000,NA,income_statement,Biotechnology,Tiziana Life Sciences plc - Ame,"Tiziana Life Sciences Plc, a clinical stage biotechnology company, focuses on the discovery and development of molecules and related diagnostics to treat diseases in oncology and immunology in the United Kingdom. The company's product pipeline includes Foralumab (TZLS-401), a human anti-CD3 monclonal antibody for the treatment of autoimmune and inflammatory diseases, such GvHD, ulcerative colitis, Crohn's disease, multiple sclerosis, type-1 diabetes, inflammatory bowel diseases, psoriasis, and rheumatoid arthritis; and Milciclib (TZLS-201), which is an orally bioavailable, small molecule inhibitor of cyclin-dependent kinases and Src family kinases for the treatment of hepatocellular carcinoma. It also develops Anti IL-6r (TZLS-501), a human anti-interleukin-6 receptor monoclonal antibody for the treatment of IL6-induced inflammation, primarily to treat hospitalized COVID-19 patients with severe respiratory symptoms; and StemPrintER, a multi-gene signature assay intended for use in patients diagnosed with estrogen-receptor positive ER+/HER2 negative breast cancers. The company was founded in 2013 and is headquartered in London, the United Kingdom. Tiziana Life Sciences Plc is a subsidiary of Planwise Group Limited."
TLSA,2017-12-31,6015000,-10505000,NA,-8593000,4478000,0,-10493000,-10493000,-12000,-1912000,0,10493000,0,-12000,NA,-8593000,-8593000,NA,income_statement,Biotechnology,Tiziana Life Sciences plc - Ame,"Tiziana Life Sciences Plc, a clinical stage biotechnology company, focuses on the discovery and development of molecules and related diagnostics to treat diseases in oncology and immunology in the United Kingdom. The company's product pipeline includes Foralumab (TZLS-401), a human anti-CD3 monclonal antibody for the treatment of autoimmune and inflammatory diseases, such GvHD, ulcerative colitis, Crohn's disease, multiple sclerosis, type-1 diabetes, inflammatory bowel diseases, psoriasis, and rheumatoid arthritis; and Milciclib (TZLS-201), which is an orally bioavailable, small molecule inhibitor of cyclin-dependent kinases and Src family kinases for the treatment of hepatocellular carcinoma. It also develops Anti IL-6r (TZLS-501), a human anti-interleukin-6 receptor monoclonal antibody for the treatment of IL6-induced inflammation, primarily to treat hospitalized COVID-19 patients with severe respiratory symptoms; and StemPrintER, a multi-gene signature assay intended for use in patients diagnosed with estrogen-receptor positive ER+/HER2 negative breast cancers. The company was founded in 2013 and is headquartered in London, the United Kingdom. Tiziana Life Sciences Plc is a subsidiary of Planwise Group Limited."
TLSA,2018-12-31,5510000,-9879000,NA,-7934000,4357000,0,-9867000,-9867000,-12000,-1945000,0,9867000,0,-12000,NA,-7934000,-7934000,NA,income_statement,Biotechnology,Tiziana Life Sciences plc - Ame,"Tiziana Life Sciences Plc, a clinical stage biotechnology company, focuses on the discovery and development of molecules and related diagnostics to treat diseases in oncology and immunology in the United Kingdom. The company's product pipeline includes Foralumab (TZLS-401), a human anti-CD3 monclonal antibody for the treatment of autoimmune and inflammatory diseases, such GvHD, ulcerative colitis, Crohn's disease, multiple sclerosis, type-1 diabetes, inflammatory bowel diseases, psoriasis, and rheumatoid arthritis; and Milciclib (TZLS-201), which is an orally bioavailable, small molecule inhibitor of cyclin-dependent kinases and Src family kinases for the treatment of hepatocellular carcinoma. It also develops Anti IL-6r (TZLS-501), a human anti-interleukin-6 receptor monoclonal antibody for the treatment of IL6-induced inflammation, primarily to treat hospitalized COVID-19 patients with severe respiratory symptoms; and StemPrintER, a multi-gene signature assay intended for use in patients diagnosed with estrogen-receptor positive ER+/HER2 negative breast cancers. The company was founded in 2013 and is headquartered in London, the United Kingdom. Tiziana Life Sciences Plc is a subsidiary of Planwise Group Limited."
TLSA,2019-12-31,3714000,-10012000,NA,-9323000,6207000,0,-9921000,-9921000,-92000,-689000,0,9921000,0,-91000,NA,-9323000,-9323000,NA,income_statement,Biotechnology,Tiziana Life Sciences plc - Ame,"Tiziana Life Sciences Plc, a clinical stage biotechnology company, focuses on the discovery and development of molecules and related diagnostics to treat diseases in oncology and immunology in the United Kingdom. The company's product pipeline includes Foralumab (TZLS-401), a human anti-CD3 monclonal antibody for the treatment of autoimmune and inflammatory diseases, such GvHD, ulcerative colitis, Crohn's disease, multiple sclerosis, type-1 diabetes, inflammatory bowel diseases, psoriasis, and rheumatoid arthritis; and Milciclib (TZLS-201), which is an orally bioavailable, small molecule inhibitor of cyclin-dependent kinases and Src family kinases for the treatment of hepatocellular carcinoma. It also develops Anti IL-6r (TZLS-501), a human anti-interleukin-6 receptor monoclonal antibody for the treatment of IL6-induced inflammation, primarily to treat hospitalized COVID-19 patients with severe respiratory symptoms; and StemPrintER, a multi-gene signature assay intended for use in patients diagnosed with estrogen-receptor positive ER+/HER2 negative breast cancers. The company was founded in 2013 and is headquartered in London, the United Kingdom. Tiziana Life Sciences Plc is a subsidiary of Planwise Group Limited."
TMDI,2016-12-31,22577885,-23323496,NA,-23323496,4925265,0,-27527790,-27527790,-422989,0,0,27527790,0,4204294,NA,-23323496,-23323496,NA,income_statement,Medical Devices,Titan Medical Inc.,"Titan Medical Inc., a research and development stage company, focuses on the design, development, and commercialization of computer-assisted robotic surgical technologies for application in minimally invasive surgery (MIS). The company is developing the SPORT Surgical System, a single-port robotic surgical system that comprises a surgeon-controlled patient cart, which includes a 3D high definition vision system and multi-articulating instruments for performing MIS procedures; and a surgeon workstation that provides the surgeon with ergonomic interface to the patient cart and a 3D endoscopic view inside the patient's body during MIS procedures. The SPORT Surgical System enables surgeons to perform surgical procedures for gynecologic, urologic, colorectal, and abdominal indications. Titan Medical Inc. is headquartered in Toronto, Canada."
TMDI,2017-12-31,12900855,-33586984,NA,-33586984,5965841,0,-18884056,-18884056,-422989,0,0,18884056,0,-14702928,NA,-33586984,-33586984,NA,income_statement,Medical Devices,Titan Medical Inc.,"Titan Medical Inc., a research and development stage company, focuses on the design, development, and commercialization of computer-assisted robotic surgical technologies for application in minimally invasive surgery (MIS). The company is developing the SPORT Surgical System, a single-port robotic surgical system that comprises a surgeon-controlled patient cart, which includes a 3D high definition vision system and multi-articulating instruments for performing MIS procedures; and a surgeon workstation that provides the surgeon with ergonomic interface to the patient cart and a 3D endoscopic view inside the patient's body during MIS procedures. The SPORT Surgical System enables surgeons to perform surgical procedures for gynecologic, urologic, colorectal, and abdominal indications. Titan Medical Inc. is headquartered in Toronto, Canada."
TMDI,2018-12-31,32858339,-22639272,NA,-22639272,5297337,0,-39690342,-39690342,-422989,0,0,39690342,0,17051070,NA,-22639272,-22639272,NA,income_statement,Medical Devices,Titan Medical Inc.,"Titan Medical Inc., a research and development stage company, focuses on the design, development, and commercialization of computer-assisted robotic surgical technologies for application in minimally invasive surgery (MIS). The company is developing the SPORT Surgical System, a single-port robotic surgical system that comprises a surgeon-controlled patient cart, which includes a 3D high definition vision system and multi-articulating instruments for performing MIS procedures; and a surgeon workstation that provides the surgeon with ergonomic interface to the patient cart and a 3D endoscopic view inside the patient's body during MIS procedures. The SPORT Surgical System enables surgeons to perform surgical procedures for gynecologic, urologic, colorectal, and abdominal indications. Titan Medical Inc. is headquartered in Toronto, Canada."
TMDI,2019-12-31,51418056,-41907079,NA,-41907079,6163586,0,-59265316,-59265316,-422989,0,0,59265316,0,17358237,NA,-41907079,-41907079,NA,income_statement,Medical Devices,Titan Medical Inc.,"Titan Medical Inc., a research and development stage company, focuses on the design, development, and commercialization of computer-assisted robotic surgical technologies for application in minimally invasive surgery (MIS). The company is developing the SPORT Surgical System, a single-port robotic surgical system that comprises a surgeon-controlled patient cart, which includes a 3D high definition vision system and multi-articulating instruments for performing MIS procedures; and a surgeon workstation that provides the surgeon with ergonomic interface to the patient cart and a 3D endoscopic view inside the patient's body during MIS procedures. The SPORT Surgical System enables surgeons to perform surgical procedures for gynecologic, urologic, colorectal, and abdominal indications. Titan Medical Inc. is headquartered in Toronto, Canada."
TMDX,2016-12-31,15637000,-24065000,NA,-24065000,8115000,766000,-22986000,-22986000,-979000,0,6209000,29195000,5443000,-1079000,NA,-24065000,-24065000,NA,income_statement,Medical Devices,"TransMedics Group, Inc.","TransMedics Group, Inc., a commercial-stage medical technology company, engages in transforming organ transplant therapy for end-stage organ failure patients in the United States and internationally. The company offers Organ Care System (OCS), a portable organ perfusion, optimization, and monitoring system that utilizes its proprietary and customized technology to replicate near-physiologic conditions for donor organs outside of the human body. Its Organ Care System includes OCS LUNG, a portable perfusion apparatus, optimization, and monitoring system that maintains the organ at a near-physiologic state allowing physicians to assess and improve the condition of lungs between the donor and recipient sites; OCS Heart, a portable, warm perfusion, and monitoring system designed to keep a donor heart at a human-like, metabolically active state; and OCS Liver, a system that is evaluated in clinical trials for utilized and unutilized donor livers. TransMedics Group, Inc. was founded in 1998 and is headquartered in Andover, Massachusetts."
TMDX,2017-12-30,14957000,-20791000,NA,-20823000,7606000,2137000,-20426000,-20426000,-1072000,32000,7685000,28111000,5548000,-365000,NA,-20823000,-20823000,NA,income_statement,Medical Devices,"TransMedics Group, Inc.","TransMedics Group, Inc., a commercial-stage medical technology company, engages in transforming organ transplant therapy for end-stage organ failure patients in the United States and internationally. The company offers Organ Care System (OCS), a portable organ perfusion, optimization, and monitoring system that utilizes its proprietary and customized technology to replicate near-physiologic conditions for donor organs outside of the human body. Its Organ Care System includes OCS LUNG, a portable perfusion apparatus, optimization, and monitoring system that maintains the organ at a near-physiologic state allowing physicians to assess and improve the condition of lungs between the donor and recipient sites; OCS Heart, a portable, warm perfusion, and monitoring system designed to keep a donor heart at a human-like, metabolically active state; and OCS Liver, a system that is evaluated in clinical trials for utilized and unutilized donor livers. TransMedics Group, Inc. was founded in 1998 and is headquartered in Andover, Massachusetts."
TMDX,2018-12-29,13656000,-23715000,NA,-23756000,12315000,5734000,-20237000,-20237000,-2720000,41000,13017000,33254000,7283000,-3478000,NA,-23756000,-23756000,NA,income_statement,Medical Devices,"TransMedics Group, Inc.","TransMedics Group, Inc., a commercial-stage medical technology company, engages in transforming organ transplant therapy for end-stage organ failure patients in the United States and internationally. The company offers Organ Care System (OCS), a portable organ perfusion, optimization, and monitoring system that utilizes its proprietary and customized technology to replicate near-physiologic conditions for donor organs outside of the human body. Its Organ Care System includes OCS LUNG, a portable perfusion apparatus, optimization, and monitoring system that maintains the organ at a near-physiologic state allowing physicians to assess and improve the condition of lungs between the donor and recipient sites; OCS Heart, a portable, warm perfusion, and monitoring system designed to keep a donor heart at a human-like, metabolically active state; and OCS Liver, a system that is evaluated in clinical trials for utilized and unutilized donor livers. TransMedics Group, Inc. was founded in 1998 and is headquartered in Andover, Massachusetts."
TMDX,2019-12-28,19870000,-33507000,NA,-33547000,23596000,13863000,-29603000,-29603000,-4353000,40000,23604000,53207000,9741000,-3904000,NA,-33547000,-33547000,NA,income_statement,Medical Devices,"TransMedics Group, Inc.","TransMedics Group, Inc., a commercial-stage medical technology company, engages in transforming organ transplant therapy for end-stage organ failure patients in the United States and internationally. The company offers Organ Care System (OCS), a portable organ perfusion, optimization, and monitoring system that utilizes its proprietary and customized technology to replicate near-physiologic conditions for donor organs outside of the human body. Its Organ Care System includes OCS LUNG, a portable perfusion apparatus, optimization, and monitoring system that maintains the organ at a near-physiologic state allowing physicians to assess and improve the condition of lungs between the donor and recipient sites; OCS Heart, a portable, warm perfusion, and monitoring system designed to keep a donor heart at a human-like, metabolically active state; and OCS Liver, a system that is evaluated in clinical trials for utilized and unutilized donor livers. TransMedics Group, Inc. was founded in 1998 and is headquartered in Andover, Massachusetts."
TMO,2017-12-31,887000000,2429000000,NA,2225000000,5428000000,9536000000,3221000000,3221000000,-592000000,201000000,20918000000,17697000000,11382000000,-792000000,-3000000,2228000000,2225000000,6000000,income_statement,NA,NA,NA
TMO,2018-12-31,967000000,3262000000,NA,2938000000,6023000000,10869000000,3879000000,3879000000,-667000000,324000000,24358000000,20479000000,13489000000,-617000000,NA,2938000000,2938000000,NA,income_statement,NA,NA,NA
TMO,2019-12-31,1003000000,4070000000,NA,3696000000,6080000000,11344000000,4261000000,4261000000,-676000000,374000000,25542000000,21281000000,14198000000,-191000000,NA,3696000000,3696000000,NA,income_statement,NA,NA,NA
TMO,2020-12-31,1181000000,7225000000,NA,6375000000,5774000000,16509000000,7887000000,7887000000,-553000000,850000000,32218000000,24331000000,15709000000,-662000000,NA,6375000000,6375000000,NA,income_statement,NA,NA,NA
TMUS,2017-12-31,NA,3161000000,NA,4536000000,12259000000,22896000000,4653000000,4653000000,-1671000000,-1375000000,40604000000,35951000000,17708000000,-1492000000,320000000,4536000000,4481000000,NA,income_statement,NA,NA,NA
TMUS,2018-12-31,NA,3917000000,NA,2888000000,12965000000,24809000000,5358000000,5358000000,-1357000000,1029000000,43239000000,37881000000,18430000000,-1441000000,320000000,2888000000,2888000000,NA,income_statement,NA,NA,NA
TMUS,2019-12-31,NA,4603000000,NA,3468000000,13519000000,26477000000,6342000000,6342000000,-1135000000,1135000000,44998000000,38656000000,18521000000,-1739000000,320000000,3468000000,3468000000,NA,income_statement,NA,NA,NA
TMUS,2020-12-31,NA,3530000000,NA,3064000000,17205000000,40777000000,9421000000,9421000000,-2730000000,786000000,68397000000,58976000000,27620000000,-5891000000,320000000,2744000000,3064000000,NA,income_statement,NA,NA,NA
TNDM,2016-12-31,18809000,-83462000,NA,-83447000,82834000,23592000,-78051000,-78051000,-5707000,-15000,84248000,162299000,60656000,-5411000,NA,-83447000,-83447000,NA,income_statement,Medical Devices,"Tandem Diabetes Care, Inc.","Tandem Diabetes Care, Inc., a medical device company, designs, develops, and commercializes various products for people with insulin-dependent diabetes in the United States. The company's flagship product is the t:slim X2 insulin delivery system, a pump platform that comprises t:slim X2 pump, its 300-unit disposable insulin cartridge, and an infusion set. It also provides t:slim X2 insulin delivery system with Basal-IQ Technology; t:slim X2 with control IQ technology; t:slim X2 with G5 Integration; and Tandem Device Updater, a tool that allows users to update their pump's software. In addition, the company offers t:connect, a web-based data management application, which provides a visual way to display diabetes therapy management data from the pump and supported blood glucose meters for users, their caregivers, and their healthcare providers. Its products in development include t:sport insulin delivery system; and connected (mobile) health offerings. Further, the company offers Sugarmate, a mobile app for people with diabetes who use insulin. Tandem Diabetes Care, Inc. has a development and commercialization agreement with Dexcom, Inc. The company was formerly known as Phluid Inc. and changed its name to Tandem Diabetes Care, Inc. in January 2008. Tandem Diabetes Care, Inc. was founded in 2006 and is headquartered in San Diego, California."
TNDM,2017-12-31,20661000,-73025000,NA,-73033000,86377000,44094000,-62944000,-62944000,-11341000,8000,107601000,170545000,63507000,-10081000,NA,-73033000,-73033000,NA,income_statement,Medical Devices,"Tandem Diabetes Care, Inc.","Tandem Diabetes Care, Inc., a medical device company, designs, develops, and commercializes various products for people with insulin-dependent diabetes in the United States. The company's flagship product is the t:slim X2 insulin delivery system, a pump platform that comprises t:slim X2 pump, its 300-unit disposable insulin cartridge, and an infusion set. It also provides t:slim X2 insulin delivery system with Basal-IQ Technology; t:slim X2 with control IQ technology; t:slim X2 with G5 Integration; and Tandem Device Updater, a tool that allows users to update their pump's software. In addition, the company offers t:connect, a web-based data management application, which provides a visual way to display diabetes therapy management data from the pump and supported blood glucose meters for users, their caregivers, and their healthcare providers. Its products in development include t:sport insulin delivery system; and connected (mobile) health offerings. Further, the company offers Sugarmate, a mobile app for people with diabetes who use insulin. Tandem Diabetes Care, Inc. has a development and commercialization agreement with Dexcom, Inc. The company was formerly known as Phluid Inc. and changed its name to Tandem Diabetes Care, Inc. in January 2008. Tandem Diabetes Care, Inc. was founded in 2006 and is headquartered in San Diego, California."
TNDM,2018-12-31,29227000,-122560000,NA,-122611000,105226000,89822000,-44631000,-44631000,-7584000,51000,183866000,228497000,94044000,-77929000,NA,-122611000,-122611000,NA,income_statement,Medical Devices,"Tandem Diabetes Care, Inc.","Tandem Diabetes Care, Inc., a medical device company, designs, develops, and commercializes various products for people with insulin-dependent diabetes in the United States. The company's flagship product is the t:slim X2 insulin delivery system, a pump platform that comprises t:slim X2 pump, its 300-unit disposable insulin cartridge, and an infusion set. It also provides t:slim X2 insulin delivery system with Basal-IQ Technology; t:slim X2 with control IQ technology; t:slim X2 with G5 Integration; and Tandem Device Updater, a tool that allows users to update their pump's software. In addition, the company offers t:connect, a web-based data management application, which provides a visual way to display diabetes therapy management data from the pump and supported blood glucose meters for users, their caregivers, and their healthcare providers. Its products in development include t:sport insulin delivery system; and connected (mobile) health offerings. Further, the company offers Sugarmate, a mobile app for people with diabetes who use insulin. Tandem Diabetes Care, Inc. has a development and commercialization agreement with Dexcom, Inc. The company was formerly known as Phluid Inc. and changed its name to Tandem Diabetes Care, Inc. in January 2008. Tandem Diabetes Care, Inc. was founded in 2006 and is headquartered in San Diego, California."
TNDM,2019-12-31,45199000,-24604000,NA,-24753000,165735000,194212000,-16722000,-16722000,-78000,149000,362305000,379027000,168093000,-7882000,NA,-24753000,-24753000,NA,income_statement,Medical Devices,"Tandem Diabetes Care, Inc.","Tandem Diabetes Care, Inc., a medical device company, designs, develops, and commercializes various products for people with insulin-dependent diabetes in the United States. The company's flagship product is the t:slim X2 insulin delivery system, a pump platform that comprises t:slim X2 pump, its 300-unit disposable insulin cartridge, and an infusion set. It also provides t:slim X2 insulin delivery system with Basal-IQ Technology; t:slim X2 with control IQ technology; t:slim X2 with G5 Integration; and Tandem Device Updater, a tool that allows users to update their pump's software. In addition, the company offers t:connect, a web-based data management application, which provides a visual way to display diabetes therapy management data from the pump and supported blood glucose meters for users, their caregivers, and their healthcare providers. Its products in development include t:sport insulin delivery system; and connected (mobile) health offerings. Further, the company offers Sugarmate, a mobile app for people with diabetes who use insulin. Tandem Diabetes Care, Inc. has a development and commercialization agreement with Dexcom, Inc. The company was formerly known as Phluid Inc. and changed its name to Tandem Diabetes Care, Inc. in January 2008. Tandem Diabetes Care, Inc. was founded in 2006 and is headquartered in San Diego, California."
TNXP,2016-12-31,28533000,-38842000,NA,-38842000,10436000,0,-38969000,-38969000,NA,0,0,38969000,0,127000,NA,-38842000,-38842000,NA,income_statement,Biotechnology,Tonix Pharmaceuticals Holding C,"Tonix Pharmaceuticals Holding Corp., a clinical-stage biopharmaceutical company, focuses on discovering, acquiring, developing, manufacturing, and licensing small molecules and biologics to treat and prevent human diseases and alleviate suffering. Its immunology product candidates include vaccines to prevent infectious diseases and biologics to address immunosuppression, cancer, and autoimmune diseases; and central nervous system (CNS) product candidates comprise small molecules and biologics to treat pain, neurologic, psychiatric, and addiction conditions. The company's lead vaccine candidate is TNX-1800, a live replicating vaccine based on the horsepox viral vector platform to protect against COVID-19. Its vaccines also comprise TNX-801, a live horsepox virus vaccine to protect against smallpox and monkeypox and serves as the vector platform; and TNX-2300 and TNX-2600, which are live replicating attenuated vaccine candidates for the prevention of COVID-19. In addition, the company's lead CNS candidate is TNX-102 SL, a sublingual formulation of cyclobenzaprine, which is in Phase 3 development for fibromyalgia, as well as in Phase 2 studies for agitation in Alzheimer's disease and alcohol use disorder. Further, its products include TNX-1300, which is in Phase 2 development for the treatment of life-threatening cocaine intoxication; TNX-601 CR for depression; and TNX-1900 for migraine and cranio-facial pain treatment. Additionally, its preclinical pipeline includes TNX-1600 for posttraumatic stress disorder, depression, and attention deficit hyperactivity disorder; TNX-701 for radioprotection; TNX-1200, a smallpox vaccine; TNX-1500 for transplant organ rejection and autoimmune conditions; and TNX-1700 for gastric and pancreatic cancers. The company is headquartered in Chatham, New Jersey."
TNXP,2017-12-31,13342000,-21123000,NA,-21123000,7949000,0,-21291000,-21291000,NA,0,0,21291000,0,368000,NA,-21123000,-21123000,NA,income_statement,Biotechnology,Tonix Pharmaceuticals Holding C,"Tonix Pharmaceuticals Holding Corp., a clinical-stage biopharmaceutical company, focuses on discovering, acquiring, developing, manufacturing, and licensing small molecules and biologics to treat and prevent human diseases and alleviate suffering. Its immunology product candidates include vaccines to prevent infectious diseases and biologics to address immunosuppression, cancer, and autoimmune diseases; and central nervous system (CNS) product candidates comprise small molecules and biologics to treat pain, neurologic, psychiatric, and addiction conditions. The company's lead vaccine candidate is TNX-1800, a live replicating vaccine based on the horsepox viral vector platform to protect against COVID-19. Its vaccines also comprise TNX-801, a live horsepox virus vaccine to protect against smallpox and monkeypox and serves as the vector platform; and TNX-2300 and TNX-2600, which are live replicating attenuated vaccine candidates for the prevention of COVID-19. In addition, the company's lead CNS candidate is TNX-102 SL, a sublingual formulation of cyclobenzaprine, which is in Phase 3 development for fibromyalgia, as well as in Phase 2 studies for agitation in Alzheimer's disease and alcohol use disorder. Further, its products include TNX-1300, which is in Phase 2 development for the treatment of life-threatening cocaine intoxication; TNX-601 CR for depression; and TNX-1900 for migraine and cranio-facial pain treatment. Additionally, its preclinical pipeline includes TNX-1600 for posttraumatic stress disorder, depression, and attention deficit hyperactivity disorder; TNX-701 for radioprotection; TNX-1200, a smallpox vaccine; TNX-1500 for transplant organ rejection and autoimmune conditions; and TNX-1700 for gastric and pancreatic cancers. The company is headquartered in Chatham, New Jersey."
TNXP,2018-12-31,17558000,-26089000,NA,-26089000,8764000,0,-26322000,-26322000,NA,0,0,26322000,0,233000,NA,-26089000,-29355000,NA,income_statement,Biotechnology,Tonix Pharmaceuticals Holding C,"Tonix Pharmaceuticals Holding Corp., a clinical-stage biopharmaceutical company, focuses on discovering, acquiring, developing, manufacturing, and licensing small molecules and biologics to treat and prevent human diseases and alleviate suffering. Its immunology product candidates include vaccines to prevent infectious diseases and biologics to address immunosuppression, cancer, and autoimmune diseases; and central nervous system (CNS) product candidates comprise small molecules and biologics to treat pain, neurologic, psychiatric, and addiction conditions. The company's lead vaccine candidate is TNX-1800, a live replicating vaccine based on the horsepox viral vector platform to protect against COVID-19. Its vaccines also comprise TNX-801, a live horsepox virus vaccine to protect against smallpox and monkeypox and serves as the vector platform; and TNX-2300 and TNX-2600, which are live replicating attenuated vaccine candidates for the prevention of COVID-19. In addition, the company's lead CNS candidate is TNX-102 SL, a sublingual formulation of cyclobenzaprine, which is in Phase 3 development for fibromyalgia, as well as in Phase 2 studies for agitation in Alzheimer's disease and alcohol use disorder. Further, its products include TNX-1300, which is in Phase 2 development for the treatment of life-threatening cocaine intoxication; TNX-601 CR for depression; and TNX-1900 for migraine and cranio-facial pain treatment. Additionally, its preclinical pipeline includes TNX-1600 for posttraumatic stress disorder, depression, and attention deficit hyperactivity disorder; TNX-701 for radioprotection; TNX-1200, a smallpox vaccine; TNX-1500 for transplant organ rejection and autoimmune conditions; and TNX-1700 for gastric and pancreatic cancers. The company is headquartered in Chatham, New Jersey."
TNXP,2019-12-31,18192000,-28618000,NA,-28618000,10636000,0,-28828000,-28828000,NA,0,0,28828000,0,210000,NA,-28618000,-31092000,NA,income_statement,Biotechnology,Tonix Pharmaceuticals Holding C,"Tonix Pharmaceuticals Holding Corp., a clinical-stage biopharmaceutical company, focuses on discovering, acquiring, developing, manufacturing, and licensing small molecules and biologics to treat and prevent human diseases and alleviate suffering. Its immunology product candidates include vaccines to prevent infectious diseases and biologics to address immunosuppression, cancer, and autoimmune diseases; and central nervous system (CNS) product candidates comprise small molecules and biologics to treat pain, neurologic, psychiatric, and addiction conditions. The company's lead vaccine candidate is TNX-1800, a live replicating vaccine based on the horsepox viral vector platform to protect against COVID-19. Its vaccines also comprise TNX-801, a live horsepox virus vaccine to protect against smallpox and monkeypox and serves as the vector platform; and TNX-2300 and TNX-2600, which are live replicating attenuated vaccine candidates for the prevention of COVID-19. In addition, the company's lead CNS candidate is TNX-102 SL, a sublingual formulation of cyclobenzaprine, which is in Phase 3 development for fibromyalgia, as well as in Phase 2 studies for agitation in Alzheimer's disease and alcohol use disorder. Further, its products include TNX-1300, which is in Phase 2 development for the treatment of life-threatening cocaine intoxication; TNX-601 CR for depression; and TNX-1900 for migraine and cranio-facial pain treatment. Additionally, its preclinical pipeline includes TNX-1600 for posttraumatic stress disorder, depression, and attention deficit hyperactivity disorder; TNX-701 for radioprotection; TNX-1200, a smallpox vaccine; TNX-1500 for transplant organ rejection and autoimmune conditions; and TNX-1700 for gastric and pancreatic cancers. The company is headquartered in Chatham, New Jersey."
TOMZ,2016-12-31,184259,-3157259,NA,-3157259,5716743,3732932,-3369150,-3369150,-197535,0,6343432,9712582,2610500,211891,NA,-3157259,-3157259,-319388,income_statement,Pollution & Treatment Controls,"TOMI Environmental Solutions, I","TOMI Environmental Solutions, Inc. provides disinfection and decontamination products and services for indoor and outdoor surface, and air decontamination in the United States and internationally. The company's products and services include SteraMist Surface Unit, a point and spray disinfection/decontamination system; SteraMist Environment System, a system that provides room disinfection/decontamination of a sealed space up to 103.8 m3; and The SteraMist Hospital Disinfection Cart, a solution to aid its hospital-healthcare customers in providing the quality of care and safety to their patients by disinfecting patient and operating rooms, pharmacies, ambulances, and emergency environments in a hospital or healthcare facility. Its products and services also comprise SteraMist Select Surface Unit; Stainless Steel 90-Degree Applicator; SteraMist Permanent iHP Complete Disinfection Room, an automated system that is plumbed utilizing the facilities' existing HVAC system; and iHP Plasma Decontamination Chamber. In addition, the company offers full room, equipment, facility, and emergency disinfection/decontamination services. It manufactures, sells, services, and licenses SteraMist Binary Ionization Technology, a hydrogen peroxide-based mist and fog. The company's products and services are used in pharmaceutical companies, clean rooms, hospitals and medical facilities, ambulances, bio-safety labs, tissue labs, vivariums, research universities, military and government agencies, office buildings, schools, athletic facilities, single-family homes and multi-unit residences, cruise ships, schools, and entertainment establishments; patient medical transport airline, hospitality, transportation industries; and cannabis market. TOMI Environmental Solutions, Inc. was incorporated in 1979 and is headquartered in Beverly Hills, California."
TOMZ,2017-12-31,454089,-3639815,NA,-3639815,5132924,3065895,-3444080,-3444080,-197535,0,4993668,8437748,1927773,-195735,NA,-3639815,-3442280,-319388,income_statement,Pollution & Treatment Controls,"TOMI Environmental Solutions, I","TOMI Environmental Solutions, Inc. provides disinfection and decontamination products and services for indoor and outdoor surface, and air decontamination in the United States and internationally. The company's products and services include SteraMist Surface Unit, a point and spray disinfection/decontamination system; SteraMist Environment System, a system that provides room disinfection/decontamination of a sealed space up to 103.8 m3; and The SteraMist Hospital Disinfection Cart, a solution to aid its hospital-healthcare customers in providing the quality of care and safety to their patients by disinfecting patient and operating rooms, pharmacies, ambulances, and emergency environments in a hospital or healthcare facility. Its products and services also comprise SteraMist Select Surface Unit; Stainless Steel 90-Degree Applicator; SteraMist Permanent iHP Complete Disinfection Room, an automated system that is plumbed utilizing the facilities' existing HVAC system; and iHP Plasma Decontamination Chamber. In addition, the company offers full room, equipment, facility, and emergency disinfection/decontamination services. It manufactures, sells, services, and licenses SteraMist Binary Ionization Technology, a hydrogen peroxide-based mist and fog. The company's products and services are used in pharmaceutical companies, clean rooms, hospitals and medical facilities, ambulances, bio-safety labs, tissue labs, vivariums, research universities, military and government agencies, office buildings, schools, athletic facilities, single-family homes and multi-unit residences, cruise ships, schools, and entertainment establishments; patient medical transport airline, hospitality, transportation industries; and cannabis market. TOMI Environmental Solutions, Inc. was incorporated in 1979 and is headquartered in Beverly Hills, California."
TOMZ,2018-12-31,916003,-3230462,NA,-3230462,4559802,3117498,-3070220,-3070220,-259969,0,5584612,8654832,2467114,-160242,NA,-3230462,-2970493,NA,income_statement,Pollution & Treatment Controls,"TOMI Environmental Solutions, I","TOMI Environmental Solutions, Inc. provides disinfection and decontamination products and services for indoor and outdoor surface, and air decontamination in the United States and internationally. The company's products and services include SteraMist Surface Unit, a point and spray disinfection/decontamination system; SteraMist Environment System, a system that provides room disinfection/decontamination of a sealed space up to 103.8 m3; and The SteraMist Hospital Disinfection Cart, a solution to aid its hospital-healthcare customers in providing the quality of care and safety to their patients by disinfecting patient and operating rooms, pharmacies, ambulances, and emergency environments in a hospital or healthcare facility. Its products and services also comprise SteraMist Select Surface Unit; Stainless Steel 90-Degree Applicator; SteraMist Permanent iHP Complete Disinfection Room, an automated system that is plumbed utilizing the facilities' existing HVAC system; and iHP Plasma Decontamination Chamber. In addition, the company offers full room, equipment, facility, and emergency disinfection/decontamination services. It manufactures, sells, services, and licenses SteraMist Binary Ionization Technology, a hydrogen peroxide-based mist and fog. The company's products and services are used in pharmaceutical companies, clean rooms, hospitals and medical facilities, ambulances, bio-safety labs, tissue labs, vivariums, research universities, military and government agencies, office buildings, schools, athletic facilities, single-family homes and multi-unit residences, cruise ships, schools, and entertainment establishments; patient medical transport airline, hospitality, transportation industries; and cannabis market. TOMI Environmental Solutions, Inc. was incorporated in 1979 and is headquartered in Beverly Hills, California."
TOMZ,2019-12-31,340582,-2297733,NA,-2297733,4826192,3913917,-2083244,-2083244,-217534,0,6347160,8430404,2433243,-214489,NA,-2297733,-2080199,NA,income_statement,Pollution & Treatment Controls,"TOMI Environmental Solutions, I","TOMI Environmental Solutions, Inc. provides disinfection and decontamination products and services for indoor and outdoor surface, and air decontamination in the United States and internationally. The company's products and services include SteraMist Surface Unit, a point and spray disinfection/decontamination system; SteraMist Environment System, a system that provides room disinfection/decontamination of a sealed space up to 103.8 m3; and The SteraMist Hospital Disinfection Cart, a solution to aid its hospital-healthcare customers in providing the quality of care and safety to their patients by disinfecting patient and operating rooms, pharmacies, ambulances, and emergency environments in a hospital or healthcare facility. Its products and services also comprise SteraMist Select Surface Unit; Stainless Steel 90-Degree Applicator; SteraMist Permanent iHP Complete Disinfection Room, an automated system that is plumbed utilizing the facilities' existing HVAC system; and iHP Plasma Decontamination Chamber. In addition, the company offers full room, equipment, facility, and emergency disinfection/decontamination services. It manufactures, sells, services, and licenses SteraMist Binary Ionization Technology, a hydrogen peroxide-based mist and fog. The company's products and services are used in pharmaceutical companies, clean rooms, hospitals and medical facilities, ambulances, bio-safety labs, tissue labs, vivariums, research universities, military and government agencies, office buildings, schools, athletic facilities, single-family homes and multi-unit residences, cruise ships, schools, and entertainment establishments; patient medical transport airline, hospitality, transportation industries; and cannabis market. TOMI Environmental Solutions, Inc. was incorporated in 1979 and is headquartered in Beverly Hills, California."
TOPS,2016-12-31,NA,-351000,1185000,-351000,6307000,11528000,4848000,4848000,-2888000,0,28433000,23585000,16905000,-5199000,NA,-351000,-351000,-3094000,income_statement,Marine Shipping,TOP Ships Inc.,"Top Ships Inc. owns and operates tanker vessels worldwide. The company's medium range tanker vessels transport crude oil, petroleum products, and bulk liquid chemicals. As of December 31, 2019, it had a fleet with a total capacity of 714,000 deadweight tonnes (dwt) consisting of eight 50,000 dwt product/chemical tankers, such as the M/T Stenaweco Energy, M/T Stenaweco Evolution, M/T Nord Valiant, M/T Stenaweco Excellence, the M/T Eco California, the M/T Eco Marina Del Ray, The M/T Eco Los Angeles, and the M/T Eco City of Angels; and two 157,000 dwt Suezmax tankers, including the M/T Eco Bel Air and M/T Eco Beverly Hills. The company was formerly known as Top Tankers Inc. and changed its name to Top Ships Inc. in December 2007. Top Ships Inc. was founded in 2000 and is based in Maroussi, Greece."
TOPS,2017-12-31,NA,-13372000,1185000,-13404000,12192000,18730000,1616000,1616000,-14556000,0,39363000,37747000,20633000,-14988000,NA,-13372000,-13404000,-822000,income_statement,Marine Shipping,TOP Ships Inc.,"Top Ships Inc. owns and operates tanker vessels worldwide. The company's medium range tanker vessels transport crude oil, petroleum products, and bulk liquid chemicals. As of December 31, 2019, it had a fleet with a total capacity of 714,000 deadweight tonnes (dwt) consisting of eight 50,000 dwt product/chemical tankers, such as the M/T Stenaweco Energy, M/T Stenaweco Evolution, M/T Nord Valiant, M/T Stenaweco Excellence, the M/T Eco California, the M/T Eco Marina Del Ray, The M/T Eco Los Angeles, and the M/T Eco City of Angels; and two 157,000 dwt Suezmax tankers, including the M/T Eco Bel Air and M/T Eco Beverly Hills. The company was formerly known as Top Tankers Inc. and changed its name to Top Ships Inc. in December 2007. Top Ships Inc. was founded in 2000 and is based in Maroussi, Greece."
TOPS,2018-12-31,NA,-11129000,NA,-11134000,16419000,19035000,-3889000,-3889000,-8996000,0,41048000,44937000,22013000,-7240000,NA,-11129000,-11134000,115000,income_statement,Marine Shipping,TOP Ships Inc.,"Top Ships Inc. owns and operates tanker vessels worldwide. The company's medium range tanker vessels transport crude oil, petroleum products, and bulk liquid chemicals. As of December 31, 2019, it had a fleet with a total capacity of 714,000 deadweight tonnes (dwt) consisting of eight 50,000 dwt product/chemical tankers, such as the M/T Stenaweco Energy, M/T Stenaweco Evolution, M/T Nord Valiant, M/T Stenaweco Excellence, the M/T Eco California, the M/T Eco Marina Del Ray, The M/T Eco Los Angeles, and the M/T Eco City of Angels; and two 157,000 dwt Suezmax tankers, including the M/T Eco Bel Air and M/T Eco Beverly Hills. The company was formerly known as Top Tankers Inc. and changed its name to Top Ships Inc. in December 2007. Top Ships Inc. was founded in 2000 and is based in Maroussi, Greece."
TOPS,2019-12-31,NA,-14773000,NA,-14773000,4173000,32970000,16246000,16246000,-18497000,0,66088000,49842000,33118000,-31019000,NA,-14773000,-30989000,159000,income_statement,Marine Shipping,TOP Ships Inc.,"Top Ships Inc. owns and operates tanker vessels worldwide. The company's medium range tanker vessels transport crude oil, petroleum products, and bulk liquid chemicals. As of December 31, 2019, it had a fleet with a total capacity of 714,000 deadweight tonnes (dwt) consisting of eight 50,000 dwt product/chemical tankers, such as the M/T Stenaweco Energy, M/T Stenaweco Evolution, M/T Nord Valiant, M/T Stenaweco Excellence, the M/T Eco California, the M/T Eco Marina Del Ray, The M/T Eco Los Angeles, and the M/T Eco City of Angels; and two 157,000 dwt Suezmax tankers, including the M/T Eco Bel Air and M/T Eco Beverly Hills. The company was formerly known as Top Tankers Inc. and changed its name to Top Ships Inc. in December 2007. Top Ships Inc. was founded in 2000 and is based in Maroussi, Greece."
TOUR,2016-12-31,601402000,-2424043000,90870000,-2407300000,2559187000,639205000,-2500286000,-2500286000,-7918000,-1711000,10530941000,13031227000,9891736000,76243000,NA,-2422332000,-2407300000,-21098000,income_statement,Travel Services,Tuniu Corporation,"Tuniu Corporation operates as an online leisure travel company. The company offers a selection of packaged tours, including organized and self-guided tours; and other travel-related services, such as tourist attraction tickets selling, visa application services, accommodation reservation, financial services, and hotel booking services, as well as air, train, and bus ticketing for leisure travelers. It also provides car rental and insurance services, as well as advertising services to tourism boards and bureaus. The company offers its products and services through various online and offline channels comprising the tuniu.com website; mobile platform; a primary call center in Nanjing; a regional call center in Suqian; and other offline retail stores in China. Tuniu Corporation was founded in 2006 and is headquartered in Nanjing, China."
TOUR,2017-12-31,541126000,-755691000,98917000,-773029000,1531943000,1117027000,-928721000,-928721000,-7918000,15625000,2141233000,3069954000,1024206000,173030000,NA,-771316000,-773029000,-27321000,income_statement,Travel Services,Tuniu Corporation,"Tuniu Corporation operates as an online leisure travel company. The company offers a selection of packaged tours, including organized and self-guided tours; and other travel-related services, such as tourist attraction tickets selling, visa application services, accommodation reservation, financial services, and hotel booking services, as well as air, train, and bus ticketing for leisure travelers. It also provides car rental and insurance services, as well as advertising services to tourism boards and bureaus. The company offers its products and services through various online and offline channels comprising the tuniu.com website; mobile platform; a primary call center in Nanjing; a regional call center in Suqian; and other offline retail stores in China. Tuniu Corporation was founded in 2006 and is headquartered in Nanjing, China."
TOUR,2018-12-31,315222000,-199218000,63489000,-187934000,1265498000,1175127000,-354236000,-354236000,-7918000,153000,2240149000,2594385000,1065022000,155018000,NA,-199371000,-187934000,-51357000,income_statement,Travel Services,Tuniu Corporation,"Tuniu Corporation operates as an online leisure travel company. The company offers a selection of packaged tours, including organized and self-guided tours; and other travel-related services, such as tourist attraction tickets selling, visa application services, accommodation reservation, financial services, and hotel booking services, as well as air, train, and bus ticketing for leisure travelers. It also provides car rental and insurance services, as well as advertising services to tourism boards and bureaus. The company offers its products and services through various online and offline channels comprising the tuniu.com website; mobile platform; a primary call center in Nanjing; a regional call center in Suqian; and other offline retail stores in China. Tuniu Corporation was founded in 2006 and is headquartered in Nanjing, China."
TOUR,2019-12-31,303561000,-728433000,38210000,-699199000,1672677000,1080975000,-871188000,-871188000,-34052000,949000,2280987000,3152175000,1200012000,142755000,NA,-729382000,-699199000,-24075000,income_statement,Travel Services,Tuniu Corporation,"Tuniu Corporation operates as an online leisure travel company. The company offers a selection of packaged tours, including organized and self-guided tours; and other travel-related services, such as tourist attraction tickets selling, visa application services, accommodation reservation, financial services, and hotel booking services, as well as air, train, and bus ticketing for leisure travelers. It also provides car rental and insurance services, as well as advertising services to tourism boards and bureaus. The company offers its products and services through various online and offline channels comprising the tuniu.com website; mobile platform; a primary call center in Nanjing; a regional call center in Suqian; and other offline retail stores in China. Tuniu Corporation was founded in 2006 and is headquartered in Nanjing, China."
TOWN,2017-12-31,NA,147602000,11265000,87663000,242879000,443816000,0,157526000,NA,54813000,443816000,286290000,0,-9924000,NA,92789000,87663000,43411000,income_statement,Banks—Regional,Towne Bank,"TowneBank provides retail and commercial banking services for individuals, professionals, and commercial enterprises. The company operates in three segments: Banking, Realty, and Insurance. It accepts various deposits products, including demand deposits, savings accounts, money rate savings, certificates of deposit, and individual retirement accounts. The company also offers secured and unsecured personal loans for financing automobiles, home improvements, education, and personal investments; commercial loans for working capital, business expansion, and equipment and machinery purchases; and mortgage loans, as well as real estate acquisition, development, and construction loans. In addition, it provides other services, such as safe deposit boxes, treasury management services, direct deposit of payroll and social security checks, and automatic drafts for various accounts, as well as online, mobile, and on-call banking services. Further, the company offers documentation services to accomplish tax deferral to investors; investment and asset management services; commercial mortgage brokerage services; and other financial services, such as financial, retirement, and estate planning services, as well as assistance on various investment options, such as alternative investments, annuities, margin accounts, convertible bonds, and pension and profit sharing plans. Additionally, it provides residential real estate, relocation, property management, vacations rental, and title and settlement services; and originates residential mortgage loans. The company offers life, property, casualty, travel, and vehicle insurance services; medical, and baggage protection insurance for travelers; and employee benefit programs, such as health, dental, vision, and disability insurance. It operates 42 banking offices in Virginia and North Carolina. TowneBank was founded in 1998 and is headquartered in Portsmouth, Virginia."
TOWN,2018-12-31,NA,172001000,12894000,133793000,284461000,524125000,0,192139000,NA,34227000,524125000,331986000,0,-20138000,NA,137774000,133793000,47525000,income_statement,Banks—Regional,Towne Bank,"TowneBank provides retail and commercial banking services for individuals, professionals, and commercial enterprises. The company operates in three segments: Banking, Realty, and Insurance. It accepts various deposits products, including demand deposits, savings accounts, money rate savings, certificates of deposit, and individual retirement accounts. The company also offers secured and unsecured personal loans for financing automobiles, home improvements, education, and personal investments; commercial loans for working capital, business expansion, and equipment and machinery purchases; and mortgage loans, as well as real estate acquisition, development, and construction loans. In addition, it provides other services, such as safe deposit boxes, treasury management services, direct deposit of payroll and social security checks, and automatic drafts for various accounts, as well as online, mobile, and on-call banking services. Further, the company offers documentation services to accomplish tax deferral to investors; investment and asset management services; commercial mortgage brokerage services; and other financial services, such as financial, retirement, and estate planning services, as well as assistance on various investment options, such as alternative investments, annuities, margin accounts, convertible bonds, and pension and profit sharing plans. Additionally, it provides residential real estate, relocation, property management, vacations rental, and title and settlement services; and originates residential mortgage loans. The company offers life, property, casualty, travel, and vehicle insurance services; medical, and baggage protection insurance for travelers; and employee benefit programs, such as health, dental, vision, and disability insurance. It operates 42 banking offices in Virginia and North Carolina. TowneBank was founded in 1998 and is headquartered in Portsmouth, Virginia."
TOWN,2019-12-31,NA,176270000,12939000,138783000,313416000,554572000,0,189297000,NA,32596000,554572000,365275000,0,-13027000,NA,143674000,138783000,51859000,income_statement,Banks—Regional,Towne Bank,"TowneBank provides retail and commercial banking services for individuals, professionals, and commercial enterprises. The company operates in three segments: Banking, Realty, and Insurance. It accepts various deposits products, including demand deposits, savings accounts, money rate savings, certificates of deposit, and individual retirement accounts. The company also offers secured and unsecured personal loans for financing automobiles, home improvements, education, and personal investments; commercial loans for working capital, business expansion, and equipment and machinery purchases; and mortgage loans, as well as real estate acquisition, development, and construction loans. In addition, it provides other services, such as safe deposit boxes, treasury management services, direct deposit of payroll and social security checks, and automatic drafts for various accounts, as well as online, mobile, and on-call banking services. Further, the company offers documentation services to accomplish tax deferral to investors; investment and asset management services; commercial mortgage brokerage services; and other financial services, such as financial, retirement, and estate planning services, as well as assistance on various investment options, such as alternative investments, annuities, margin accounts, convertible bonds, and pension and profit sharing plans. Additionally, it provides residential real estate, relocation, property management, vacations rental, and title and settlement services; and originates residential mortgage loans. The company offers life, property, casualty, travel, and vehicle insurance services; medical, and baggage protection insurance for travelers; and employee benefit programs, such as health, dental, vision, and disability insurance. It operates 42 banking offices in Virginia and North Carolina. TowneBank was founded in 1998 and is headquartered in Portsmouth, Virginia."
TOWN,2020-12-31,NA,201333000,16981000,145535000,327425000,597158000,0,212831000,NA,31900000,597158000,384327000,0,-11498000,NA,169433000,145535000,56902000,income_statement,Banks—Regional,Towne Bank,"TowneBank provides retail and commercial banking services for individuals, professionals, and commercial enterprises. The company operates in three segments: Banking, Realty, and Insurance. It accepts various deposits products, including demand deposits, savings accounts, money rate savings, certificates of deposit, and individual retirement accounts. The company also offers secured and unsecured personal loans for financing automobiles, home improvements, education, and personal investments; commercial loans for working capital, business expansion, and equipment and machinery purchases; and mortgage loans, as well as real estate acquisition, development, and construction loans. In addition, it provides other services, such as safe deposit boxes, treasury management services, direct deposit of payroll and social security checks, and automatic drafts for various accounts, as well as online, mobile, and on-call banking services. Further, the company offers documentation services to accomplish tax deferral to investors; investment and asset management services; commercial mortgage brokerage services; and other financial services, such as financial, retirement, and estate planning services, as well as assistance on various investment options, such as alternative investments, annuities, margin accounts, convertible bonds, and pension and profit sharing plans. Additionally, it provides residential real estate, relocation, property management, vacations rental, and title and settlement services; and originates residential mortgage loans. The company offers life, property, casualty, travel, and vehicle insurance services; medical, and baggage protection insurance for travelers; and employee benefit programs, such as health, dental, vision, and disability insurance. It operates 42 banking offices in Virginia and North Carolina. TowneBank was founded in 1998 and is headquartered in Portsmouth, Virginia."
TPCO,2016-12-25,NA,-44939000,39756000,6537000,346690000,572959000,-1043000,-1043000,-26561000,-9576000,1063363000,1064406000,490404000,-43896000,41900000,-35363000,6537000,175949000,income_statement,Publishing,Tribune Publishing Company,"Tribune Publishing Company, together with subsidiaries, publishes newspapers worldwide. The company operates in two segments, M and X. It publishes daily newspapers, weekly newspapers, and niche publications and direct mails; and operates local websites and mobile applications. The company also provides various digital marketing services, which include the development of mobile websites, search engine marketing and optimization, social media account management, and content marketing for its customers' web presence for small to medium size businesses. In addition, it operates Tribune Content Agency, a syndication and licensing business that provides daily news service and syndicated premium content to approximately 2,000 media and digital information publishers. Tribune Publishing Company operates in eight markets with Chicago Tribune, New York Daily News, The Baltimore Sun, Orlando Sentinel Sun Sentinel, Daily Press and The Virginian-Pilot, The Morning Call of Lehigh Valley, Pennsylvania, and the Hartford Courant titles; and BestReviews engages in business of testing, researching, and reviewing consumer products. The company was formerly known as tronc, Inc. and changed its name to Tribune Publishing Company in October 2018. Tribune Publishing Company was founded in 2013 and is headquartered in Chicago, Illinois."
TPCO,2017-12-31,NA,-22625000,39756000,5535000,364702000,553446000,12443000,12443000,-26334000,7188000,1015453000,1003010000,462007000,-35068000,35348000,-29813000,5535000,128995000,income_statement,Publishing,Tribune Publishing Company,"Tribune Publishing Company, together with subsidiaries, publishes newspapers worldwide. The company operates in two segments, M and X. It publishes daily newspapers, weekly newspapers, and niche publications and direct mails; and operates local websites and mobile applications. The company also provides various digital marketing services, which include the development of mobile websites, search engine marketing and optimization, social media account management, and content marketing for its customers' web presence for small to medium size businesses. In addition, it operates Tribune Content Agency, a syndication and licensing business that provides daily news service and syndicated premium content to approximately 2,000 media and digital information publishers. Tribune Publishing Company operates in eight markets with Chicago Tribune, New York Daily News, The Baltimore Sun, Orlando Sentinel Sun Sentinel, Daily Press and The Virginian-Pilot, The Morning Call of Lehigh Valley, Pennsylvania, and the Hartford Courant titles; and BestReviews engages in business of testing, researching, and reviewing consumer products. The company was formerly known as tronc, Inc. and changed its name to Tribune Publishing Company in October 2018. Tribune Publishing Company was founded in 2013 and is headquartered in Chicago, Illinois."
TPCO,2018-12-30,NA,-52586000,39756000,248791000,369127000,581728000,28437000,28437000,-11353000,-12723000,1030669000,1002232000,448941000,-81023000,289510000,-39863000,248791000,130902000,income_statement,Publishing,Tribune Publishing Company,"Tribune Publishing Company, together with subsidiaries, publishes newspapers worldwide. The company operates in two segments, M and X. It publishes daily newspapers, weekly newspapers, and niche publications and direct mails; and operates local websites and mobile applications. The company also provides various digital marketing services, which include the development of mobile websites, search engine marketing and optimization, social media account management, and content marketing for its customers' web presence for small to medium size businesses. In addition, it operates Tribune Content Agency, a syndication and licensing business that provides daily news service and syndicated premium content to approximately 2,000 media and digital information publishers. Tribune Publishing Company operates in eight markets with Chicago Tribune, New York Daily News, The Baltimore Sun, Orlando Sentinel Sun Sentinel, Daily Press and The Virginian-Pilot, The Morning Call of Lehigh Valley, Pennsylvania, and the Hartford Courant titles; and BestReviews engages in business of testing, researching, and reviewing consumer products. The company was formerly known as tronc, Inc. and changed its name to Tribune Publishing Company in October 2018. Tribune Publishing Company was founded in 2013 and is headquartered in Chicago, Illinois."
TPCO,2019-12-29,NA,4713000,63501000,-5069000,361859000,572915000,30654000,30654000,NA,1620000,983149000,952495000,410234000,-25941000,-3337000,3093000,-30589000,133088000,income_statement,Publishing,Tribune Publishing Company,"Tribune Publishing Company, together with subsidiaries, publishes newspapers worldwide. The company operates in two segments, M and X. It publishes daily newspapers, weekly newspapers, and niche publications and direct mails; and operates local websites and mobile applications. The company also provides various digital marketing services, which include the development of mobile websites, search engine marketing and optimization, social media account management, and content marketing for its customers' web presence for small to medium size businesses. In addition, it operates Tribune Content Agency, a syndication and licensing business that provides daily news service and syndicated premium content to approximately 2,000 media and digital information publishers. Tribune Publishing Company operates in eight markets with Chicago Tribune, New York Daily News, The Baltimore Sun, Orlando Sentinel Sun Sentinel, Daily Press and The Virginian-Pilot, The Morning Call of Lehigh Valley, Pennsylvania, and the Hartford Courant titles; and BestReviews engages in business of testing, researching, and reviewing consumer products. The company was formerly known as tronc, Inc. and changed its name to Tribune Publishing Company in October 2018. Tribune Publishing Company was founded in 2013 and is headquartered in Chicago, Illinois."
TPIC,2016-12-31,1500000,30698000,NA,27044000,32392000,104993000,52974000,52974000,-17614000,3654000,769019000,716045000,664026000,-22276000,NA,27044000,21573000,NA,income_statement,Specialty Industrial Machinery,"TPI Composites, Inc.","TPI Composites, Inc. manufactures and sells composite wind blades, and related precision molding and assembly systems to original equipment manufacturers. The company also provides composite solutions for the transportation industry. It operates in the United States, Asia, Mexico, Europe, the Middle East, Africa, and India. The company was formerly known as LCSI Holding, Inc. and changed its name to TPI Composites, Inc. in 2008. TPI Composites, Inc. was founded in 1968 and is headquartered in Scottsdale, Arizona."
TPIC,2017-12-31,1600000,54532000,NA,38734000,38773000,151099000,70098000,70098000,-12381000,15798000,955198000,885100000,804099000,-15566000,NA,38734000,38734000,NA,income_statement,Specialty Industrial Machinery,"TPI Composites, Inc.","TPI Composites, Inc. manufactures and sells composite wind blades, and related precision molding and assembly systems to original equipment manufacturers. The company also provides composite solutions for the transportation industry. It operates in the United States, Asia, Mexico, Europe, the Middle East, Africa, and India. The company was formerly known as LCSI Holding, Inc. and changed its name to TPI Composites, Inc. in 2008. TPI Composites, Inc. was founded in 1968 and is headquartered in Scottsdale, Arizona."
TPIC,2018-12-31,800000,2246000,NA,5279000,42742000,147549000,29299000,29299000,-10417000,-3033000,1029624000,1000325000,882075000,-27053000,NA,5279000,5279000,NA,income_statement,Specialty Industrial Machinery,"TPI Composites, Inc.","TPI Composites, Inc. manufactures and sells composite wind blades, and related precision molding and assembly systems to original equipment manufacturers. The company also provides composite solutions for the transportation industry. It operates in the United States, Asia, Mexico, Europe, the Middle East, Africa, and India. The company was formerly known as LCSI Holding, Inc. and changed its name to TPI Composites, Inc. in 2008. TPI Composites, Inc. was founded in 1968 and is headquartered in Scottsdale, Arizona."
TPIC,2019-12-31,1000000,7407000,NA,-15708000,38916000,145881000,37932000,37932000,-8179000,23115000,1436500000,1398568000,1290619000,-30525000,NA,-15708000,-15708000,NA,income_statement,Specialty Industrial Machinery,"TPI Composites, Inc.","TPI Composites, Inc. manufactures and sells composite wind blades, and related precision molding and assembly systems to original equipment manufacturers. The company also provides composite solutions for the transportation industry. It operates in the United States, Asia, Mexico, Europe, the Middle East, Africa, and India. The company was formerly known as LCSI Holding, Inc. and changed its name to TPI Composites, Inc. in 2008. TPI Composites, Inc. was founded in 1968 and is headquartered in Scottsdale, Arizona."
TPR,2017-07-01,NA,759000000,NA,591000000,2271400000,3084000000,812600000,812600000,-26800000,168000000,4488300000,3675700000,1404300000,-53600000,NA,591000000,591000000,NA,income_statement,NA,NA,NA
TPR,2018-06-30,NA,596800000,NA,397500000,2971800000,3964900000,993100000,993100000,-86300000,199300000,5880000000,4886900000,1915100000,-396300000,NA,397500000,397500000,NA,income_statement,NA,NA,NA
TPR,2019-06-29,NA,766200000,NA,643400000,3167400000,4081500000,914100000,914100000,-66900000,122800000,6027100000,5113000000,1945600000,-147900000,NA,643400000,643400000,NA,income_statement,NA,NA,NA
TPR,2020-06-27,NA,-624200000,NA,-652100000,2920400000,3357300000,436900000,436900000,-71500000,27900000,4961400000,4524500000,1604100000,-1061100000,NA,-652100000,-652100000,NA,income_statement,NA,NA,NA
TPTX,2017-12-31,15241000,-16593000,NA,-16593000,1488000,0,-16729000,-16729000,NA,1000,0,16729000,0,272000,NA,-16593000,-16593000,NA,income_statement,Biotechnology,"Turning Point Therapeutics, Inc","Turning Point Therapeutics, Inc., a clinical-stage biopharmaceutical company, engages in designing and developing novel small molecule targeted oncology therapies. It develops a pipeline of tyrosine kinase inhibitors (TKIs) that targets genetic drivers of cancer in TKI-naÃ¯ve and TKI-pretreated patients. The company's lead drug candidate repotrectinib is being evaluated in an ongoing Phase I/II trial called TRIDENT-1 for the treatment of patients with ROS1+ advanced non-small-cell lung cancer (NSCLC) and patients with ROS1+, NTRK+, or ALK+ advanced solid tumors. Its pipeline also includes multi-targeted drug candidates TPX-0046, a RET/SRC inhibitor; TPX-0022, a MET/CSF1R/SRC inhibitor; and TPX-0131, a preclinical ALK inhibitor. The company was founded in 2013 and is headquartered in San Diego, California."
TPTX,2018-12-31,21062000,-24785000,NA,-24785000,4578000,0,-25640000,-25640000,NA,1000,0,25640000,0,1711000,NA,-24785000,-24785000,NA,income_statement,Biotechnology,"Turning Point Therapeutics, Inc","Turning Point Therapeutics, Inc., a clinical-stage biopharmaceutical company, engages in designing and developing novel small molecule targeted oncology therapies. It develops a pipeline of tyrosine kinase inhibitors (TKIs) that targets genetic drivers of cancer in TKI-naÃ¯ve and TKI-pretreated patients. The company's lead drug candidate repotrectinib is being evaluated in an ongoing Phase I/II trial called TRIDENT-1 for the treatment of patients with ROS1+ advanced non-small-cell lung cancer (NSCLC) and patients with ROS1+, NTRK+, or ALK+ advanced solid tumors. Its pipeline also includes multi-targeted drug candidates TPX-0046, a RET/SRC inhibitor; TPX-0022, a MET/CSF1R/SRC inhibitor; and TPX-0131, a preclinical ALK inhibitor. The company was founded in 2013 and is headquartered in San Diego, California."
TPTX,2019-12-31,57943000,-72131000,NA,-72131000,19781000,0,-77724000,-77724000,NA,0,0,77724000,0,5593000,NA,-72131000,-72131000,NA,income_statement,Biotechnology,"Turning Point Therapeutics, Inc","Turning Point Therapeutics, Inc., a clinical-stage biopharmaceutical company, engages in designing and developing novel small molecule targeted oncology therapies. It develops a pipeline of tyrosine kinase inhibitors (TKIs) that targets genetic drivers of cancer in TKI-naÃ¯ve and TKI-pretreated patients. The company's lead drug candidate repotrectinib is being evaluated in an ongoing Phase I/II trial called TRIDENT-1 for the treatment of patients with ROS1+ advanced non-small-cell lung cancer (NSCLC) and patients with ROS1+, NTRK+, or ALK+ advanced solid tumors. Its pipeline also includes multi-targeted drug candidates TPX-0046, a RET/SRC inhibitor; TPX-0022, a MET/CSF1R/SRC inhibitor; and TPX-0131, a preclinical ALK inhibitor. The company was founded in 2013 and is headquartered in San Diego, California."
TRCH,2016-12-31,NA,-7684346,NA,-7684346,6447706,25952,-7058221,-7058221,-272796,0,354390,7412611,328438,-626125,NA,-7684346,-7684346,41,income_statement,Oil & Gas E&P,"Torchlight Energy Resources, In","Torchlight Energy Resources, Inc., through its subsidiaries, engages in the acquisition, exploration, exploitation, and/or development of oil and natural gas properties in the United States. As of December 31, 2019, it had interests in four oil and gas projects, including the Orogrande project in Hudspeth County, Texas; Hazel project in Sterling, Tom Green, and Irion Counties, Texas; Winkler project in Winkler County, Texas; and Hunton wells in partnership with Husky Ventures in central Oklahoma. The company was founded in 2010 and is headquartered in Plano, Texas."
TRCH,2017-12-31,NA,-919910,NA,-919910,3652970,397312,-3355814,-3355814,-346050,0,570499,3926313,173187,2435904,NA,-919910,-919910,4441,income_statement,Oil & Gas E&P,"Torchlight Energy Resources, In","Torchlight Energy Resources, Inc., through its subsidiaries, engages in the acquisition, exploration, exploitation, and/or development of oil and natural gas properties in the United States. As of December 31, 2019, it had interests in four oil and gas projects, including the Orogrande project in Hudspeth County, Texas; Hazel project in Sterling, Tom Green, and Irion Counties, Texas; Winkler project in Winkler County, Texas; and Hunton wells in partnership with Husky Ventures in central Oklahoma. The company was founded in 2010 and is headquartered in Plano, Texas."
TRCH,2018-12-31,NA,-5806612,NA,-5806612,4053062,476204,-4750610,-4750610,-547710,0,1282362,6032972,806158,-1056002,NA,-5806612,-5806612,4441,income_statement,Oil & Gas E&P,"Torchlight Energy Resources, In","Torchlight Energy Resources, Inc., through its subsidiaries, engages in the acquisition, exploration, exploitation, and/or development of oil and natural gas properties in the United States. As of December 31, 2019, it had interests in four oil and gas projects, including the Orogrande project in Hudspeth County, Texas; Hazel project in Sterling, Tom Green, and Irion Counties, Texas; Winkler project in Winkler County, Texas; and Hunton wells in partnership with Husky Ventures in central Oklahoma. The company was founded in 2010 and is headquartered in Plano, Texas."
TRCH,2019-12-31,NA,-9839396,NA,-9839396,3273697,294938,-7376360,-7376360,-968292,0,746263,8122623,451325,-2463036,NA,-9839396,-9839396,4441,income_statement,Oil & Gas E&P,"Torchlight Energy Resources, In","Torchlight Energy Resources, Inc., through its subsidiaries, engages in the acquisition, exploration, exploitation, and/or development of oil and natural gas properties in the United States. As of December 31, 2019, it had interests in four oil and gas projects, including the Orogrande project in Hudspeth County, Texas; Hazel project in Sterling, Tom Green, and Irion Counties, Texas; Winkler project in Winkler County, Texas; and Hunton wells in partnership with Husky Ventures in central Oklahoma. The company was founded in 2010 and is headquartered in Plano, Texas."
TREE,2016-12-31,13761000,51574000,589000,27494000,297827000,370638000,52863000,52863000,-561000,20366000,384402000,331539000,13764000,-1289000,-3714000,31208000,27494000,NA,income_statement,Mortgage Finance,"LendingTree, Inc.","LendingTree, Inc., through its subsidiary, LendingTree, LLC, operates online consumer platform in the United States. It operates through Home, Consumer, and Insurance segments. The company's Home segment offers purchase mortgage, refinance mortgage, reverse mortgage, and home equity loans; lines of credit; and real estate brokerage services. Its Consumer segment provides credit cards; personal, small business, student, and auto loans; deposit accounts; and other credit products, such as credit repair and debt settlement services. The company's Insurance segment includes information, tools, and access to insurance quote products, including home and automobile, through which consumers are matched with insurance lead aggregators to obtain insurance offers. It also operates CompareCards, an online source for side-by-side credit card comparison shopping; SimpleTuition, an online marketing platform for student loans; MagnifyMoney, a consumer facing media property that offers editorial content, expert commentary, tools, and resources; SnapCap, an online platform, which connects business owners with lenders; ValuePenguin, a personal finance website that offers consumers objective analysis; QuoteWizard.com, a marketplace for insurance comparison; and Student Loan Hero, a personal finance website dedicated to helping student loan borrowers manage their student debt. The company was formerly known as Tree.com, Inc. and changed its name to LendingTree, Inc. in January 2015. LendingTree, Inc. was founded in 1996 and is headquartered in Charlotte, North Carolina."
TREE,2017-12-31,17925000,25709000,589000,15578000,503325000,600513000,59186000,59186000,-7028000,6291000,617736000,558550000,17223000,-33477000,-3840000,19418000,15578000,NA,income_statement,Mortgage Finance,"LendingTree, Inc.","LendingTree, Inc., through its subsidiary, LendingTree, LLC, operates online consumer platform in the United States. It operates through Home, Consumer, and Insurance segments. The company's Home segment offers purchase mortgage, refinance mortgage, reverse mortgage, and home equity loans; lines of credit; and real estate brokerage services. Its Consumer segment provides credit cards; personal, small business, student, and auto loans; deposit accounts; and other credit products, such as credit repair and debt settlement services. The company's Insurance segment includes information, tools, and access to insurance quote products, including home and automobile, through which consumers are matched with insurance lead aggregators to obtain insurance offers. It also operates CompareCards, an online source for side-by-side credit card comparison shopping; SimpleTuition, an online marketing platform for student loans; MagnifyMoney, a consumer facing media property that offers editorial content, expert commentary, tools, and resources; SnapCap, an online platform, which connects business owners with lenders; ValuePenguin, a personal finance website that offers consumers objective analysis; QuoteWizard.com, a marketplace for insurance comparison; and Student Loan Hero, a personal finance website dedicated to helping student loan borrowers manage their student debt. The company was formerly known as Tree.com, Inc. and changed its name to LendingTree, Inc. in January 2015. LendingTree, Inc. was founded in 1996 and is headquartered in Charlotte, North Carolina."
TREE,2018-12-31,26958000,43744000,NA,96499000,594210000,728466000,76445000,76445000,-12437000,-65575000,764865000,688420000,36399000,-32701000,-12820000,109319000,96499000,NA,income_statement,Mortgage Finance,"LendingTree, Inc.","LendingTree, Inc., through its subsidiary, LendingTree, LLC, operates online consumer platform in the United States. It operates through Home, Consumer, and Insurance segments. The company's Home segment offers purchase mortgage, refinance mortgage, reverse mortgage, and home equity loans; lines of credit; and real estate brokerage services. Its Consumer segment provides credit cards; personal, small business, student, and auto loans; deposit accounts; and other credit products, such as credit repair and debt settlement services. The company's Insurance segment includes information, tools, and access to insurance quote products, including home and automobile, through which consumers are matched with insurance lead aggregators to obtain insurance offers. It also operates CompareCards, an online source for side-by-side credit card comparison shopping; SimpleTuition, an online marketing platform for student loans; MagnifyMoney, a consumer facing media property that offers editorial content, expert commentary, tools, and resources; SnapCap, an online platform, which connects business owners with lenders; ValuePenguin, a personal finance website that offers consumers objective analysis; QuoteWizard.com, a marketplace for insurance comparison; and Student Loan Hero, a personal finance website dedicated to helping student loan borrowers manage their student debt. The company was formerly known as Tree.com, Inc. and changed its name to LendingTree, Inc. in January 2015. LendingTree, Inc. was founded in 1996 and is headquartered in Charlotte, North Carolina."
TREE,2019-12-31,39953000,30981000,NA,17828000,851927000,1038224000,80105000,80105000,-20271000,-8479000,1106603000,1026498000,68379000,-49124000,-21632000,39460000,17828000,NA,income_statement,Mortgage Finance,"LendingTree, Inc.","LendingTree, Inc., through its subsidiary, LendingTree, LLC, operates online consumer platform in the United States. It operates through Home, Consumer, and Insurance segments. The company's Home segment offers purchase mortgage, refinance mortgage, reverse mortgage, and home equity loans; lines of credit; and real estate brokerage services. Its Consumer segment provides credit cards; personal, small business, student, and auto loans; deposit accounts; and other credit products, such as credit repair and debt settlement services. The company's Insurance segment includes information, tools, and access to insurance quote products, including home and automobile, through which consumers are matched with insurance lead aggregators to obtain insurance offers. It also operates CompareCards, an online source for side-by-side credit card comparison shopping; SimpleTuition, an online marketing platform for student loans; MagnifyMoney, a consumer facing media property that offers editorial content, expert commentary, tools, and resources; SnapCap, an online platform, which connects business owners with lenders; ValuePenguin, a personal finance website that offers consumers objective analysis; QuoteWizard.com, a marketplace for insurance comparison; and Student Loan Hero, a personal finance website dedicated to helping student loan borrowers manage their student debt. The company was formerly known as Tree.com, Inc. and changed its name to LendingTree, Inc. in January 2015. LendingTree, Inc. was founded in 1996 and is headquartered in Charlotte, North Carolina."
TRHC,2016-12-31,3811000,-4980000,NA,-5521000,15746000,29614000,4942000,4942000,-4488000,541000,94791000,89849000,65177000,-9922000,NA,-5521000,-3082000,NA,income_statement,Health Information Services,"Tabula Rasa HealthCare, Inc.","Tabula Rasa HealthCare, Inc. provides patient-specific and data-driven technology and solutions in the field of medication safety in the United States. Its proprietary Medication Risk Mitigation Matrix delivers a multi-drug review, which identifies medication-related risks. The company offers EireneRx, a cloud-based medication decision-support and e-prescribing platform to access patients' medication-related information; and MedWise that provides medication decision support components for clients seeking to manage their medication risk and improve medication outcomes, and patient relationships by enhancing their existing systems. Its cloud-based software also comprise RxCompanion, an MTM software platform designed to aid in the identification and resolution of medication and other health related problems; TruChart, an electronic health record (EHR) system for Programs of All-Inclusive Care for the Elderly (PACE) organizations; and PACElogic, which delivers real-time sharable workflows comprising EHR, customer relationship management, claims adjudication, electronic data interchange, care management, coordination, planning, integration with community-based providers, and various Federal and State required reporting. In addition, the company offers clinical pharmacist collaboration, prescription fulfillment and reminder packaging, and pharmacy cost management services, as well as health plan management services, including risk adjustment and third party administrator services. As of December 31, 2019, it served 237 healthcare organizations. The company provides its cloud-based software solutions to prescribers, pharmacists, pharmacies, and healthcare organizations for managing the medication-related needs of patients. It has collaboration with Innovative Integrated Health Community Plans, Inc.; and RxResults. Tabula Rasa HealthCare, Inc. was founded in 2009 and is headquartered in Moorestown, New Jersey."
TRHC,2017-12-31,5628000,3452000,NA,12791000,25708000,39830000,-1018000,-1018000,-688000,-9339000,133485000,134503000,93655000,4470000,NA,12791000,12791000,NA,income_statement,Health Information Services,"Tabula Rasa HealthCare, Inc.","Tabula Rasa HealthCare, Inc. provides patient-specific and data-driven technology and solutions in the field of medication safety in the United States. Its proprietary Medication Risk Mitigation Matrix delivers a multi-drug review, which identifies medication-related risks. The company offers EireneRx, a cloud-based medication decision-support and e-prescribing platform to access patients' medication-related information; and MedWise that provides medication decision support components for clients seeking to manage their medication risk and improve medication outcomes, and patient relationships by enhancing their existing systems. Its cloud-based software also comprise RxCompanion, an MTM software platform designed to aid in the identification and resolution of medication and other health related problems; TruChart, an electronic health record (EHR) system for Programs of All-Inclusive Care for the Elderly (PACE) organizations; and PACElogic, which delivers real-time sharable workflows comprising EHR, customer relationship management, claims adjudication, electronic data interchange, care management, coordination, planning, integration with community-based providers, and various Federal and State required reporting. In addition, the company offers clinical pharmacist collaboration, prescription fulfillment and reminder packaging, and pharmacy cost management services, as well as health plan management services, including risk adjustment and third party administrator services. As of December 31, 2019, it served 237 healthcare organizations. The company provides its cloud-based software solutions to prescribers, pharmacists, pharmacies, and healthcare organizations for managing the medication-related needs of patients. It has collaboration with Innovative Integrated Health Community Plans, Inc.; and RxResults. Tabula Rasa HealthCare, Inc. was founded in 2009 and is headquartered in Moorestown, New Jersey."
TRHC,2018-12-31,12222000,-50645000,NA,-47269000,35971000,66601000,1606000,1606000,-906000,-3376000,204270000,202664000,137669000,-101719000,NA,-47269000,-47269000,NA,income_statement,Health Information Services,"Tabula Rasa HealthCare, Inc.","Tabula Rasa HealthCare, Inc. provides patient-specific and data-driven technology and solutions in the field of medication safety in the United States. Its proprietary Medication Risk Mitigation Matrix delivers a multi-drug review, which identifies medication-related risks. The company offers EireneRx, a cloud-based medication decision-support and e-prescribing platform to access patients' medication-related information; and MedWise that provides medication decision support components for clients seeking to manage their medication risk and improve medication outcomes, and patient relationships by enhancing their existing systems. Its cloud-based software also comprise RxCompanion, an MTM software platform designed to aid in the identification and resolution of medication and other health related problems; TruChart, an electronic health record (EHR) system for Programs of All-Inclusive Care for the Elderly (PACE) organizations; and PACElogic, which delivers real-time sharable workflows comprising EHR, customer relationship management, claims adjudication, electronic data interchange, care management, coordination, planning, integration with community-based providers, and various Federal and State required reporting. In addition, the company offers clinical pharmacist collaboration, prescription fulfillment and reminder packaging, and pharmacy cost management services, as well as health plan management services, including risk adjustment and third party administrator services. As of December 31, 2019, it served 237 healthcare organizations. The company provides its cloud-based software solutions to prescribers, pharmacists, pharmacies, and healthcare organizations for managing the medication-related needs of patients. It has collaboration with Innovative Integrated Health Community Plans, Inc.; and RxResults. Tabula Rasa HealthCare, Inc. was founded in 2009 and is headquartered in Moorestown, New Jersey."
TRHC,2019-12-31,21739000,-48635000,NA,-32436000,72823000,103352000,-25486000,-25486000,-15986000,-16199000,284707000,310193000,181355000,-23149000,NA,-32436000,-32436000,NA,income_statement,Health Information Services,"Tabula Rasa HealthCare, Inc.","Tabula Rasa HealthCare, Inc. provides patient-specific and data-driven technology and solutions in the field of medication safety in the United States. Its proprietary Medication Risk Mitigation Matrix delivers a multi-drug review, which identifies medication-related risks. The company offers EireneRx, a cloud-based medication decision-support and e-prescribing platform to access patients' medication-related information; and MedWise that provides medication decision support components for clients seeking to manage their medication risk and improve medication outcomes, and patient relationships by enhancing their existing systems. Its cloud-based software also comprise RxCompanion, an MTM software platform designed to aid in the identification and resolution of medication and other health related problems; TruChart, an electronic health record (EHR) system for Programs of All-Inclusive Care for the Elderly (PACE) organizations; and PACElogic, which delivers real-time sharable workflows comprising EHR, customer relationship management, claims adjudication, electronic data interchange, care management, coordination, planning, integration with community-based providers, and various Federal and State required reporting. In addition, the company offers clinical pharmacist collaboration, prescription fulfillment and reminder packaging, and pharmacy cost management services, as well as health plan management services, including risk adjustment and third party administrator services. As of December 31, 2019, it served 237 healthcare organizations. The company provides its cloud-based software solutions to prescribers, pharmacists, pharmacies, and healthcare organizations for managing the medication-related needs of patients. It has collaboration with Innovative Integrated Health Community Plans, Inc.; and RxResults. Tabula Rasa HealthCare, Inc. was founded in 2009 and is headquartered in Moorestown, New Jersey."
TRIB,2016-12-31,5040000,-42140000,NA,-100625000,30366000,43484000,8317000,8317000,-5439000,-3557000,99611000,91294000,56127000,-50457000,-62042000,-38583000,-100625000,-239000,income_statement,Diagnostics & Research,Trinity Biotech plc,"Trinity Biotech plc acquires, develops, manufactures, and markets medical diagnostic products for the clinical laboratory and point-of-care (POC) segments of the diagnostic market in the United States, Africa, Asia, and Europe. The company offers clinical laboratory products, including diagnostic tests and instrumentation, which detect infectious diseases, such as lyme disease; sexually transmitted diseases consisting syphilis and herpes; and epstein barr, measles, mumps, toxoplasmosis, cytomegalovirus, rubella, varicella and other viral pathogens, as well as products for the in-vitro diagnostic testing for haemoglobin A1c used in the monitoring and diagnosis of diabetes, and identifying those who are at a risk of developing diabetes. It also develops, manufactures, and distributes products in the immunofluorescence assay, enzyme-linked immunosorbent, western blot, and line immunoassay formats; and provides reagent products, such as ACE, bile acids, lactate, oxalate, and glucose-6-phosphate dehydrogenase for diagnosis of liver and kidney diseases, as well as haemolytic anaemia. In addition, the company sells raw materials to the life sciences industry and research institutes. The company sells its products through its direct sales force; and a network of independent distributors and strategic partners. Its customers include public health facilities, hospitals, and other outreach facilities, as well as clinical and reference laboratories. Trinity Biotech plc was founded in 1992 and is headquartered in Bray, Ireland."
TRIB,2017-12-31,5657000,-39875000,NA,-40270000,30855000,41890000,5478000,5478000,-5405000,-1214000,99140000,93662000,57250000,-45353000,-1609000,-38661000,-40270000,-100000,income_statement,Diagnostics & Research,Trinity Biotech plc,"Trinity Biotech plc acquires, develops, manufactures, and markets medical diagnostic products for the clinical laboratory and point-of-care (POC) segments of the diagnostic market in the United States, Africa, Asia, and Europe. The company offers clinical laboratory products, including diagnostic tests and instrumentation, which detect infectious diseases, such as lyme disease; sexually transmitted diseases consisting syphilis and herpes; and epstein barr, measles, mumps, toxoplasmosis, cytomegalovirus, rubella, varicella and other viral pathogens, as well as products for the in-vitro diagnostic testing for haemoglobin A1c used in the monitoring and diagnosis of diabetes, and identifying those who are at a risk of developing diabetes. It also develops, manufactures, and distributes products in the immunofluorescence assay, enzyme-linked immunosorbent, western blot, and line immunoassay formats; and provides reagent products, such as ACE, bile acids, lactate, oxalate, and glucose-6-phosphate dehydrogenase for diagnosis of liver and kidney diseases, as well as haemolytic anaemia. In addition, the company sells raw materials to the life sciences industry and research institutes. The company sells its products through its direct sales force; and a network of independent distributors and strategic partners. Its customers include public health facilities, hospitals, and other outreach facilities, as well as clinical and reference laboratories. Trinity Biotech plc was founded in 1992 and is headquartered in Bray, Ireland."
TRIB,2018-12-31,5369000,-23183000,NA,-22090000,29477000,41449000,6705000,6705000,-5080000,-525000,97035000,90330000,55586000,-29888000,568000,-22658000,-22090000,-102000,income_statement,Diagnostics & Research,Trinity Biotech plc,"Trinity Biotech plc acquires, develops, manufactures, and markets medical diagnostic products for the clinical laboratory and point-of-care (POC) segments of the diagnostic market in the United States, Africa, Asia, and Europe. The company offers clinical laboratory products, including diagnostic tests and instrumentation, which detect infectious diseases, such as lyme disease; sexually transmitted diseases consisting syphilis and herpes; and epstein barr, measles, mumps, toxoplasmosis, cytomegalovirus, rubella, varicella and other viral pathogens, as well as products for the in-vitro diagnostic testing for haemoglobin A1c used in the monitoring and diagnosis of diabetes, and identifying those who are at a risk of developing diabetes. It also develops, manufactures, and distributes products in the immunofluorescence assay, enzyme-linked immunosorbent, western blot, and line immunoassay formats; and provides reagent products, such as ACE, bile acids, lactate, oxalate, and glucose-6-phosphate dehydrogenase for diagnosis of liver and kidney diseases, as well as haemolytic anaemia. In addition, the company sells raw materials to the life sciences industry and research institutes. The company sells its products through its direct sales force; and a network of independent distributors and strategic partners. Its customers include public health facilities, hospitals, and other outreach facilities, as well as clinical and reference laboratories. Trinity Biotech plc was founded in 1992 and is headquartered in Bray, Ireland."
TRIB,2019-12-31,5325000,-29997000,NA,-28914000,32703000,38120000,183000,183000,-6582000,-1006000,90435000,90252000,52315000,-30180000,77000,-28991000,-28914000,-91000,income_statement,Diagnostics & Research,Trinity Biotech plc,"Trinity Biotech plc acquires, develops, manufactures, and markets medical diagnostic products for the clinical laboratory and point-of-care (POC) segments of the diagnostic market in the United States, Africa, Asia, and Europe. The company offers clinical laboratory products, including diagnostic tests and instrumentation, which detect infectious diseases, such as lyme disease; sexually transmitted diseases consisting syphilis and herpes; and epstein barr, measles, mumps, toxoplasmosis, cytomegalovirus, rubella, varicella and other viral pathogens, as well as products for the in-vitro diagnostic testing for haemoglobin A1c used in the monitoring and diagnosis of diabetes, and identifying those who are at a risk of developing diabetes. It also develops, manufactures, and distributes products in the immunofluorescence assay, enzyme-linked immunosorbent, western blot, and line immunoassay formats; and provides reagent products, such as ACE, bile acids, lactate, oxalate, and glucose-6-phosphate dehydrogenase for diagnosis of liver and kidney diseases, as well as haemolytic anaemia. In addition, the company sells raw materials to the life sciences industry and research institutes. The company sells its products through its direct sales force; and a network of independent distributors and strategic partners. Its customers include public health facilities, hospitals, and other outreach facilities, as well as clinical and reference laboratories. Trinity Biotech plc was founded in 1992 and is headquartered in Bray, Ireland."
TRIL,2016-12-31,29580000,-35414000,NA,-31733000,3826000,0,-33406000,-33406000,-82000,-3681000,0,33406000,0,-2008000,NA,-31733000,-31733000,NA,income_statement,Biotechnology,Trillium Therapeutics Inc.,"Trillium Therapeutics Inc., a clinical stage immuno-oncology company, develops therapies for the treatment of cancer. The company's lead program is TTI-621, a SIRPaFc fusion protein that acts a soluble decoy receptor preventing CD47 from delivering its inhibitory signal, which is in Phase I clinical trial for advanced relapsed or refractory hematologic malignancies, and solid tumors and mycosis fungoides. Its product candidates also include TTI-622 that is in Phase I clinical trial of immunoglobulin G4 SIRPaFc protein; and TTI-10001, a small molecule stimulator of interferon genes agonist that senses cytosolic DNA for promoting tumor immunity, which is in the discovery Phase. The company was formerly known as Stem Cell Therapeutics Corp. and changed its name to Trillium Therapeutics Inc. in June 2014. Trillium Therapeutics Inc. was founded in 2004 is headquartered in Mississauga, Canada."
TRIL,2017-12-31,38293000,-45084000,NA,-45088000,3861000,0,-42154000,-42154000,-68000,4000,0,42154000,0,-2930000,NA,-45088000,-45088000,NA,income_statement,Biotechnology,Trillium Therapeutics Inc.,"Trillium Therapeutics Inc., a clinical stage immuno-oncology company, develops therapies for the treatment of cancer. The company's lead program is TTI-621, a SIRPaFc fusion protein that acts a soluble decoy receptor preventing CD47 from delivering its inhibitory signal, which is in Phase I clinical trial for advanced relapsed or refractory hematologic malignancies, and solid tumors and mycosis fungoides. Its product candidates also include TTI-622 that is in Phase I clinical trial of immunoglobulin G4 SIRPaFc protein; and TTI-10001, a small molecule stimulator of interferon genes agonist that senses cytosolic DNA for promoting tumor immunity, which is in the discovery Phase. The company was formerly known as Stem Cell Therapeutics Corp. and changed its name to Trillium Therapeutics Inc. in June 2014. Trillium Therapeutics Inc. was founded in 2004 is headquartered in Mississauga, Canada."
TRIL,2018-12-31,34096000,-32859000,NA,-32866000,2786000,0,-36882000,-36882000,-35000,7000,0,36882000,0,4023000,NA,-32866000,-32866000,NA,income_statement,Biotechnology,Trillium Therapeutics Inc.,"Trillium Therapeutics Inc., a clinical stage immuno-oncology company, develops therapies for the treatment of cancer. The company's lead program is TTI-621, a SIRPaFc fusion protein that acts a soluble decoy receptor preventing CD47 from delivering its inhibitory signal, which is in Phase I clinical trial for advanced relapsed or refractory hematologic malignancies, and solid tumors and mycosis fungoides. Its product candidates also include TTI-622 that is in Phase I clinical trial of immunoglobulin G4 SIRPaFc protein; and TTI-10001, a small molecule stimulator of interferon genes agonist that senses cytosolic DNA for promoting tumor immunity, which is in the discovery Phase. The company was formerly known as Stem Cell Therapeutics Corp. and changed its name to Trillium Therapeutics Inc. in June 2014. Trillium Therapeutics Inc. was founded in 2004 is headquartered in Mississauga, Canada."
TRIL,2019-12-31,27266000,-41594000,NA,-41622000,5439000,124000,-32581000,-32581000,-177000,28000,124000,32705000,0,-9013000,NA,-41622000,-41622000,NA,income_statement,Biotechnology,Trillium Therapeutics Inc.,"Trillium Therapeutics Inc., a clinical stage immuno-oncology company, develops therapies for the treatment of cancer. The company's lead program is TTI-621, a SIRPaFc fusion protein that acts a soluble decoy receptor preventing CD47 from delivering its inhibitory signal, which is in Phase I clinical trial for advanced relapsed or refractory hematologic malignancies, and solid tumors and mycosis fungoides. Its product candidates also include TTI-622 that is in Phase I clinical trial of immunoglobulin G4 SIRPaFc protein; and TTI-10001, a small molecule stimulator of interferon genes agonist that senses cytosolic DNA for promoting tumor immunity, which is in the discovery Phase. The company was formerly known as Stem Cell Therapeutics Corp. and changed its name to Trillium Therapeutics Inc. in June 2014. Trillium Therapeutics Inc. was founded in 2004 is headquartered in Mississauga, Canada."
TRIN,2019-12-31,NA,-1258397,NA,-1258397,1258397,0,-1258397,-1258397,NA,0,0,1258397,0,0,NA,-1258397,-1258397,NA,income_statement,Asset Management,Trinity Capital Inc.,"Trinity, an internally managed specialty lending company that has elected to be regulated as a business development company under the Investment Company Act of 1940, is a leading provider of debt, including loans and equipment financing, to growth stage companies, including venture-backed companies and companies with institutional equity investors. Trinity's investment objective is to generate current income and, to a lesser extent, capital appreciation through investments consisting primarily of term loans and equipment financings and, to a lesser extent, working capital loans, equity and equity-related investments. Trinity believes it is one of only a select group of specialty lenders that has the depth of knowledge, experience, and track record in lending to growth stage companies. For more information, please visit https://trincapinvestment.com/."
TRIP,2017-12-31,243000000,110000000,NA,-19000000,1006000000,1484000000,124000000,124000000,-15000000,129000000,1556000000,1432000000,72000000,-14000000,NA,-19000000,-19000000,3000000,income_statement,Travel Services,"TripAdvisor, Inc.","TripAdvisor, Inc. operates as an online travel company. It operates in two segments, Hotels, Media & Platform; and Experiences & Dining. The company operates TripAdvisor-branded Websites, including tripadvisor.com in the United States; and localized versions of the Website in 48 markets and 28 languages. It also manages and operates other travel media brands that provide users the comprehensive travel-planning and trip-taking resources in the travel industry, such as bokun.io, bookingbuddy.com, cruisecritic.com, familyvacationcritic.com, flipkey.com, thefork.com, holidaylettings.co.uk, holidaywatchdog.com, housetrip.com, jetsetter.com, niumba.com, onetime.com, oyster.com, seatguru.com, singleplatform.com, smartertravel.com, vacationhomerentals.com, and viator.com. In addition, the company provides information and services for consumers to research and book restaurants in travel destinations; and vacation and short-term rental properties, including full home rentals, condominiums, villas, beach rentals, cabins, and cottages. Its Websites feature 859 million reviews and opinions on 8.6 million places comprising 1.4 million hotels, inns, B&Bs, and specialty lodging; 842,000 rental properties; 5.2 million restaurants; and 1.2 million travel activities and experiences worldwide. TripAdvisor, Inc. was founded in 2000 and is headquartered in Needham, Massachusetts."
TRIP,2018-12-31,275000000,173000000,NA,113000000,950000000,1529000000,188000000,188000000,-12000000,60000000,1615000000,1427000000,86000000,-15000000,NA,113000000,113000000,3000000,income_statement,Travel Services,"TripAdvisor, Inc.","TripAdvisor, Inc. operates as an online travel company. It operates in two segments, Hotels, Media & Platform; and Experiences & Dining. The company operates TripAdvisor-branded Websites, including tripadvisor.com in the United States; and localized versions of the Website in 48 markets and 28 languages. It also manages and operates other travel media brands that provide users the comprehensive travel-planning and trip-taking resources in the travel industry, such as bokun.io, bookingbuddy.com, cruisecritic.com, familyvacationcritic.com, flipkey.com, thefork.com, holidaylettings.co.uk, holidaywatchdog.com, housetrip.com, jetsetter.com, niumba.com, onetime.com, oyster.com, seatguru.com, singleplatform.com, smartertravel.com, vacationhomerentals.com, and viator.com. In addition, the company provides information and services for consumers to research and book restaurants in travel destinations; and vacation and short-term rental properties, including full home rentals, condominiums, villas, beach rentals, cabins, and cottages. Its Websites feature 859 million reviews and opinions on 8.6 million places comprising 1.4 million hotels, inns, B&Bs, and specialty lodging; 842,000 rental properties; 5.2 million restaurants; and 1.2 million travel activities and experiences worldwide. TripAdvisor, Inc. was founded in 2000 and is headquartered in Needham, Massachusetts."
TRIP,2019-12-31,294000000,194000000,NA,126000000,854000000,1466000000,189000000,189000000,-7000000,68000000,1560000000,1371000000,94000000,5000000,NA,126000000,126000000,3000000,income_statement,Travel Services,"TripAdvisor, Inc.","TripAdvisor, Inc. operates as an online travel company. It operates in two segments, Hotels, Media & Platform; and Experiences & Dining. The company operates TripAdvisor-branded Websites, including tripadvisor.com in the United States; and localized versions of the Website in 48 markets and 28 languages. It also manages and operates other travel media brands that provide users the comprehensive travel-planning and trip-taking resources in the travel industry, such as bokun.io, bookingbuddy.com, cruisecritic.com, familyvacationcritic.com, flipkey.com, thefork.com, holidaylettings.co.uk, holidaywatchdog.com, housetrip.com, jetsetter.com, niumba.com, onetime.com, oyster.com, seatguru.com, singleplatform.com, smartertravel.com, vacationhomerentals.com, and viator.com. In addition, the company provides information and services for consumers to research and book restaurants in travel destinations; and vacation and short-term rental properties, including full home rentals, condominiums, villas, beach rentals, cabins, and cottages. Its Websites feature 859 million reviews and opinions on 8.6 million places comprising 1.4 million hotels, inns, B&Bs, and specialty lodging; 842,000 rental properties; 5.2 million restaurants; and 1.2 million travel activities and experiences worldwide. TripAdvisor, Inc. was founded in 2000 and is headquartered in Needham, Massachusetts."
TRIP,2020-12-31,220000000,-369000000,NA,-289000000,489000000,549000000,-285000000,-285000000,-35000000,-80000000,604000000,889000000,55000000,-84000000,NA,-289000000,-289000000,NA,income_statement,Travel Services,"TripAdvisor, Inc.","TripAdvisor, Inc. operates as an online travel company. It operates in two segments, Hotels, Media & Platform; and Experiences & Dining. The company operates TripAdvisor-branded Websites, including tripadvisor.com in the United States; and localized versions of the Website in 48 markets and 28 languages. It also manages and operates other travel media brands that provide users the comprehensive travel-planning and trip-taking resources in the travel industry, such as bokun.io, bookingbuddy.com, cruisecritic.com, familyvacationcritic.com, flipkey.com, thefork.com, holidaylettings.co.uk, holidaywatchdog.com, housetrip.com, jetsetter.com, niumba.com, onetime.com, oyster.com, seatguru.com, singleplatform.com, smartertravel.com, vacationhomerentals.com, and viator.com. In addition, the company provides information and services for consumers to research and book restaurants in travel destinations; and vacation and short-term rental properties, including full home rentals, condominiums, villas, beach rentals, cabins, and cottages. Its Websites feature 859 million reviews and opinions on 8.6 million places comprising 1.4 million hotels, inns, B&Bs, and specialty lodging; 842,000 rental properties; 5.2 million restaurants; and 1.2 million travel activities and experiences worldwide. TripAdvisor, Inc. was founded in 2000 and is headquartered in Needham, Massachusetts."
TRIT,2019-02-28,741619,-1895578,NA,-1895578,1146545,0,-1888164,-1888164,-1677,0,0,1888164,0,-7413,NA,-1895578,-1895578,NA,income_statement,Information Technology Services,"Triterras, Inc.","Triterras, Inc., though its subsidiaries, operates as a fintech company. The company operates Kratos, a commodity trading and trade finance platform that connects and enables commodity traders to trade and source capital from lenders directly online. The company is based in Singapore."
TRIT,2020-02-29,9172,15173340,NA,13580791,1427328,16794547,15174815,15174815,-54,1592549,16898178,1723363,103631,-1475,NA,13580791,13580791,NA,income_statement,Information Technology Services,"Triterras, Inc.","Triterras, Inc., though its subsidiaries, operates as a fintech company. The company operates Kratos, a commodity trading and trade finance platform that connects and enables commodity traders to trade and source capital from lenders directly online. The company is based in Singapore."
TRMB,2017-12-29,370200000,248200000,400000,118400000,694400000,1469800000,256400000,256400000,-25200000,129700000,2646500000,2390100000,1176700000,-8200000,NA,118500000,118400000,NA,income_statement,NA,NA,NA
TRMB,2018-12-28,446100000,278000000,400000,282800000,792700000,1786900000,368500000,368500000,-73200000,-5300000,3108400000,2739900000,1321500000,-90500000,NA,283300000,282800000,NA,income_statement,NA,NA,NA
TRMB,2020-01-03,469700000,344800000,1400000,514300000,814300000,1876100000,424300000,424300000,-82400000,-169700000,3264300000,2840000000,1388200000,-79500000,NA,514500000,514300000,NA,income_statement,NA,NA,NA
TRMB,2021-01-01,475900000,395000000,1700000,389900000,767900000,1850100000,448500000,448500000,-77600000,4400000,3147700000,2699200000,1297600000,-53500000,NA,390600000,389900000,NA,income_statement,NA,NA,NA
TRMD,2016-12-31,NA,-141731000,NA,-142491000,41406000,241537000,77612000,77612000,-29600000,760000,680143000,602531000,438606000,-219343000,NA,-142491000,-142491000,304000,income_statement,Oil & Gas Midstream,TORM plc,"TORM plc, a product tanker company, engages in the transportation of refined oil products worldwide. The company transports gasoline, jet fuel, naphtha, and diesel oil. As of March 13, 2020, it operated a fleet of approximately 80 vessels. The company was founded in 1889 and is based in London, the United Kingdom. TORM PLC is a subsidiary of Njord Luxco."
TRMD,2017-12-31,NA,3184000,NA,2407000,45007000,200212000,40336000,40336000,-33300000,777000,656991000,616655000,456779000,-37152000,NA,2407000,2407000,418000,income_statement,Oil & Gas Midstream,TORM plc,"TORM plc, a product tanker company, engages in the transportation of refined oil products worldwide. The company transports gasoline, jet fuel, naphtha, and diesel oil. As of March 13, 2020, it operated a fleet of approximately 80 vessels. The company was founded in 1889 and is based in London, the United Kingdom. TORM PLC is a subsidiary of Njord Luxco."
TRMD,2018-12-31,NA,-33221000,NA,-34779000,47826000,169399000,5130000,5130000,-35700000,1558000,635366000,630236000,465967000,-38351000,NA,-34779000,-34779000,1963000,income_statement,Oil & Gas Midstream,TORM plc,"TORM plc, a product tanker company, engages in the transportation of refined oil products worldwide. The company transports gasoline, jet fuel, naphtha, and diesel oil. As of March 13, 2020, it operated a fleet of approximately 80 vessels. The company was founded in 1889 and is based in London, the United Kingdom. TORM PLC is a subsidiary of Njord Luxco."
TRMD,2019-12-31,NA,166806000,NA,166022000,47724000,251888000,91129000,91129000,-39300000,784000,692610000,601481000,440722000,75677000,NA,166022000,166022000,2911000,income_statement,Oil & Gas Midstream,TORM plc,"TORM plc, a product tanker company, engages in the transportation of refined oil products worldwide. The company transports gasoline, jet fuel, naphtha, and diesel oil. As of March 13, 2020, it operated a fleet of approximately 80 vessels. The company was founded in 1889 and is based in London, the United Kingdom. TORM PLC is a subsidiary of Njord Luxco."
TRMK,2017-12-31,NA,154345000,NA,105630000,279485000,584514000,0,190209000,NA,48715000,584514000,394305000,0,-35864000,NA,105630000,105630000,114820000,income_statement,Banks—Regional,Trustmark Corporation,"Trustmark Corporation operates as the bank holding company for Trustmark National Bank that provides banking and other financial solutions to individuals and corporate institutions in the United States. The company offers checking, savings, and money market accounts; individual retirement accounts; certificates of deposits; financing for commercial and industrial projects, income producing commercial real estate, owner-occupied real estate, and construction and land development; and installment and real estate loans, and lines of credit. It also provides mortgage banking services, including construction financing, production of conventional and government insured mortgages, and secondary marketing and mortgage servicing; overdraft facilities; and treasury management services. In addition, the company provides wealth management and trust services, such as administration of personal trusts and estates; management of investment accounts for individuals, employee benefit plans, and charitable foundations; and corporate trust and institutional custody, securities brokerage, financial and estate planning, retirement plan, and investment management. Further, it offers business insurance products and services for medical professionals, construction, manufacturing, hospitality, real estate, and group life and health plans; and life and health insurance, and personal line policies for individual customers, as well as provides an intermediary vehicle for the provision of loans or investments in low-income communities. As of December 31, 2019, the company operated 178 full-service branches and 15 limited-service branches; and 236 automated teller machines and 14 interactive teller machines. Trustmark Corporation was founded in 1889 and is headquartered in Jackson, Mississippi."
TRMK,2018-12-31,NA,171853000,NA,149584000,289566000,587268000,0,174028000,NA,22269000,587268000,413240000,0,-2175000,NA,149584000,149584000,123674000,income_statement,Banks—Regional,Trustmark Corporation,"Trustmark Corporation operates as the bank holding company for Trustmark National Bank that provides banking and other financial solutions to individuals and corporate institutions in the United States. The company offers checking, savings, and money market accounts; individual retirement accounts; certificates of deposits; financing for commercial and industrial projects, income producing commercial real estate, owner-occupied real estate, and construction and land development; and installment and real estate loans, and lines of credit. It also provides mortgage banking services, including construction financing, production of conventional and government insured mortgages, and secondary marketing and mortgage servicing; overdraft facilities; and treasury management services. In addition, the company provides wealth management and trust services, such as administration of personal trusts and estates; management of investment accounts for individuals, employee benefit plans, and charitable foundations; and corporate trust and institutional custody, securities brokerage, financial and estate planning, retirement plan, and investment management. Further, it offers business insurance products and services for medical professionals, construction, manufacturing, hospitality, real estate, and group life and health plans; and life and health insurance, and personal line policies for individual customers, as well as provides an intermediary vehicle for the provision of loans or investments in low-income communities. As of December 31, 2019, the company operated 178 full-service branches and 15 limited-service branches; and 236 automated teller machines and 14 interactive teller machines. Trustmark Corporation was founded in 1889 and is headquartered in Jackson, Mississippi."
TRMK,2019-12-31,NA,173793000,NA,150460000,297599000,602795000,0,177699000,NA,23333000,602795000,425096000,0,-3906000,NA,150460000,150460000,127497000,income_statement,Banks—Regional,Trustmark Corporation,"Trustmark Corporation operates as the bank holding company for Trustmark National Bank that provides banking and other financial solutions to individuals and corporate institutions in the United States. The company offers checking, savings, and money market accounts; individual retirement accounts; certificates of deposits; financing for commercial and industrial projects, income producing commercial real estate, owner-occupied real estate, and construction and land development; and installment and real estate loans, and lines of credit. It also provides mortgage banking services, including construction financing, production of conventional and government insured mortgages, and secondary marketing and mortgage servicing; overdraft facilities; and treasury management services. In addition, the company provides wealth management and trust services, such as administration of personal trusts and estates; management of investment accounts for individuals, employee benefit plans, and charitable foundations; and corporate trust and institutional custody, securities brokerage, financial and estate planning, retirement plan, and investment management. Further, it offers business insurance products and services for medical professionals, construction, manufacturing, hospitality, real estate, and group life and health plans; and life and health insurance, and personal line policies for individual customers, as well as provides an intermediary vehicle for the provision of loans or investments in low-income communities. As of December 31, 2019, the company operated 178 full-service branches and 15 limited-service branches; and 236 automated teller machines and 14 interactive teller machines. Trustmark Corporation was founded in 1889 and is headquartered in Jackson, Mississippi."
TRMK,2020-12-31,NA,189782000,NA,160025000,317723000,665017000,0,197840000,NA,29757000,665017000,467177000,0,-8058000,NA,160025000,160025000,149454000,income_statement,Banks—Regional,Trustmark Corporation,"Trustmark Corporation operates as the bank holding company for Trustmark National Bank that provides banking and other financial solutions to individuals and corporate institutions in the United States. The company offers checking, savings, and money market accounts; individual retirement accounts; certificates of deposits; financing for commercial and industrial projects, income producing commercial real estate, owner-occupied real estate, and construction and land development; and installment and real estate loans, and lines of credit. It also provides mortgage banking services, including construction financing, production of conventional and government insured mortgages, and secondary marketing and mortgage servicing; overdraft facilities; and treasury management services. In addition, the company provides wealth management and trust services, such as administration of personal trusts and estates; management of investment accounts for individuals, employee benefit plans, and charitable foundations; and corporate trust and institutional custody, securities brokerage, financial and estate planning, retirement plan, and investment management. Further, it offers business insurance products and services for medical professionals, construction, manufacturing, hospitality, real estate, and group life and health plans; and life and health insurance, and personal line policies for individual customers, as well as provides an intermediary vehicle for the provision of loans or investments in low-income communities. As of December 31, 2019, the company operated 178 full-service branches and 15 limited-service branches; and 236 automated teller machines and 14 interactive teller machines. Trustmark Corporation was founded in 1889 and is headquartered in Jackson, Mississippi."
TRMT,2017-12-31,NA,-2221715,NA,-2221715,1868572,380571,0,-2221715,NA,0,380571,2602286,0,0,NA,-2221715,-2221715,733714,income_statement,REIT—Mortgage,Tremont Mortgage Trust,"Tremont Mortgage Trust, a real estate investment trust (REIT), focuses on originating and investing in first mortgage loans secured by middle market and transitional commercial real estate in the United States. The company qualifies as a REIT for federal income tax purposes. It generally would not be subject to federal corporate income taxes if it distributes at least 90% of its taxable income to its stockholders. Tremont Mortgage Trust was founded in 2017 and is headquartered in Newton, Massachusetts. Tremont Mortgage Trust is a subsidiary of Tremont Realty Advisors LLC."
TRMT,2018-12-31,NA,-1608000,NA,-1608000,2548000,2400000,0,-1608000,NA,0,2400000,4008000,0,0,NA,-1608000,-1608000,1460000,income_statement,REIT—Mortgage,Tremont Mortgage Trust,"Tremont Mortgage Trust, a real estate investment trust (REIT), focuses on originating and investing in first mortgage loans secured by middle market and transitional commercial real estate in the United States. The company qualifies as a REIT for federal income tax purposes. It generally would not be subject to federal corporate income taxes if it distributes at least 90% of its taxable income to its stockholders. Tremont Mortgage Trust was founded in 2017 and is headquartered in Newton, Massachusetts. Tremont Mortgage Trust is a subsidiary of Tremont Realty Advisors LLC."
TRMT,2019-12-31,NA,4841000,NA,4841000,2130000,8585000,0,4998000,NA,0,8585000,3587000,0,-157000,NA,4841000,4841000,1457000,income_statement,REIT—Mortgage,Tremont Mortgage Trust,"Tremont Mortgage Trust, a real estate investment trust (REIT), focuses on originating and investing in first mortgage loans secured by middle market and transitional commercial real estate in the United States. The company qualifies as a REIT for federal income tax purposes. It generally would not be subject to federal corporate income taxes if it distributes at least 90% of its taxable income to its stockholders. Tremont Mortgage Trust was founded in 2017 and is headquartered in Newton, Massachusetts. Tremont Mortgage Trust is a subsidiary of Tremont Realty Advisors LLC."
TRMT,2020-12-31,NA,8926000,NA,8851000,2354000,12439000,0,8926000,NA,75000,12439000,3513000,0,0,NA,8851000,8851000,1159000,income_statement,REIT—Mortgage,Tremont Mortgage Trust,"Tremont Mortgage Trust, a real estate investment trust (REIT), focuses on originating and investing in first mortgage loans secured by middle market and transitional commercial real estate in the United States. The company qualifies as a REIT for federal income tax purposes. It generally would not be subject to federal corporate income taxes if it distributes at least 90% of its taxable income to its stockholders. Tremont Mortgage Trust was founded in 2017 and is headquartered in Newton, Massachusetts. Tremont Mortgage Trust is a subsidiary of Tremont Realty Advisors LLC."
TRNS,2017-03-25,NA,7164000,NA,4522000,26936000,34970000,8034000,8034000,-719000,2642000,143898000,135864000,108928000,-870000,NA,4522000,4522000,NA,income_statement,Industrial Distribution,"Transcat, Inc.","Transcat, Inc. provides calibration and laboratory instrument services in North America and internationally. It operates in two segments, Service and Distribution. The Service segment offers calibration, repair, inspection, analytical qualification, preventative maintenance, consulting, and other related services. This segment also provides CalTrak, a proprietary document and asset management software that is used to integrate and manage the workflow of its calibration service centers and customers' assets; and Compliance, Control and Cost, an online customer portal that provides its customers with Web-based asset management capability, as well as a safe and secure off-site archive of calibration and other service records. The Distribution segment sells and rents test, measurement, and control instruments for customers' test and measurement instrumentation needs. This segment markets and sells its products through Website, digital and print advertising, proactive outbound sales, and an inbound call center. The company provides services and products to highly regulated industries, principally life science, which includes companies in the pharmaceutical, biotechnology, medical device, and other FDA-regulated industries; and additional industries, including aerospace and defense industrial manufacturing, oil and gas and alternative energy, and other industries that require accuracy in processes and confirmation of the capabilities of their equipment. Transcat, Inc. was founded in 1964 and is headquartered in Rochester, New York."
TRNS,2018-03-31,NA,7948000,NA,5922000,28415000,37441000,9026000,9026000,-1018000,2026000,155141000,146115000,117700000,-1078000,NA,5922000,5922000,NA,income_statement,Industrial Distribution,"Transcat, Inc.","Transcat, Inc. provides calibration and laboratory instrument services in North America and internationally. It operates in two segments, Service and Distribution. The Service segment offers calibration, repair, inspection, analytical qualification, preventative maintenance, consulting, and other related services. This segment also provides CalTrak, a proprietary document and asset management software that is used to integrate and manage the workflow of its calibration service centers and customers' assets; and Compliance, Control and Cost, an online customer portal that provides its customers with Web-based asset management capability, as well as a safe and secure off-site archive of calibration and other service records. The Distribution segment sells and rents test, measurement, and control instruments for customers' test and measurement instrumentation needs. This segment markets and sells its products through Website, digital and print advertising, proactive outbound sales, and an inbound call center. The company provides services and products to highly regulated industries, principally life science, which includes companies in the pharmaceutical, biotechnology, medical device, and other FDA-regulated industries; and additional industries, including aerospace and defense industrial manufacturing, oil and gas and alternative energy, and other industries that require accuracy in processes and confirmation of the capabilities of their equipment. Transcat, Inc. was founded in 1964 and is headquartered in Rochester, New York."
TRNS,2019-03-30,NA,9235000,NA,7145000,29114000,39343000,10229000,10229000,-903000,2090000,160898000,150669000,121555000,-994000,NA,7145000,7145000,NA,income_statement,Industrial Distribution,"Transcat, Inc.","Transcat, Inc. provides calibration and laboratory instrument services in North America and internationally. It operates in two segments, Service and Distribution. The Service segment offers calibration, repair, inspection, analytical qualification, preventative maintenance, consulting, and other related services. This segment also provides CalTrak, a proprietary document and asset management software that is used to integrate and manage the workflow of its calibration service centers and customers' assets; and Compliance, Control and Cost, an online customer portal that provides its customers with Web-based asset management capability, as well as a safe and secure off-site archive of calibration and other service records. The Distribution segment sells and rents test, measurement, and control instruments for customers' test and measurement instrumentation needs. This segment markets and sells its products through Website, digital and print advertising, proactive outbound sales, and an inbound call center. The company provides services and products to highly regulated industries, principally life science, which includes companies in the pharmaceutical, biotechnology, medical device, and other FDA-regulated industries; and additional industries, including aerospace and defense industrial manufacturing, oil and gas and alternative energy, and other industries that require accuracy in processes and confirmation of the capabilities of their equipment. Transcat, Inc. was founded in 1964 and is headquartered in Rochester, New York."
TRNS,2020-03-28,NA,9730000,NA,8067000,31628000,42478000,10850000,10850000,-934000,1663000,173099000,162249000,130621000,-1120000,NA,8067000,8067000,NA,income_statement,Industrial Distribution,"Transcat, Inc.","Transcat, Inc. provides calibration and laboratory instrument services in North America and internationally. It operates in two segments, Service and Distribution. The Service segment offers calibration, repair, inspection, analytical qualification, preventative maintenance, consulting, and other related services. This segment also provides CalTrak, a proprietary document and asset management software that is used to integrate and manage the workflow of its calibration service centers and customers' assets; and Compliance, Control and Cost, an online customer portal that provides its customers with Web-based asset management capability, as well as a safe and secure off-site archive of calibration and other service records. The Distribution segment sells and rents test, measurement, and control instruments for customers' test and measurement instrumentation needs. This segment markets and sells its products through Website, digital and print advertising, proactive outbound sales, and an inbound call center. The company provides services and products to highly regulated industries, principally life science, which includes companies in the pharmaceutical, biotechnology, medical device, and other FDA-regulated industries; and additional industries, including aerospace and defense industrial manufacturing, oil and gas and alternative energy, and other industries that require accuracy in processes and confirmation of the capabilities of their equipment. Transcat, Inc. was founded in 1964 and is headquartered in Rochester, New York."
TROW,2017-12-31,NA,2505100000,992800000,1497800000,722600000,2781400000,2058800000,2058800000,NA,923900000,4854900000,2796100000,2073500000,446300000,NA,1581200000,1463900000,NA,income_statement,NA,NA,NA
TROW,2018-12-31,NA,2384600000,740300000,1837500000,779500000,3125700000,2346200000,2346200000,NA,615900000,5372600000,3026400000,2246900000,38400000,NA,1768700000,1793900000,NA,income_statement,NA,NA,NA
TROW,2019-12-31,NA,2927300000,1121000000,2131300000,846000000,3233000000,2387000000,2387000000,NA,678400000,5617900000,3230900000,2384900000,540300000,NA,2248900000,2076000000,NA,income_statement,NA,NA,NA
TROW,2020-12-31,NA,3242200000,1561700000,2372700000,844600000,3590300000,2745700000,2745700000,NA,718900000,6206700000,3461000000,2616400000,496500000,NA,2523300000,2307400000,NA,income_statement,NA,NA,NA
TRS,2016-12-31,NA,-58230000,NA,-39800000,134230000,210800000,59010000,59010000,-13720000,-18430000,794020000,735010000,583220000,-117240000,-5000000,-39800000,-39800000,NA,income_statement,Specialty Industrial Machinery,TriMas Corporation,"TriMas Corporation manufactures and provides products for consumer products, aerospace, and industrial end markets worldwide. It operates in three segments: Packaging, Aerospace, and Specialty Products. The Packaging segment designs, manufactures, and sells specialty polymeric and steel closure products, including steel drum enclosures, plastic drum closures, plastic pail dispensers and plugs, and plastic enclosures; specialty dispensing products, such as foamers, lotion pumps, fine mist sprayers, airless dispensers, and other packaging solutions for the cosmetic, personal care, pharmaceutical, and household product markets; specialty plastic closures for bottles and jars in the food and beverage markets; and single-bodied and assembled caps and closures under the Rieke, Taplast, and Stolz brands. The Aerospace segment offers fasteners, collars, blind bolts, and rivets to original equipment manufacturers, supply chain distributors, MRO/aftermarket providers, and tier one suppliers for commercial, maintenance, repair, and operations (MRO); and military aerospace applications and platforms under the Monogram Aerospace Fasteners, Allfast Fastening Systems, and Mac Fasteners brands. The Specialty Products segment offers steel cylinders for use in the transportation, storage, and dispensing of compressed gases under the Norris Cylinder brand; natural gas powered wellhead engines, compressors, replacement parts, compressors, compressor packaging, and gas production equipment under the Arrow brand; and machined metallic components, including auxiliary power units, as well as electrical, hydraulic, and pneumatic systems for aerospace applications under the Martinic Engineering brand. This segment also provides spare parts for various industrial engines under the Caterpillar, Waukesha, and Ajax brands. The company sells its products through a direct sales force, third-party agents, and distributors. TriMas Corporation was incorporated in 1986 and is based in Bloomfield Hills, Michigan."
TRS,2017-12-31,NA,69880000,NA,30960000,84660000,189280000,89560000,89560000,-14390000,33920000,656160000,566600000,466880000,-19680000,-5000000,35960000,30960000,NA,income_statement,Specialty Industrial Machinery,TriMas Corporation,"TriMas Corporation manufactures and provides products for consumer products, aerospace, and industrial end markets worldwide. It operates in three segments: Packaging, Aerospace, and Specialty Products. The Packaging segment designs, manufactures, and sells specialty polymeric and steel closure products, including steel drum enclosures, plastic drum closures, plastic pail dispensers and plugs, and plastic enclosures; specialty dispensing products, such as foamers, lotion pumps, fine mist sprayers, airless dispensers, and other packaging solutions for the cosmetic, personal care, pharmaceutical, and household product markets; specialty plastic closures for bottles and jars in the food and beverage markets; and single-bodied and assembled caps and closures under the Rieke, Taplast, and Stolz brands. The Aerospace segment offers fasteners, collars, blind bolts, and rivets to original equipment manufacturers, supply chain distributors, MRO/aftermarket providers, and tier one suppliers for commercial, maintenance, repair, and operations (MRO); and military aerospace applications and platforms under the Monogram Aerospace Fasteners, Allfast Fastening Systems, and Mac Fasteners brands. The Specialty Products segment offers steel cylinders for use in the transportation, storage, and dispensing of compressed gases under the Norris Cylinder brand; natural gas powered wellhead engines, compressors, replacement parts, compressors, compressor packaging, and gas production equipment under the Arrow brand; and machined metallic components, including auxiliary power units, as well as electrical, hydraulic, and pneumatic systems for aerospace applications under the Martinic Engineering brand. This segment also provides spare parts for various industrial engines under the Caterpillar, Waukesha, and Ajax brands. The company sells its products through a direct sales force, third-party agents, and distributors. TriMas Corporation was incorporated in 1986 and is based in Bloomfield Hills, Michigan."
TRS,2018-12-31,NA,92360000,NA,83300000,85140000,200110000,100260000,100260000,-13910000,18650000,705030000,604770000,504920000,-7900000,9590000,73710000,83300000,NA,income_statement,Specialty Industrial Machinery,TriMas Corporation,"TriMas Corporation manufactures and provides products for consumer products, aerospace, and industrial end markets worldwide. It operates in three segments: Packaging, Aerospace, and Specialty Products. The Packaging segment designs, manufactures, and sells specialty polymeric and steel closure products, including steel drum enclosures, plastic drum closures, plastic pail dispensers and plugs, and plastic enclosures; specialty dispensing products, such as foamers, lotion pumps, fine mist sprayers, airless dispensers, and other packaging solutions for the cosmetic, personal care, pharmaceutical, and household product markets; specialty plastic closures for bottles and jars in the food and beverage markets; and single-bodied and assembled caps and closures under the Rieke, Taplast, and Stolz brands. The Aerospace segment offers fasteners, collars, blind bolts, and rivets to original equipment manufacturers, supply chain distributors, MRO/aftermarket providers, and tier one suppliers for commercial, maintenance, repair, and operations (MRO); and military aerospace applications and platforms under the Monogram Aerospace Fasteners, Allfast Fastening Systems, and Mac Fasteners brands. The Specialty Products segment offers steel cylinders for use in the transportation, storage, and dispensing of compressed gases under the Norris Cylinder brand; natural gas powered wellhead engines, compressors, replacement parts, compressors, compressor packaging, and gas production equipment under the Arrow brand; and machined metallic components, including auxiliary power units, as well as electrical, hydraulic, and pneumatic systems for aerospace applications under the Martinic Engineering brand. This segment also provides spare parts for various industrial engines under the Caterpillar, Waukesha, and Ajax brands. The company sells its products through a direct sales force, third-party agents, and distributors. TriMas Corporation was incorporated in 1986 and is based in Bloomfield Hills, Michigan."
TRS,2019-12-31,NA,78260000,NA,98620000,90760000,194200000,88420000,88420000,-13950000,16320000,723530000,635110000,529330000,-10160000,36680000,61940000,98620000,NA,income_statement,Specialty Industrial Machinery,TriMas Corporation,"TriMas Corporation manufactures and provides products for consumer products, aerospace, and industrial end markets worldwide. It operates in three segments: Packaging, Aerospace, and Specialty Products. The Packaging segment designs, manufactures, and sells specialty polymeric and steel closure products, including steel drum enclosures, plastic drum closures, plastic pail dispensers and plugs, and plastic enclosures; specialty dispensing products, such as foamers, lotion pumps, fine mist sprayers, airless dispensers, and other packaging solutions for the cosmetic, personal care, pharmaceutical, and household product markets; specialty plastic closures for bottles and jars in the food and beverage markets; and single-bodied and assembled caps and closures under the Rieke, Taplast, and Stolz brands. The Aerospace segment offers fasteners, collars, blind bolts, and rivets to original equipment manufacturers, supply chain distributors, MRO/aftermarket providers, and tier one suppliers for commercial, maintenance, repair, and operations (MRO); and military aerospace applications and platforms under the Monogram Aerospace Fasteners, Allfast Fastening Systems, and Mac Fasteners brands. The Specialty Products segment offers steel cylinders for use in the transportation, storage, and dispensing of compressed gases under the Norris Cylinder brand; natural gas powered wellhead engines, compressors, replacement parts, compressors, compressor packaging, and gas production equipment under the Arrow brand; and machined metallic components, including auxiliary power units, as well as electrical, hydraulic, and pneumatic systems for aerospace applications under the Martinic Engineering brand. This segment also provides spare parts for various industrial engines under the Caterpillar, Waukesha, and Ajax brands. The company sells its products through a direct sales force, third-party agents, and distributors. TriMas Corporation was incorporated in 1986 and is based in Bloomfield Hills, Michigan."
TRST,2017-12-31,NA,76747000,NA,43145000,79209000,170741000,0,82097000,NA,33602000,170741000,88644000,0,-5350000,NA,43145000,43145000,9435000,income_statement,Banks—Regional,TrustCo Bank Corp NY,"TrustCo Bank Corp NY operates as the holding company for Trustco Bank, a federal savings bank that provides personal and business banking services to individuals, partnerships, and corporations. The company is primarily involved in accepting deposits, and making loans and investments. It also operates as a real estate investment trust that acquires, holds, and manages real estate mortgage assets, including residential mortgage loans and mortgage backed securities. In addition, the company serves as the executor of estates and trustee of personal trusts; provides asset and wealth management, estate planning and related advice, and custodial services; and acts as trustee for various types of employee benefit plans, and corporate pension and profit sharing trusts. As of December 31, 2019, it operated 148 banking offices and 162 automatic teller machines in New York, Florida, Vermont, Massachusetts, and New Jersey. The company was founded in 1902 and is headquartered in Glenville, New York."
TRST,2018-12-31,NA,79654000,NA,61445000,83463000,177367000,0,83626000,NA,18209000,177367000,93741000,0,-3972000,NA,61445000,61445000,10278000,income_statement,Banks—Regional,TrustCo Bank Corp NY,"TrustCo Bank Corp NY operates as the holding company for Trustco Bank, a federal savings bank that provides personal and business banking services to individuals, partnerships, and corporations. The company is primarily involved in accepting deposits, and making loans and investments. It also operates as a real estate investment trust that acquires, holds, and manages real estate mortgage assets, including residential mortgage loans and mortgage backed securities. In addition, the company serves as the executor of estates and trustee of personal trusts; provides asset and wealth management, estate planning and related advice, and custodial services; and acts as trustee for various types of employee benefit plans, and corporate pension and profit sharing trusts. As of December 31, 2019, it operated 148 banking offices and 162 automatic teller machines in New York, Florida, Vermont, Massachusetts, and New Jersey. The company was founded in 1902 and is headquartered in Glenville, New York."
TRST,2019-12-31,NA,76509000,NA,57840000,86659000,174239000,0,78130000,NA,18669000,174239000,96109000,0,-1621000,NA,57840000,57840000,9450000,income_statement,Banks—Regional,TrustCo Bank Corp NY,"TrustCo Bank Corp NY operates as the holding company for Trustco Bank, a federal savings bank that provides personal and business banking services to individuals, partnerships, and corporations. The company is primarily involved in accepting deposits, and making loans and investments. It also operates as a real estate investment trust that acquires, holds, and manages real estate mortgage assets, including residential mortgage loans and mortgage backed securities. In addition, the company serves as the executor of estates and trustee of personal trusts; provides asset and wealth management, estate planning and related advice, and custodial services; and acts as trustee for various types of employee benefit plans, and corporate pension and profit sharing trusts. As of December 31, 2019, it operated 148 banking offices and 162 automatic teller machines in New York, Florida, Vermont, Massachusetts, and New Jersey. The company was founded in 1902 and is headquartered in Glenville, New York."
TRST,2020-12-31,NA,69446000,NA,52452000,85091000,165150000,0,71758000,NA,16994000,165150000,93392000,0,-2312000,NA,52452000,52452000,8301000,income_statement,Banks—Regional,TrustCo Bank Corp NY,"TrustCo Bank Corp NY operates as the holding company for Trustco Bank, a federal savings bank that provides personal and business banking services to individuals, partnerships, and corporations. The company is primarily involved in accepting deposits, and making loans and investments. It also operates as a real estate investment trust that acquires, holds, and manages real estate mortgage assets, including residential mortgage loans and mortgage backed securities. In addition, the company serves as the executor of estates and trustee of personal trusts; provides asset and wealth management, estate planning and related advice, and custodial services; and acts as trustee for various types of employee benefit plans, and corporate pension and profit sharing trusts. As of December 31, 2019, it operated 148 banking offices and 162 automatic teller machines in New York, Florida, Vermont, Massachusetts, and New Jersey. The company was founded in 1902 and is headquartered in Glenville, New York."
TRUE,2016-12-31,52280000,-41053000,NA,-41708000,210749000,252340000,-34034000,-34034000,-2530000,655000,277507000,311541000,25167000,-7019000,NA,-41708000,-41708000,NA,income_statement,Internet Content & Information,"TrueCar, Inc.","TrueCar, Inc. operates as an internet-based information, technology, and communication services company in the United States. It operates its platform on the TrueCar website and mobile applications. Its platform enables users to obtain market-based pricing data on new and used cars, and to connect with its network of TrueCar certified dealers. The company also offers forecast and consulting services regarding determination of the residual value of an automobile at given future points in time, which are used to underwrite automotive loans and leases, and by financial institutions to measure exposure and risk across loan, lease, and fleet portfolios. In addition, it provides geographically specific real-time pricing information for consumers and dealers; TrueCar Trade, which gives consumers information on the value of their trade-in vehicles and enables them to obtain a guaranteed trade-in price before setting foot in the dealership; DealerSync, a dealer website creation and management service and a software platform that assists dealers in managing, marketing, and growing their business; and DealerScience that provides dealers with advanced digital retailing software tools. Further, the company customizes and operates its platform for financial institutions, membership-based organizations, and large enterprises.  The company was formerly known as Zag.com Inc. TrueCar, Inc. was founded in 2005 and is headquartered in Santa Monica, California."
TRUE,2017-12-31,59070000,-35013000,NA,-32849000,247176000,294922000,-33796000,-33796000,-2610000,-2164000,323149000,356945000,28227000,-1217000,NA,-32849000,-32849000,NA,income_statement,Internet Content & Information,"TrueCar, Inc.","TrueCar, Inc. operates as an internet-based information, technology, and communication services company in the United States. It operates its platform on the TrueCar website and mobile applications. Its platform enables users to obtain market-based pricing data on new and used cars, and to connect with its network of TrueCar certified dealers. The company also offers forecast and consulting services regarding determination of the residual value of an automobile at given future points in time, which are used to underwrite automotive loans and leases, and by financial institutions to measure exposure and risk across loan, lease, and fleet portfolios. In addition, it provides geographically specific real-time pricing information for consumers and dealers; TrueCar Trade, which gives consumers information on the value of their trade-in vehicles and enables them to obtain a guaranteed trade-in price before setting foot in the dealership; DealerSync, a dealer website creation and management service and a software platform that assists dealers in managing, marketing, and growing their business; and DealerScience that provides dealers with advanced digital retailing software tools. Further, the company customizes and operates its platform for financial institutions, membership-based organizations, and large enterprises.  The company was formerly known as Zag.com Inc. TrueCar, Inc. was founded in 2005 and is headquartered in Santa Monica, California."
TRUE,2018-12-31,61348000,-28498000,NA,-28321000,266935000,322417000,-27543000,-27543000,-2649000,-177000,353571000,381114000,31154000,-955000,NA,-28321000,-28321000,NA,income_statement,Internet Content & Information,"TrueCar, Inc.","TrueCar, Inc. operates as an internet-based information, technology, and communication services company in the United States. It operates its platform on the TrueCar website and mobile applications. Its platform enables users to obtain market-based pricing data on new and used cars, and to connect with its network of TrueCar certified dealers. The company also offers forecast and consulting services regarding determination of the residual value of an automobile at given future points in time, which are used to underwrite automotive loans and leases, and by financial institutions to measure exposure and risk across loan, lease, and fleet portfolios. In addition, it provides geographically specific real-time pricing information for consumers and dealers; TrueCar Trade, which gives consumers information on the value of their trade-in vehicles and enables them to obtain a guaranteed trade-in price before setting foot in the dealership; DealerSync, a dealer website creation and management service and a software platform that assists dealers in managing, marketing, and growing their business; and DealerScience that provides dealers with advanced digital retailing software tools. Further, the company customizes and operates its platform for financial institutions, membership-based organizations, and large enterprises.  The company was formerly known as Zag.com Inc. TrueCar, Inc. was founded in 2005 and is headquartered in Santa Monica, California."
TRUE,2019-12-31,52226000,-54601000,NA,-54890000,290766000,321593000,-45890000,-45890000,NA,289000,353880000,399770000,32287000,-8711000,NA,-54890000,-54890000,NA,income_statement,Internet Content & Information,"TrueCar, Inc.","TrueCar, Inc. operates as an internet-based information, technology, and communication services company in the United States. It operates its platform on the TrueCar website and mobile applications. Its platform enables users to obtain market-based pricing data on new and used cars, and to connect with its network of TrueCar certified dealers. The company also offers forecast and consulting services regarding determination of the residual value of an automobile at given future points in time, which are used to underwrite automotive loans and leases, and by financial institutions to measure exposure and risk across loan, lease, and fleet portfolios. In addition, it provides geographically specific real-time pricing information for consumers and dealers; TrueCar Trade, which gives consumers information on the value of their trade-in vehicles and enables them to obtain a guaranteed trade-in price before setting foot in the dealership; DealerSync, a dealer website creation and management service and a software platform that assists dealers in managing, marketing, and growing their business; and DealerScience that provides dealers with advanced digital retailing software tools. Further, the company customizes and operates its platform for financial institutions, membership-based organizations, and large enterprises.  The company was formerly known as Zag.com Inc. TrueCar, Inc. was founded in 2005 and is headquartered in Santa Monica, California."
TRV,2017-12-31,NA,2730000000,NA,2056000000,4170000000,7269000000,3099000000,3099000000,-369000000,674000000,28902000000,25803000000,21633000000,-369000000,NA,2056000000,2041000000,NA,income_statement,NA,NA,NA
TRV,2018-12-31,NA,2961000000,NA,2523000000,4297000000,7610000000,3313000000,3313000000,-352000000,438000000,30282000000,26969000000,22672000000,-352000000,NA,2523000000,2504000000,NA,income_statement,NA,NA,NA
TRV,2019-12-31,NA,3138000000,NA,2622000000,4365000000,7847000000,3482000000,3482000000,-344000000,516000000,31581000000,28099000000,23734000000,-344000000,NA,2622000000,2603000000,NA,income_statement,NA,NA,NA
TRV,2020-12-31,NA,3237000000,NA,2697000000,4509000000,8085000000,3576000000,3576000000,-339000000,540000000,31981000000,28405000000,23896000000,-339000000,NA,2697000000,2678000000,NA,income_statement,NA,NA,NA
TRVG,2017-12-31,NA,-17813000,NA,-12481000,1046601000,1029453000,-20368000,-20368000,-44000,-4764000,1035383000,1055751000,5930000,2555000,NA,-13049000,-12481000,NA,income_statement,Internet Content & Information,trivago N.V.,"trivago N.V., together with its subsidiaries, operates a hotel and accommodation search platform. It offers online meta-search for hotels and accommodation through online travel agencies, hotel chains, and independent hotels. The company provides access to its platform through 54 localized websites and apps in 32 languages. As of June 30, 2020, its hotel search platform offered access to approximately 5.0 million hotels and other types of accommodation worldwide. The company was founded in 2005 and is headquartered in DÃ¼sseldorf, Germany. trivago N.V. is a subsidiary of Expedia Lodging Partner Services S.Ã  r.l."
TRVG,2018-12-31,NA,-20403000,NA,-21489000,925426000,909381000,-17729000,-17729000,-1839000,1086000,914816000,932545000,5435000,-2674000,NA,-21489000,-21489000,NA,income_statement,Internet Content & Information,trivago N.V.,"trivago N.V., together with its subsidiaries, operates a hotel and accommodation search platform. It offers online meta-search for hotels and accommodation through online travel agencies, hotel chains, and independent hotels. The company provides access to its platform through 54 localized websites and apps in 32 languages. As of June 30, 2020, its hotel search platform offered access to approximately 5.0 million hotels and other types of accommodation worldwide. The company was founded in 2005 and is headquartered in DÃ¼sseldorf, Germany. trivago N.V. is a subsidiary of Expedia Lodging Partner Services S.Ã  r.l."
TRVG,2019-12-31,NA,38143000,NA,17161000,789526000,829458000,38247000,38247000,-33000,20982000,838617000,800370000,9159000,-104000,NA,17161000,17161000,NA,income_statement,Internet Content & Information,trivago N.V.,"trivago N.V., together with its subsidiaries, operates a hotel and accommodation search platform. It offers online meta-search for hotels and accommodation through online travel agencies, hotel chains, and independent hotels. The company provides access to its platform through 54 localized websites and apps in 32 languages. As of June 30, 2020, its hotel search platform offered access to approximately 5.0 million hotels and other types of accommodation worldwide. The company was founded in 2005 and is headquartered in DÃ¼sseldorf, Germany. trivago N.V. is a subsidiary of Expedia Lodging Partner Services S.Ã  r.l."
TRVG,2020-12-31,NA,-253872000,NA,-245378000,283448000,238788000,-45033000,-45033000,-270000,-8494000,248921000,293954000,10133000,-208839000,NA,-245378000,-245378000,NA,income_statement,Internet Content & Information,trivago N.V.,"trivago N.V., together with its subsidiaries, operates a hotel and accommodation search platform. It offers online meta-search for hotels and accommodation through online travel agencies, hotel chains, and independent hotels. The company provides access to its platform through 54 localized websites and apps in 32 languages. As of June 30, 2020, its hotel search platform offered access to approximately 5.0 million hotels and other types of accommodation worldwide. The company was founded in 2005 and is headquartered in DÃ¼sseldorf, Germany. trivago N.V. is a subsidiary of Expedia Lodging Partner Services S.Ã  r.l."
TRVI,2016-12-31,6913000,-11095000,NA,-11087000,1712000,0,-8625000,-8625000,-2607000,-8000,0,8625000,0,-2470000,NA,-11087000,-6714000,NA,income_statement,Biotechnology,"Trevi Therapeutics, Inc.","Trevi Therapeutics, Inc., a clinical-stage biopharmaceutical company, focuses on the development and commercialization of Haduvio to treat serious neurologically mediated conditions. It develops Haduvio, which is in Phase IIb/III clinical trial is an oral extended release formulation of nalbuphine that is used for the treatment of chronic pruritus, chronic cough in patients with idiopathic pulmonary fibrosis, and levodopa-induced dyskinesia in patients with Parkinson's disease, as well as to treat chronic kidney disease-associated with pruritus. The company was founded in 2011 and is headquartered in New Haven, Connecticut."
TRVI,2017-12-31,6095000,-12886000,NA,-12860000,2142000,0,-8237000,-8237000,-3342000,-26000,0,8237000,0,-4649000,NA,-12860000,-12540000,NA,income_statement,Biotechnology,"Trevi Therapeutics, Inc.","Trevi Therapeutics, Inc., a clinical-stage biopharmaceutical company, focuses on the development and commercialization of Haduvio to treat serious neurologically mediated conditions. It develops Haduvio, which is in Phase IIb/III clinical trial is an oral extended release formulation of nalbuphine that is used for the treatment of chronic pruritus, chronic cough in patients with idiopathic pulmonary fibrosis, and levodopa-induced dyskinesia in patients with Parkinson's disease, as well as to treat chronic kidney disease-associated with pruritus. The company was founded in 2011 and is headquartered in New Haven, Connecticut."
TRVI,2018-12-31,14072000,-20669000,NA,-20545000,4336000,0,-18408000,-18408000,-174000,-124000,0,18408000,0,-2261000,NA,-20545000,-25577000,NA,income_statement,Biotechnology,"Trevi Therapeutics, Inc.","Trevi Therapeutics, Inc., a clinical-stage biopharmaceutical company, focuses on the development and commercialization of Haduvio to treat serious neurologically mediated conditions. It develops Haduvio, which is in Phase IIb/III clinical trial is an oral extended release formulation of nalbuphine that is used for the treatment of chronic pruritus, chronic cough in patients with idiopathic pulmonary fibrosis, and levodopa-induced dyskinesia in patients with Parkinson's disease, as well as to treat chronic kidney disease-associated with pruritus. The company was founded in 2011 and is headquartered in New Haven, Connecticut."
TRVI,2019-12-31,19339000,-26068000,NA,-26050000,7306000,0,-26645000,-26645000,NA,-18000,0,26645000,0,577000,NA,-26050000,-26754000,NA,income_statement,Biotechnology,"Trevi Therapeutics, Inc.","Trevi Therapeutics, Inc., a clinical-stage biopharmaceutical company, focuses on the development and commercialization of Haduvio to treat serious neurologically mediated conditions. It develops Haduvio, which is in Phase IIb/III clinical trial is an oral extended release formulation of nalbuphine that is used for the treatment of chronic pruritus, chronic cough in patients with idiopathic pulmonary fibrosis, and levodopa-induced dyskinesia in patients with Parkinson's disease, as well as to treat chronic kidney disease-associated with pruritus. The company was founded in 2011 and is headquartered in New Haven, Connecticut."
TRVN,2016-12-31,89956000,-102994000,NA,-102994000,16077000,3750000,-102283000,-102283000,-1738000,0,3750000,106033000,89956000,-711000,NA,-102994000,-102994000,NA,income_statement,Biotechnology,"Trevena, Inc.","Trevena, Inc., a biopharmaceutical company, focuses on the development and commercialization of novel medicines for patients affected by central nervous system disorders. Its product candidates include Oliceridine injection, a G protein biased mu-opioid receptor (MOR) ligand that has completed Phase III clinical trials for the management of moderate-to-severe acute pain where intravenous administration is warranted; TRV250, a G protein biased delta-opioid receptor agonist that has completed Phase I clinical study for the treatment of acute migraine; TRV734, a small molecule G protein biased ligand of the MOR that has completed Phase I clinical study for the treatment of moderate-to-severe acute and chronic pain; TRV027 for the treatment of acute heart failure; and TRV045, a novel S1P modulator for managing chronic pain. The company has a collaboration with Imperial College London to evaluate Trv027 in Covid-19 patients. Trevena, Inc. was founded in 2007 and is headquartered in Chesterbrook, Pennsylvania."
TRVN,2017-12-31,48974000,-71865000,NA,-71865000,20994000,-48974000,-69968000,-69968000,-2780000,0,0,69968000,48974000,-1897000,NA,-71865000,-71865000,NA,income_statement,Biotechnology,"Trevena, Inc.","Trevena, Inc., a biopharmaceutical company, focuses on the development and commercialization of novel medicines for patients affected by central nervous system disorders. Its product candidates include Oliceridine injection, a G protein biased mu-opioid receptor (MOR) ligand that has completed Phase III clinical trials for the management of moderate-to-severe acute pain where intravenous administration is warranted; TRV250, a G protein biased delta-opioid receptor agonist that has completed Phase I clinical study for the treatment of acute migraine; TRV734, a small molecule G protein biased ligand of the MOR that has completed Phase I clinical study for the treatment of moderate-to-severe acute and chronic pain; TRV027 for the treatment of acute heart failure; and TRV045, a novel S1P modulator for managing chronic pain. The company has a collaboration with Imperial College London to evaluate Trv027 in Covid-19 patients. Trevena, Inc. was founded in 2007 and is headquartered in Chesterbrook, Pennsylvania."
TRVN,2018-12-31,15824000,-30039000,NA,-30784000,20372000,5732000,-30464000,-30464000,-2231000,745000,5732000,36196000,0,425000,NA,-30784000,-30784000,NA,income_statement,Biotechnology,"Trevena, Inc.","Trevena, Inc., a biopharmaceutical company, focuses on the development and commercialization of novel medicines for patients affected by central nervous system disorders. Its product candidates include Oliceridine injection, a G protein biased mu-opioid receptor (MOR) ligand that has completed Phase III clinical trials for the management of moderate-to-severe acute pain where intravenous administration is warranted; TRV250, a G protein biased delta-opioid receptor agonist that has completed Phase I clinical study for the treatment of acute migraine; TRV734, a small molecule G protein biased ligand of the MOR that has completed Phase I clinical study for the treatment of moderate-to-severe acute and chronic pain; TRV027 for the treatment of acute heart failure; and TRV045, a novel S1P modulator for managing chronic pain. The company has a collaboration with Imperial College London to evaluate Trv027 in Covid-19 patients. Trevena, Inc. was founded in 2007 and is headquartered in Chesterbrook, Pennsylvania."
TRVN,2019-12-31,13291000,-24871000,NA,-24871000,13136000,31000,-26396000,-26396000,-931000,0,31000,26427000,0,1525000,NA,-24871000,-24871000,NA,income_statement,Biotechnology,"Trevena, Inc.","Trevena, Inc., a biopharmaceutical company, focuses on the development and commercialization of novel medicines for patients affected by central nervous system disorders. Its product candidates include Oliceridine injection, a G protein biased mu-opioid receptor (MOR) ligand that has completed Phase III clinical trials for the management of moderate-to-severe acute pain where intravenous administration is warranted; TRV250, a G protein biased delta-opioid receptor agonist that has completed Phase I clinical study for the treatment of acute migraine; TRV734, a small molecule G protein biased ligand of the MOR that has completed Phase I clinical study for the treatment of moderate-to-severe acute and chronic pain; TRV027 for the treatment of acute heart failure; and TRV045, a novel S1P modulator for managing chronic pain. The company has a collaboration with Imperial College London to evaluate Trv027 in Covid-19 patients. Trevena, Inc. was founded in 2007 and is headquartered in Chesterbrook, Pennsylvania."
TSC,2017-12-31,NA,47470000,NA,37988000,72946000,138942000,0,54616000,NA,9482000,138942000,84326000,0,-7146000,NA,37988000,37988000,11380000,income_statement,Banks—Regional,"TriState Capital Holdings, Inc.","TriState Capital Holdings, Inc. operates as the bank holding company for TriState Capital Bank that provides various commercial and private banking services to middle-market businesses and high-net-worth individuals in the United States. It operates in two segments, Bank and Investment Management. The company's deposit products include checking accounts, money market deposit accounts, and certificates of deposit, as well as promontory's certificate of deposit account registry services and insured cash sweep services. It also provides loans that are secured by cash, marketable securities, cash value life insurance, residential property, or other financial assets, as well as commercial and industrial loans, commercial real estate loans, personal loans, asset-based loans, acquisition financing, and letters of credit. In addition, the company offers liquidity and treasury management services, such as online balance reporting, online bill payment, remote deposit, liquidity, wire and ACH, foreign exchange, and controlled disbursement services; and equity and fixed income advisory and sub-advisory services to third party mutual funds and series trust mutual funds, as well as separately managed accounts primarily comprising ultra-high-net-worth and institutional clients that include corporations, ERISA plans, Taft-Hartley funds, municipalities, endowments, and foundations. Further, it provides cash management services; and capital market services, which comprise interest rate swaps and investment management products, as well as engages in wholesaling and marketing the investment products and services. The company offers its products and services through its main office located in Pittsburgh, Pennsylvania, as well as through its four additional representative offices in Cleveland, Ohio; Philadelphia, Pennsylvania; Edison, New Jersey; and New York, New York. TriState Capital Holdings, Inc. was incorporated in 2006 and is headquartered in Pittsburgh, Pennsylvania."
TSC,2018-12-31,NA,60369000,NA,54424000,81491000,161526000,0,67701000,NA,5945000,161526000,93825000,0,-7332000,NA,54424000,52304000,12334000,income_statement,Banks—Regional,"TriState Capital Holdings, Inc.","TriState Capital Holdings, Inc. operates as the bank holding company for TriState Capital Bank that provides various commercial and private banking services to middle-market businesses and high-net-worth individuals in the United States. It operates in two segments, Bank and Investment Management. The company's deposit products include checking accounts, money market deposit accounts, and certificates of deposit, as well as promontory's certificate of deposit account registry services and insured cash sweep services. It also provides loans that are secured by cash, marketable securities, cash value life insurance, residential property, or other financial assets, as well as commercial and industrial loans, commercial real estate loans, personal loans, asset-based loans, acquisition financing, and letters of credit. In addition, the company offers liquidity and treasury management services, such as online balance reporting, online bill payment, remote deposit, liquidity, wire and ACH, foreign exchange, and controlled disbursement services; and equity and fixed income advisory and sub-advisory services to third party mutual funds and series trust mutual funds, as well as separately managed accounts primarily comprising ultra-high-net-worth and institutional clients that include corporations, ERISA plans, Taft-Hartley funds, municipalities, endowments, and foundations. Further, it provides cash management services; and capital market services, which comprise interest rate swaps and investment management products, as well as engages in wholesaling and marketing the investment products and services. The company offers its products and services through its main office located in Pittsburgh, Pennsylvania, as well as through its four additional representative offices in Cleveland, Ohio; Philadelphia, Pennsylvania; Edison, New Jersey; and New York, New York. TriState Capital Holdings, Inc. was incorporated in 2006 and is headquartered in Pittsburgh, Pennsylvania."
TSC,2019-12-31,NA,68658000,NA,60193000,89670000,180807000,0,77116000,NA,8465000,180807000,103691000,0,-8458000,NA,60193000,54440000,14021000,income_statement,Banks—Regional,"TriState Capital Holdings, Inc.","TriState Capital Holdings, Inc. operates as the bank holding company for TriState Capital Bank that provides various commercial and private banking services to middle-market businesses and high-net-worth individuals in the United States. It operates in two segments, Bank and Investment Management. The company's deposit products include checking accounts, money market deposit accounts, and certificates of deposit, as well as promontory's certificate of deposit account registry services and insured cash sweep services. It also provides loans that are secured by cash, marketable securities, cash value life insurance, residential property, or other financial assets, as well as commercial and industrial loans, commercial real estate loans, personal loans, asset-based loans, acquisition financing, and letters of credit. In addition, the company offers liquidity and treasury management services, such as online balance reporting, online bill payment, remote deposit, liquidity, wire and ACH, foreign exchange, and controlled disbursement services; and equity and fixed income advisory and sub-advisory services to third party mutual funds and series trust mutual funds, as well as separately managed accounts primarily comprising ultra-high-net-worth and institutional clients that include corporations, ERISA plans, Taft-Hartley funds, municipalities, endowments, and foundations. Further, it provides cash management services; and capital market services, which comprise interest rate swaps and investment management products, as well as engages in wholesaling and marketing the investment products and services. The company offers its products and services through its main office located in Pittsburgh, Pennsylvania, as well as through its four additional representative offices in Cleveland, Ohio; Philadelphia, Pennsylvania; Edison, New Jersey; and New York, New York. TriState Capital Holdings, Inc. was incorporated in 2006 and is headquartered in Pittsburgh, Pennsylvania."
TSC,2020-12-31,NA,52646000,NA,45234000,100043000,175749000,0,64270000,NA,7412000,175749000,111479000,0,-11624000,NA,45234000,37361000,11436000,income_statement,Banks—Regional,"TriState Capital Holdings, Inc.","TriState Capital Holdings, Inc. operates as the bank holding company for TriState Capital Bank that provides various commercial and private banking services to middle-market businesses and high-net-worth individuals in the United States. It operates in two segments, Bank and Investment Management. The company's deposit products include checking accounts, money market deposit accounts, and certificates of deposit, as well as promontory's certificate of deposit account registry services and insured cash sweep services. It also provides loans that are secured by cash, marketable securities, cash value life insurance, residential property, or other financial assets, as well as commercial and industrial loans, commercial real estate loans, personal loans, asset-based loans, acquisition financing, and letters of credit. In addition, the company offers liquidity and treasury management services, such as online balance reporting, online bill payment, remote deposit, liquidity, wire and ACH, foreign exchange, and controlled disbursement services; and equity and fixed income advisory and sub-advisory services to third party mutual funds and series trust mutual funds, as well as separately managed accounts primarily comprising ultra-high-net-worth and institutional clients that include corporations, ERISA plans, Taft-Hartley funds, municipalities, endowments, and foundations. Further, it provides cash management services; and capital market services, which comprise interest rate swaps and investment management products, as well as engages in wholesaling and marketing the investment products and services. The company offers its products and services through its main office located in Pittsburgh, Pennsylvania, as well as through its four additional representative offices in Cleveland, Ohio; Philadelphia, Pennsylvania; Edison, New Jersey; and New York, New York. TriState Capital Holdings, Inc. was incorporated in 2006 and is headquartered in Pittsburgh, Pennsylvania."
TSCAP,2017-12-31,NA,47470000,NA,37988000,72946000,138942000,0,54616000,NA,9482000,138942000,84326000,0,-7146000,NA,37988000,37988000,11380000,income_statement,Banks—Regional,"TriState Capital Holdings, Inc.","TriState Capital Holdings, Inc. operates as the bank holding company for TriState Capital Bank that provides various commercial and private banking services to middle-market businesses and high-net-worth individuals in the United States. It operates in two segments, Bank and Investment Management. The company's deposit products include checking accounts, money market deposit accounts, and certificates of deposit, as well as promontory's certificate of deposit account registry services and insured cash sweep services. It also provides loans that are secured by cash, marketable securities, cash value life insurance, residential property, or other financial assets, as well as commercial and industrial loans, commercial real estate loans, personal loans, asset-based loans, acquisition financing, and letters of credit. In addition, the company offers liquidity and treasury management services, such as online balance reporting, online bill payment, remote deposit, liquidity, wire and ACH, foreign exchange, and controlled disbursement services; and equity and fixed income advisory and sub-advisory services to third party mutual funds and series trust mutual funds, as well as separately managed accounts primarily comprising ultra-high-net-worth and institutional clients that include corporations, ERISA plans, Taft-Hartley funds, municipalities, endowments, and foundations. Further, it provides cash management services; and capital market services, which comprise interest rate swaps and investment management products, as well as engages in wholesaling and marketing the investment products and services. The company offers its products and services through its main office located in Pittsburgh, Pennsylvania, as well as through its four additional representative offices in Cleveland, Ohio; Philadelphia, Pennsylvania; Edison, New Jersey; and New York, New York. TriState Capital Holdings, Inc. was incorporated in 2006 and is headquartered in Pittsburgh, Pennsylvania."
TSCAP,2018-12-31,NA,60369000,NA,54424000,81491000,161526000,0,67701000,NA,5945000,161526000,93825000,0,-7332000,NA,54424000,52304000,12334000,income_statement,Banks—Regional,"TriState Capital Holdings, Inc.","TriState Capital Holdings, Inc. operates as the bank holding company for TriState Capital Bank that provides various commercial and private banking services to middle-market businesses and high-net-worth individuals in the United States. It operates in two segments, Bank and Investment Management. The company's deposit products include checking accounts, money market deposit accounts, and certificates of deposit, as well as promontory's certificate of deposit account registry services and insured cash sweep services. It also provides loans that are secured by cash, marketable securities, cash value life insurance, residential property, or other financial assets, as well as commercial and industrial loans, commercial real estate loans, personal loans, asset-based loans, acquisition financing, and letters of credit. In addition, the company offers liquidity and treasury management services, such as online balance reporting, online bill payment, remote deposit, liquidity, wire and ACH, foreign exchange, and controlled disbursement services; and equity and fixed income advisory and sub-advisory services to third party mutual funds and series trust mutual funds, as well as separately managed accounts primarily comprising ultra-high-net-worth and institutional clients that include corporations, ERISA plans, Taft-Hartley funds, municipalities, endowments, and foundations. Further, it provides cash management services; and capital market services, which comprise interest rate swaps and investment management products, as well as engages in wholesaling and marketing the investment products and services. The company offers its products and services through its main office located in Pittsburgh, Pennsylvania, as well as through its four additional representative offices in Cleveland, Ohio; Philadelphia, Pennsylvania; Edison, New Jersey; and New York, New York. TriState Capital Holdings, Inc. was incorporated in 2006 and is headquartered in Pittsburgh, Pennsylvania."
TSCAP,2019-12-31,NA,68658000,NA,60193000,89670000,180807000,0,77116000,NA,8465000,180807000,103691000,0,-8458000,NA,60193000,54440000,14021000,income_statement,Banks—Regional,"TriState Capital Holdings, Inc.","TriState Capital Holdings, Inc. operates as the bank holding company for TriState Capital Bank that provides various commercial and private banking services to middle-market businesses and high-net-worth individuals in the United States. It operates in two segments, Bank and Investment Management. The company's deposit products include checking accounts, money market deposit accounts, and certificates of deposit, as well as promontory's certificate of deposit account registry services and insured cash sweep services. It also provides loans that are secured by cash, marketable securities, cash value life insurance, residential property, or other financial assets, as well as commercial and industrial loans, commercial real estate loans, personal loans, asset-based loans, acquisition financing, and letters of credit. In addition, the company offers liquidity and treasury management services, such as online balance reporting, online bill payment, remote deposit, liquidity, wire and ACH, foreign exchange, and controlled disbursement services; and equity and fixed income advisory and sub-advisory services to third party mutual funds and series trust mutual funds, as well as separately managed accounts primarily comprising ultra-high-net-worth and institutional clients that include corporations, ERISA plans, Taft-Hartley funds, municipalities, endowments, and foundations. Further, it provides cash management services; and capital market services, which comprise interest rate swaps and investment management products, as well as engages in wholesaling and marketing the investment products and services. The company offers its products and services through its main office located in Pittsburgh, Pennsylvania, as well as through its four additional representative offices in Cleveland, Ohio; Philadelphia, Pennsylvania; Edison, New Jersey; and New York, New York. TriState Capital Holdings, Inc. was incorporated in 2006 and is headquartered in Pittsburgh, Pennsylvania."
TSCAP,2020-12-31,NA,52646000,NA,45234000,100043000,175749000,0,64270000,NA,7412000,175749000,111479000,0,-11624000,NA,45234000,37361000,11436000,income_statement,Banks—Regional,"TriState Capital Holdings, Inc.","TriState Capital Holdings, Inc. operates as the bank holding company for TriState Capital Bank that provides various commercial and private banking services to middle-market businesses and high-net-worth individuals in the United States. It operates in two segments, Bank and Investment Management. The company's deposit products include checking accounts, money market deposit accounts, and certificates of deposit, as well as promontory's certificate of deposit account registry services and insured cash sweep services. It also provides loans that are secured by cash, marketable securities, cash value life insurance, residential property, or other financial assets, as well as commercial and industrial loans, commercial real estate loans, personal loans, asset-based loans, acquisition financing, and letters of credit. In addition, the company offers liquidity and treasury management services, such as online balance reporting, online bill payment, remote deposit, liquidity, wire and ACH, foreign exchange, and controlled disbursement services; and equity and fixed income advisory and sub-advisory services to third party mutual funds and series trust mutual funds, as well as separately managed accounts primarily comprising ultra-high-net-worth and institutional clients that include corporations, ERISA plans, Taft-Hartley funds, municipalities, endowments, and foundations. Further, it provides cash management services; and capital market services, which comprise interest rate swaps and investment management products, as well as engages in wholesaling and marketing the investment products and services. The company offers its products and services through its main office located in Pittsburgh, Pennsylvania, as well as through its four additional representative offices in Cleveland, Ohio; Philadelphia, Pennsylvania; Edison, New Jersey; and New York, New York. TriState Capital Holdings, Inc. was incorporated in 2006 and is headquartered in Pittsburgh, Pennsylvania."
TSCBP,2017-12-31,NA,47470000,NA,37988000,72946000,138942000,0,54616000,NA,9482000,138942000,84326000,0,-7146000,NA,37988000,37988000,11380000,income_statement,Banks—Regional,"TriState Capital Holdings, Inc.","TriState Capital Holdings, Inc. operates as the bank holding company for TriState Capital Bank that provides various commercial and private banking services to middle-market businesses and high-net-worth individuals in the United States. It operates in two segments, Bank and Investment Management. The company's deposit products include checking accounts, money market deposit accounts, and certificates of deposit, as well as promontory's certificate of deposit account registry services and insured cash sweep services. It also provides loans that are secured by cash, marketable securities, cash value life insurance, residential property, or other financial assets, as well as commercial and industrial loans, commercial real estate loans, personal loans, asset-based loans, acquisition financing, and letters of credit. In addition, the company offers liquidity and treasury management services, such as online balance reporting, online bill payment, remote deposit, liquidity, wire and ACH, foreign exchange, and controlled disbursement services; and equity and fixed income advisory and sub-advisory services to third party mutual funds and series trust mutual funds, as well as separately managed accounts primarily comprising ultra-high-net-worth and institutional clients that include corporations, ERISA plans, Taft-Hartley funds, municipalities, endowments, and foundations. Further, it provides cash management services; and capital market services, which comprise interest rate swaps and investment management products, as well as engages in wholesaling and marketing the investment products and services. The company offers its products and services through its main office located in Pittsburgh, Pennsylvania, as well as through its four additional representative offices in Cleveland, Ohio; Philadelphia, Pennsylvania; Edison, New Jersey; and New York, New York. TriState Capital Holdings, Inc. was incorporated in 2006 and is headquartered in Pittsburgh, Pennsylvania."
TSCBP,2018-12-31,NA,60369000,NA,54424000,81491000,161526000,0,67701000,NA,5945000,161526000,93825000,0,-7332000,NA,54424000,52304000,12334000,income_statement,Banks—Regional,"TriState Capital Holdings, Inc.","TriState Capital Holdings, Inc. operates as the bank holding company for TriState Capital Bank that provides various commercial and private banking services to middle-market businesses and high-net-worth individuals in the United States. It operates in two segments, Bank and Investment Management. The company's deposit products include checking accounts, money market deposit accounts, and certificates of deposit, as well as promontory's certificate of deposit account registry services and insured cash sweep services. It also provides loans that are secured by cash, marketable securities, cash value life insurance, residential property, or other financial assets, as well as commercial and industrial loans, commercial real estate loans, personal loans, asset-based loans, acquisition financing, and letters of credit. In addition, the company offers liquidity and treasury management services, such as online balance reporting, online bill payment, remote deposit, liquidity, wire and ACH, foreign exchange, and controlled disbursement services; and equity and fixed income advisory and sub-advisory services to third party mutual funds and series trust mutual funds, as well as separately managed accounts primarily comprising ultra-high-net-worth and institutional clients that include corporations, ERISA plans, Taft-Hartley funds, municipalities, endowments, and foundations. Further, it provides cash management services; and capital market services, which comprise interest rate swaps and investment management products, as well as engages in wholesaling and marketing the investment products and services. The company offers its products and services through its main office located in Pittsburgh, Pennsylvania, as well as through its four additional representative offices in Cleveland, Ohio; Philadelphia, Pennsylvania; Edison, New Jersey; and New York, New York. TriState Capital Holdings, Inc. was incorporated in 2006 and is headquartered in Pittsburgh, Pennsylvania."
TSCBP,2019-12-31,NA,68658000,NA,60193000,89670000,180807000,0,77116000,NA,8465000,180807000,103691000,0,-8458000,NA,60193000,54440000,14021000,income_statement,Banks—Regional,"TriState Capital Holdings, Inc.","TriState Capital Holdings, Inc. operates as the bank holding company for TriState Capital Bank that provides various commercial and private banking services to middle-market businesses and high-net-worth individuals in the United States. It operates in two segments, Bank and Investment Management. The company's deposit products include checking accounts, money market deposit accounts, and certificates of deposit, as well as promontory's certificate of deposit account registry services and insured cash sweep services. It also provides loans that are secured by cash, marketable securities, cash value life insurance, residential property, or other financial assets, as well as commercial and industrial loans, commercial real estate loans, personal loans, asset-based loans, acquisition financing, and letters of credit. In addition, the company offers liquidity and treasury management services, such as online balance reporting, online bill payment, remote deposit, liquidity, wire and ACH, foreign exchange, and controlled disbursement services; and equity and fixed income advisory and sub-advisory services to third party mutual funds and series trust mutual funds, as well as separately managed accounts primarily comprising ultra-high-net-worth and institutional clients that include corporations, ERISA plans, Taft-Hartley funds, municipalities, endowments, and foundations. Further, it provides cash management services; and capital market services, which comprise interest rate swaps and investment management products, as well as engages in wholesaling and marketing the investment products and services. The company offers its products and services through its main office located in Pittsburgh, Pennsylvania, as well as through its four additional representative offices in Cleveland, Ohio; Philadelphia, Pennsylvania; Edison, New Jersey; and New York, New York. TriState Capital Holdings, Inc. was incorporated in 2006 and is headquartered in Pittsburgh, Pennsylvania."
TSCBP,2020-12-31,NA,52646000,NA,45234000,100043000,175749000,0,64270000,NA,7412000,175749000,111479000,0,-11624000,NA,45234000,37361000,11436000,income_statement,Banks—Regional,"TriState Capital Holdings, Inc.","TriState Capital Holdings, Inc. operates as the bank holding company for TriState Capital Bank that provides various commercial and private banking services to middle-market businesses and high-net-worth individuals in the United States. It operates in two segments, Bank and Investment Management. The company's deposit products include checking accounts, money market deposit accounts, and certificates of deposit, as well as promontory's certificate of deposit account registry services and insured cash sweep services. It also provides loans that are secured by cash, marketable securities, cash value life insurance, residential property, or other financial assets, as well as commercial and industrial loans, commercial real estate loans, personal loans, asset-based loans, acquisition financing, and letters of credit. In addition, the company offers liquidity and treasury management services, such as online balance reporting, online bill payment, remote deposit, liquidity, wire and ACH, foreign exchange, and controlled disbursement services; and equity and fixed income advisory and sub-advisory services to third party mutual funds and series trust mutual funds, as well as separately managed accounts primarily comprising ultra-high-net-worth and institutional clients that include corporations, ERISA plans, Taft-Hartley funds, municipalities, endowments, and foundations. Further, it provides cash management services; and capital market services, which comprise interest rate swaps and investment management products, as well as engages in wholesaling and marketing the investment products and services. The company offers its products and services through its main office located in Pittsburgh, Pennsylvania, as well as through its four additional representative offices in Cleveland, Ohio; Philadelphia, Pennsylvania; Edison, New Jersey; and New York, New York. TriState Capital Holdings, Inc. was incorporated in 2006 and is headquartered in Pittsburgh, Pennsylvania."
TSCO,2017-12-30,NA,672523000,NA,422599000,1639749000,2491965000,686382000,686382000,-13859000,249924000,7256382000,6570000000,4764417000,-13859000,NA,422599000,422599000,NA,income_statement,NA,NA,NA
TSCO,2018-12-29,NA,683385000,NA,532357000,1823440000,2702528000,701737000,701737000,-18352000,151028000,7911046000,7209309000,5208518000,-18352000,NA,532357000,532357000,NA,income_statement,NA,NA,NA
TSCO,2019-12-28,NA,723377000,NA,562354000,1929672000,2871770000,746120000,746120000,-19843000,161023000,8351931000,7605811000,5480161000,-22743000,NA,562354000,562354000,NA,income_statement,NA,NA,NA
TSCO,2020-12-26,NA,968147000,NA,748958000,2473446000,3761549000,1070979000,1070979000,-28781000,219189000,10620352000,9549373000,6858803000,-102832000,NA,748958000,748958000,NA,income_statement,NA,NA,NA
TSEM,2017-12-31,67664000,201768000,-6354000,298011000,66799000,354305000,219842000,219842000,-19591000,-99888000,1387310000,1167468000,1033005000,-18074000,NA,301656000,298011000,NA,income_statement,Semiconductors,Tower Semiconductor Ltd.,"Tower Semiconductor Ltd., an independent semiconductor foundry, manufactures and markets analog intensive mixed-signal semiconductor devices in the United States, Japan, Asia, and Europe. It provides various customizable process technologies, including SiGe, BiCMOS, mixed-signal/CMOS, RF CMOS, CMOS image sensor, integrated power management, and MEMS. The company also offers transfer optimization and development process services to integrated device manufacturers and fabless companies. It serves various markets, such as consumer electronics, personal computers, communications, automotive, industrial, aerospace, and medical device products. The company was founded in 1993 and is headquartered in Migdal Haemek, Israel."
TSEM,2018-12-31,73053000,139317000,-6761000,135579000,64951000,292947000,154943000,154943000,-19209000,5938000,1304034000,1149091000,1011087000,-15626000,NA,133379000,135579000,NA,income_statement,Semiconductors,Tower Semiconductor Ltd.,"Tower Semiconductor Ltd., an independent semiconductor foundry, manufactures and markets analog intensive mixed-signal semiconductor devices in the United States, Japan, Asia, and Europe. It provides various customizable process technologies, including SiGe, BiCMOS, mixed-signal/CMOS, RF CMOS, CMOS image sensor, integrated power management, and MEMS. The company also offers transfer optimization and development process services to integrated device manufacturers and fabless companies. It serves various markets, such as consumer electronics, personal computers, communications, automotive, industrial, aerospace, and medical device products. The company was founded in 1993 and is headquartered in Migdal Haemek, Israel."
TSEM,2019-12-31,75579000,91021000,-7824000,90048000,67376000,229671000,86716000,86716000,-10122000,2948000,1234003000,1147287000,1004332000,4305000,NA,88073000,90048000,NA,income_statement,Semiconductors,Tower Semiconductor Ltd.,"Tower Semiconductor Ltd., an independent semiconductor foundry, manufactures and markets analog intensive mixed-signal semiconductor devices in the United States, Japan, Asia, and Europe. It provides various customizable process technologies, including SiGe, BiCMOS, mixed-signal/CMOS, RF CMOS, CMOS image sensor, integrated power management, and MEMS. The company also offers transfer optimization and development process services to integrated device manufacturers and fabless companies. It serves various markets, such as consumer electronics, personal computers, communications, automotive, industrial, aerospace, and medical device products. The company was founded in 1993 and is headquartered in Migdal Haemek, Israel."
TSEM,2020-12-31,78320000,88688000,NA,82302000,63965000,233318000,91033000,91033000,-2345000,5399000,1265684000,1174651000,1032366000,-2345000,NA,83289000,82302000,NA,income_statement,Semiconductors,Tower Semiconductor Ltd.,"Tower Semiconductor Ltd., an independent semiconductor foundry, manufactures and markets analog intensive mixed-signal semiconductor devices in the United States, Japan, Asia, and Europe. It provides various customizable process technologies, including SiGe, BiCMOS, mixed-signal/CMOS, RF CMOS, CMOS image sensor, integrated power management, and MEMS. The company also offers transfer optimization and development process services to integrated device manufacturers and fabless companies. It serves various markets, such as consumer electronics, personal computers, communications, automotive, industrial, aerospace, and medical device products. The company was founded in 1993 and is headquartered in Migdal Haemek, Israel."
TSHA,2019-12-31,3948000,-4460000,NA,-4460000,512000,0,-4460000,-4460000,NA,0,0,4460000,0,0,NA,-4460000,-4460000,NA,income_statement,Biotechnology,"Taysha Gene Therapies, Inc.","Taysha Gene Therapies, Inc., a gene therapy company, develops adeno-associated virus based gene therapies for the treatment of monogenic diseases of the central nervous system. It primarily develops TSHA-101 for the treatment of GM2 gangliosidosis; TSHA-118 for the treatment of CLN1 disease; TSHA-102 for the treatment of Rett syndrome; TSHA-103 for the treatment of SLC6A1 haploinsufficiency disorder; and TSHA-104 for the treatment for Surfeit locus 1 deficiency. The company also has strategic partnership with The University of Texas Southwestern Medical Center to develop and commercialize transformative gene therapy treatments. Taysha Gene Therapies, Inc. was founded in 2019 and is based in Dallas, Texas."
TSLA,2017-12-31,1378000000,-2209000000,1395080000,-1962000000,2477000000,2223000000,-1632000000,-1632000000,-477000000,32000000,11759000000,13391000000,9536000000,-577000000,NA,-2241000000,-1962000000,NA,income_statement,NA,NA,NA
TSLA,2018-12-31,1460000000,-1005000000,1390000000,-976000000,2835000000,4042000000,-253000000,-253000000,-653000000,58000000,21461000000,21714000000,17419000000,-752000000,NA,-1063000000,-976000000,NA,income_statement,NA,NA,NA
TSLA,2019-12-31,1343000000,-665000000,1492000000,-862000000,2646000000,4069000000,80000000,80000000,-725000000,110000000,24578000000,24498000000,20509000000,-745000000,NA,-775000000,-870000000,NA,income_statement,NA,NA,NA
TSLA,2020-12-31,1491000000,1154000000,1454000000,721000000,3188000000,6630000000,1951000000,1951000000,-784000000,292000000,31536000000,29585000000,24906000000,-797000000,NA,862000000,690000000,NA,income_statement,NA,NA,NA
TSN,2017-09-30,NA,2628000000,18000000,1774000000,2008000000,5141000000,3133000000,3133000000,-279000000,850000000,38260000000,35127000000,33119000000,-505000000,NA,1778000000,1774000000,NA,income_statement,NA,NA,NA
TSN,2018-09-29,NA,2682000000,8000000,2970000000,2045000000,5197000000,3152000000,3152000000,-350000000,-291000000,40052000000,36900000000,34855000000,-470000000,NA,2973000000,2970000000,NA,income_statement,NA,NA,NA
TSN,2019-09-28,NA,2374000000,144000000,1980000000,2222000000,5094000000,2872000000,2872000000,-462000000,381000000,42405000000,39533000000,37311000000,-498000000,NA,1993000000,1980000000,NA,income_statement,NA,NA,NA
TSN,2020-10-03,NA,2664000000,132000000,2061000000,2167000000,5901000000,3734000000,3734000000,-485000000,593000000,43185000000,39451000000,37284000000,-1070000000,NA,2071000000,2061000000,NA,income_statement,NA,NA,NA
TSRI,2017-05-31,NA,576967,21457,268189,9683601,10246064,562463,562463,-79386,263000,62572585,62010122,52326521,14504,NA,313967,268189,NA,income_statement,Software—Application,"TSR, Inc.","TSR, Inc. offers contract computer programming services in the New York metropolitan area, New England, and the Mid-Atlantic region. It provides technical computer personnel to supplement the in-house information technology capabilities of its customers in the areas of .net and java application development, android and IOS mobile application platform development, project management, IT security, cloud development and architecture, UI design and development, network infrastructure and support, and database development and administration, as well as provides business analysts. The company primarily serves vendor management companies, as well as customers in the financial services business. TSR, Inc. was founded in 1969 and is based in Hauppauge, New York."
TSRI,2018-05-31,NA,937030,44552,486208,9471523,10380900,909377,909377,-79386,381000,64989995,64080618,54609095,27653,NA,556030,486208,NA,income_statement,Software—Application,"TSR, Inc.","TSR, Inc. offers contract computer programming services in the New York metropolitan area, New England, and the Mid-Atlantic region. It provides technical computer personnel to supplement the in-house information technology capabilities of its customers in the areas of .net and java application development, android and IOS mobile application platform development, project management, IT security, cloud development and architecture, UI design and development, network infrastructure and support, and database development and administration, as well as provides business analysts. The company primarily serves vendor management companies, as well as customers in the financial services business. TSR, Inc. was founded in 1969 and is based in Hauppauge, New York."
TSRI,2019-05-31,NA,-1837055,28792,-1335995,11672946,9825392,-1847554,-1847554,-79386,-538000,63340028,65187582,53514636,10499,NA,-1299055,-1335995,NA,income_statement,Software—Application,"TSR, Inc.","TSR, Inc. offers contract computer programming services in the New York metropolitan area, New England, and the Mid-Atlantic region. It provides technical computer personnel to supplement the in-house information technology capabilities of its customers in the areas of .net and java application development, android and IOS mobile application platform development, project management, IT security, cloud development and architecture, UI design and development, network infrastructure and support, and database development and administration, as well as provides business analysts. The company primarily serves vendor management companies, as well as customers in the financial services business. TSR, Inc. was founded in 1969 and is based in Hauppauge, New York."
TSRI,2020-05-31,NA,-1810049,28380,-1126428,10110648,9177996,-932652,-932652,-79386,-712000,59121401,60054053,49943405,-877397,NA,-1098049,-1126428,NA,income_statement,Software—Application,"TSR, Inc.","TSR, Inc. offers contract computer programming services in the New York metropolitan area, New England, and the Mid-Atlantic region. It provides technical computer personnel to supplement the in-house information technology capabilities of its customers in the areas of .net and java application development, android and IOS mobile application platform development, project management, IT security, cloud development and architecture, UI design and development, network infrastructure and support, and database development and administration, as well as provides business analysts. The company primarily serves vendor management companies, as well as customers in the financial services business. TSR, Inc. was founded in 1969 and is based in Hauppauge, New York."
TT,2017-12-31,NA,1417900000,66600000,1302600000,2736800000,4432800000,1696000000,1696000000,-215800000,80200000,14197600000,12501600000,9764800000,-278100000,-25400000,1337700000,1302600000,NA,income_statement,NA,NA,NA
TT,2018-12-31,NA,1257800000,42100000,1337600000,2252000000,3786500000,1534500000,1534500000,-221000000,234900000,12343800000,10809300000,8557300000,-276700000,329800000,1022900000,1337600000,NA,income_statement,NA,NA,NA
TT,2019-12-31,NA,1398900000,44800000,1410900000,2339900000,4027700000,1687800000,1687800000,-242800000,238600000,13075900000,11388100000,9048200000,-288900000,265800000,1160300000,1410900000,NA,income_statement,NA,NA,NA
TT,2020-12-31,NA,1288200000,19400000,854900000,2233700000,3827500000,1593800000,1593800000,-248700000,296800000,12454700000,10860900000,8627200000,-305600000,-122300000,991400000,854900000,NA,income_statement,NA,NA,NA
TTCF,2018-12-31,NA,-365000,-102000,-121000,3237000,3187000,-50000,-50000,-315000,-29000,47295000,47345000,44108000,-315000,NA,-336000,-121000,NA,income_statement,Packaged Foods,"Tattooed Chef, Inc.","Tattooed Chef, Inc., a plant-based food company, produces and sells a portfolio of frozen foods. It supplies plant-based products to retailers in the United States. The company primarily offers products, such as ready-to-cook bowls, zucchini spirals, riced cauliflower, acai and smoothie bowls, and cauliflower crust pizza. Its products are available in private label and Tattooed Chef brand in the frozen food section of retail food stores. Tattooed Chef, Inc. was founded in 2018 and is headquartered in Paramount, California."
TTCF,2019-12-31,NA,5762000,7186000,4526000,7454000,13710000,6256000,6256000,-494000,154000,84919000,78663000,71209000,-494000,NA,5608000,4526000,NA,income_statement,Packaged Foods,"Tattooed Chef, Inc.","Tattooed Chef, Inc., a plant-based food company, produces and sells a portfolio of frozen foods. It supplies plant-based products to retailers in the United States. The company primarily offers products, such as ready-to-cook bowls, zucchini spirals, riced cauliflower, acai and smoothie bowls, and cauliflower crust pizza. Its products are available in private label and Tattooed Chef brand in the frozen food section of retail food stores. Tattooed Chef, Inc. was founded in 2018 and is headquartered in Paramount, California."
TTD,2017-12-31,52806000,63625000,NA,50798000,119825000,241987000,69356000,69356000,-1698000,12827000,308217000,238861000,66230000,-5731000,NA,50798000,50798000,NA,income_statement,Software—Application,"The Trade Desk, Inc.","The Trade Desk, Inc. operates as a technology company in the United States and internationally. The company operates a self-service cloud-based platform that allows buyers to create, manage, and optimize data-driven digital advertising campaigns in various advertising formats, including display, video, audio, native and social, and on various devices, such as computers, mobile devices, and connected TV. It also provides data and other value-added services, as well as platform features. The company serves advertising agencies and other service providers for advertisers. The Trade Desk, Inc. was founded in 2009 and is headquartered in Ventura, California."
TTD,2018-12-31,83892000,105737000,NA,88140000,171981000,363196000,107323000,107323000,-1550000,17597000,477294000,369971000,114098000,-1586000,NA,88140000,88140000,NA,income_statement,Software—Application,"The Trade Desk, Inc.","The Trade Desk, Inc. operates as a technology company in the United States and internationally. The company operates a self-service cloud-based platform that allows buyers to create, manage, and optimize data-driven digital advertising campaigns in various advertising formats, including display, video, audio, native and social, and on various devices, such as computers, mobile devices, and connected TV. It also provides data and other value-added services, as well as platform features. The company serves advertising agencies and other service providers for advertisers. The Trade Desk, Inc. was founded in 2009 and is headquartered in Ventura, California."
TTD,2019-12-31,116752000,116220000,NA,108318000,275930000,504878000,112196000,112196000,NA,7902000,661058000,548862000,156180000,4024000,NA,108318000,108318000,NA,income_statement,Software—Application,"The Trade Desk, Inc.","The Trade Desk, Inc. operates as a technology company in the United States and internationally. The company operates a self-service cloud-based platform that allows buyers to create, manage, and optimize data-driven digital advertising campaigns in various advertising formats, including display, video, audio, native and social, and on various devices, such as computers, mobile devices, and connected TV. It also provides data and other value-added services, as well as platform features. The company serves advertising agencies and other service providers for advertisers. The Trade Desk, Inc. was founded in 2009 and is headquartered in Ventura, California."
TTD,2020-12-31,166654000,143903000,NA,242317000,346359000,657221000,144208000,144208000,NA,-98414000,836033000,691825000,178812000,-305000,NA,242317000,242317000,NA,income_statement,Software—Application,"The Trade Desk, Inc.","The Trade Desk, Inc. operates as a technology company in the United States and internationally. The company operates a self-service cloud-based platform that allows buyers to create, manage, and optimize data-driven digital advertising campaigns in various advertising formats, including display, video, audio, native and social, and on various devices, such as computers, mobile devices, and connected TV. It also provides data and other value-added services, as well as platform features. The company serves advertising agencies and other service providers for advertisers. The Trade Desk, Inc. was founded in 2009 and is headquartered in Ventura, California."
TTEC,2016-12-31,NA,50298000,6981000,33678000,175797000,333666000,89194000,89194000,-7943000,12863000,1275258000,1186064000,941592000,-38896000,NA,37435000,33678000,NA,income_statement,Information Technology Services,"TTEC Holdings, Inc.","TTEC Holdings, Inc., a customer experience technology and services company, focuses on the design, implementation, and delivery of transformative customer experience for various brands. It operates through TTEC Digital and TTEC Engage segments. The TTEC Digital segments designs, builds, and delivers tech-enabled customer experience solutions through its professional services and suite of technology offerings to enabling and accelerating digital transformation for clients. The TTEC Engage segment provides essential technologies, human resources, infrastructure, and processes to operate customer care, acquisition, and fraud detection and prevention services. TTEC Holdings, Inc. serves clients in the automotive, communication, financial services, government, healthcare, logistics, media and entertainment, retail, technology, transportation, and travel industries with operations in the United States, Australia, Belgium, Brazil, Bulgaria, Canada, Costa Rica, Germany, Greece, Hong Kong, India, Ireland, Mexico, the Netherlands, New Zealand, the Philippines, Poland, Singapore, South Africa, Thailand, the United Arab Emirates, and the United Kingdom. The company was formerly known as TeleTech Holdings, Inc. and changed its name to TTEC Holdings, Inc. in January 2018. TTEC Holdings, Inc. was founded in 1982 and is headquartered in Englewood, Colorado."
TTEC,2017-12-31,NA,88887000,6978000,7256000,182314000,367297000,120476000,120476000,-13734000,78075000,1477365000,1356889000,1110068000,-31589000,NA,10812000,7256000,NA,income_statement,Information Technology Services,"TTEC Holdings, Inc.","TTEC Holdings, Inc., a customer experience technology and services company, focuses on the design, implementation, and delivery of transformative customer experience for various brands. It operates through TTEC Digital and TTEC Engage segments. The TTEC Digital segments designs, builds, and delivers tech-enabled customer experience solutions through its professional services and suite of technology offerings to enabling and accelerating digital transformation for clients. The TTEC Engage segment provides essential technologies, human resources, infrastructure, and processes to operate customer care, acquisition, and fraud detection and prevention services. TTEC Holdings, Inc. serves clients in the automotive, communication, financial services, government, healthcare, logistics, media and entertainment, retail, technology, transportation, and travel industries with operations in the United States, Australia, Belgium, Brazil, Bulgaria, Canada, Costa Rica, Germany, Greece, Hong Kong, India, Ireland, Mexico, the Netherlands, New Zealand, the Philippines, Poland, Singapore, South Africa, Thailand, the United Arab Emirates, and the United Kingdom. The company was formerly known as TeleTech Holdings, Inc. and changed its name to TTEC Holdings, Inc. in January 2018. TTEC Holdings, Inc. was founded in 1982 and is headquartered in Englewood, Colorado."
TTEC,2018-12-31,NA,56238000,7677000,35817000,182428000,351244000,99637000,99637000,-28674000,16483000,1509171000,1409534000,1157927000,-43399000,NA,39755000,35817000,NA,income_statement,Information Technology Services,"TTEC Holdings, Inc.","TTEC Holdings, Inc., a customer experience technology and services company, focuses on the design, implementation, and delivery of transformative customer experience for various brands. It operates through TTEC Digital and TTEC Engage segments. The TTEC Digital segments designs, builds, and delivers tech-enabled customer experience solutions through its professional services and suite of technology offerings to enabling and accelerating digital transformation for clients. The TTEC Engage segment provides essential technologies, human resources, infrastructure, and processes to operate customer care, acquisition, and fraud detection and prevention services. TTEC Holdings, Inc. serves clients in the automotive, communication, financial services, government, healthcare, logistics, media and entertainment, retail, technology, transportation, and travel industries with operations in the United States, Australia, Belgium, Brazil, Bulgaria, Canada, Costa Rica, Germany, Greece, Hong Kong, India, Ireland, Mexico, the Netherlands, New Zealand, the Philippines, Poland, Singapore, South Africa, Thailand, the United Arab Emirates, and the United Kingdom. The company was formerly known as TeleTech Holdings, Inc. and changed its name to TTEC Holdings, Inc. in January 2018. TTEC Holdings, Inc. was founded in 1982 and is headquartered in Englewood, Colorado."
TTEC,2019-12-31,NA,110411000,62109000,77164000,253131000,452424000,130207000,130207000,-19113000,25677000,1643704000,1513497000,1191280000,-19796000,NA,84734000,77164000,NA,income_statement,Information Technology Services,"TTEC Holdings, Inc.","TTEC Holdings, Inc., a customer experience technology and services company, focuses on the design, implementation, and delivery of transformative customer experience for various brands. It operates through TTEC Digital and TTEC Engage segments. The TTEC Digital segments designs, builds, and delivers tech-enabled customer experience solutions through its professional services and suite of technology offerings to enabling and accelerating digital transformation for clients. The TTEC Engage segment provides essential technologies, human resources, infrastructure, and processes to operate customer care, acquisition, and fraud detection and prevention services. TTEC Holdings, Inc. serves clients in the automotive, communication, financial services, government, healthcare, logistics, media and entertainment, retail, technology, transportation, and travel industries with operations in the United States, Australia, Belgium, Brazil, Bulgaria, Canada, Costa Rica, Germany, Greece, Hong Kong, India, Ireland, Mexico, the Netherlands, New Zealand, the Philippines, Poland, Singapore, South Africa, Thailand, the United Arab Emirates, and the United Kingdom. The company was formerly known as TeleTech Holdings, Inc. and changed its name to TTEC Holdings, Inc. in January 2018. TTEC Holdings, Inc. was founded in 1982 and is headquartered in Englewood, Colorado."
TTEK,2017-10-01,NA,171761000,171000,117874000,177219000,353638000,176419000,176419000,-12310000,53844000,2034010000,1857591000,1680372000,-4658000,NA,117917000,117874000,NA,income_statement,Engineering & Construction,"Tetra Tech, Inc.","Tetra Tech, Inc. provides consulting and engineering services worldwide. The company operates through Government Services Group (GSG) and Commercial/International Services Group (CIG) segments. The GSG segment offers early data collection and monitoring, data analysis and information technology, science and engineering applied research, engineering design, construction management, and operations and maintenance services; and climate change and energy management consulting, as well as greenhouse gas inventory assessment, certification, reduction, and management services. This segment serves federal, state, and local governments, and development agencies in water resources analysis and water management, environmental monitoring, data analytics, government consulting, waste management, and a range of civil infrastructure master planning and engineering design markets. The CIG segment provides early data collection and monitoring, data analysis and information management, feasibility studies and assessments, science and engineering applied research, engineering design, construction management, and operations and maintenance services. This segment serves natural resources, energy, and utilities markets, as well as civil infrastructure master planning and engineering design markets. Tetra Tech, Inc. was founded in 1966 and is headquartered in Pasadena, California."
TTEK,2018-09-30,NA,174562000,129000,136883000,185720000,384458000,198738000,198738000,-17348000,37605000,2200734000,2001996000,1816276000,-24176000,NA,136957000,136883000,NA,income_statement,Engineering & Construction,"Tetra Tech, Inc.","Tetra Tech, Inc. provides consulting and engineering services worldwide. The company operates through Government Services Group (GSG) and Commercial/International Services Group (CIG) segments. The GSG segment offers early data collection and monitoring, data analysis and information technology, science and engineering applied research, engineering design, construction management, and operations and maintenance services; and climate change and energy management consulting, as well as greenhouse gas inventory assessment, certification, reduction, and management services. This segment serves federal, state, and local governments, and development agencies in water resources analysis and water management, environmental monitoring, data analytics, government consulting, waste management, and a range of civil infrastructure master planning and engineering design markets. The CIG segment provides early data collection and monitoring, data analysis and information management, feasibility studies and assessments, science and engineering applied research, engineering design, construction management, and operations and maintenance services. This segment serves natural resources, energy, and utilities markets, as well as civil infrastructure master planning and engineering design markets. Tetra Tech, Inc. was founded in 1966 and is headquartered in Pasadena, California."
TTEK,2019-09-29,NA,175136000,178000,158668000,196930000,408183000,211253000,211253000,-15358000,16375000,2389637000,2178384000,1981454000,-36117000,NA,158761000,158668000,NA,income_statement,Engineering & Construction,"Tetra Tech, Inc.","Tetra Tech, Inc. provides consulting and engineering services worldwide. The company operates through Government Services Group (GSG) and Commercial/International Services Group (CIG) segments. The GSG segment offers early data collection and monitoring, data analysis and information technology, science and engineering applied research, engineering design, construction management, and operations and maintenance services; and climate change and energy management consulting, as well as greenhouse gas inventory assessment, certification, reduction, and management services. This segment serves federal, state, and local governments, and development agencies in water resources analysis and water management, environmental monitoring, data analytics, government consulting, waste management, and a range of civil infrastructure master planning and engineering design markets. The CIG segment provides early data collection and monitoring, data analysis and information management, feasibility studies and assessments, science and engineering applied research, engineering design, construction management, and operations and maintenance services. This segment serves natural resources, energy, and utilities markets, as well as civil infrastructure master planning and engineering design markets. Tetra Tech, Inc. was founded in 1966 and is headquartered in Pasadena, California."
TTEK,2020-09-27,NA,227991000,54000,173859000,203015000,446535000,243520000,243520000,-14475000,54101000,2348572000,2105052000,1902037000,-15529000,NA,173890000,173859000,NA,income_statement,Engineering & Construction,"Tetra Tech, Inc.","Tetra Tech, Inc. provides consulting and engineering services worldwide. The company operates through Government Services Group (GSG) and Commercial/International Services Group (CIG) segments. The GSG segment offers early data collection and monitoring, data analysis and information technology, science and engineering applied research, engineering design, construction management, and operations and maintenance services; and climate change and energy management consulting, as well as greenhouse gas inventory assessment, certification, reduction, and management services. This segment serves federal, state, and local governments, and development agencies in water resources analysis and water management, environmental monitoring, data analytics, government consulting, waste management, and a range of civil infrastructure master planning and engineering design markets. The CIG segment provides early data collection and monitoring, data analysis and information management, feasibility studies and assessments, science and engineering applied research, engineering design, construction management, and operations and maintenance services. This segment serves natural resources, energy, and utilities markets, as well as civil infrastructure master planning and engineering design markets. Tetra Tech, Inc. was founded in 1966 and is headquartered in Pasadena, California."
TTGT,2017-12-31,8215000,9717000,NA,6803000,56959000,80220000,10410000,10410000,-1272000,2914000,108556000,98146000,28336000,-693000,NA,6803000,6803000,NA,income_statement,Internet Content & Information,"TechTarget, Inc.","TechTarget, Inc. provides specialized online content for buyers of enterprise information technology (IT) products and services in North America and internationally. It also provides purchase-intent marketing and sales services for enterprise technology vendors; and customized marketing programs that integrate demand generation and brand advertising techniques. The company offers online services, including IT Deal Alert, including priority engine, qualified sales opportunities, deal data services; demand solutions, such as white papers, webcasts, podcasts, videocasts, virtual trade shows, and content sponsorships; brand solutions comprise on-network, off-network, and microsites and related formats branding; and custom content creation. It also operates an integrated content platform that consists of a network of approximately 140 Websites that focus on a specific IT sector, such as storage, security, networking, or business applications. In addition, the company enables registered members to conduct their pre-purchase research by accessing vendor supplied content through a websites network. TechTarget, Inc. was founded in 1999 and is headquartered in Newton, Massachusetts."
TTGT,2018-12-31,8869000,14843000,NA,12955000,62336000,92374000,17321000,17321000,-1300000,1888000,121333000,104012000,28959000,-2478000,NA,12955000,12955000,NA,income_statement,Internet Content & Information,"TechTarget, Inc.","TechTarget, Inc. provides specialized online content for buyers of enterprise information technology (IT) products and services in North America and internationally. It also provides purchase-intent marketing and sales services for enterprise technology vendors; and customized marketing programs that integrate demand generation and brand advertising techniques. The company offers online services, including IT Deal Alert, including priority engine, qualified sales opportunities, deal data services; demand solutions, such as white papers, webcasts, podcasts, videocasts, virtual trade shows, and content sponsorships; brand solutions comprise on-network, off-network, and microsites and related formats branding; and custom content creation. It also operates an integrated content platform that consists of a network of approximately 140 Websites that focus on a specific IT sector, such as storage, security, networking, or business applications. In addition, the company enables registered members to conduct their pre-purchase research by accessing vendor supplied content through a websites network. TechTarget, Inc. was founded in 1999 and is headquartered in Newton, Massachusetts."
TTGT,2019-12-31,8107000,22048000,NA,16875000,66550000,102099000,22739000,22739000,-742000,5173000,133957000,111218000,31858000,-691000,NA,16875000,16875000,NA,income_statement,Internet Content & Information,"TechTarget, Inc.","TechTarget, Inc. provides specialized online content for buyers of enterprise information technology (IT) products and services in North America and internationally. It also provides purchase-intent marketing and sales services for enterprise technology vendors; and customized marketing programs that integrate demand generation and brand advertising techniques. The company offers online services, including IT Deal Alert, including priority engine, qualified sales opportunities, deal data services; demand solutions, such as white papers, webcasts, podcasts, videocasts, virtual trade shows, and content sponsorships; brand solutions comprise on-network, off-network, and microsites and related formats branding; and custom content creation. It also operates an integrated content platform that consists of a network of approximately 140 Websites that focus on a specific IT sector, such as storage, security, networking, or business applications. In addition, the company enables registered members to conduct their pre-purchase research by accessing vendor supplied content through a websites network. TechTarget, Inc. was founded in 1999 and is headquartered in Newton, Massachusetts."
TTGT,2020-12-31,7827000,22504000,NA,17068000,74438000,111032000,22821000,22821000,-317000,5436000,148376000,125555000,37344000,-317000,NA,17068000,17068000,NA,income_statement,Internet Content & Information,"TechTarget, Inc.","TechTarget, Inc. provides specialized online content for buyers of enterprise information technology (IT) products and services in North America and internationally. It also provides purchase-intent marketing and sales services for enterprise technology vendors; and customized marketing programs that integrate demand generation and brand advertising techniques. The company offers online services, including IT Deal Alert, including priority engine, qualified sales opportunities, deal data services; demand solutions, such as white papers, webcasts, podcasts, videocasts, virtual trade shows, and content sponsorships; brand solutions comprise on-network, off-network, and microsites and related formats branding; and custom content creation. It also operates an integrated content platform that consists of a network of approximately 140 Websites that focus on a specific IT sector, such as storage, security, networking, or business applications. In addition, the company enables registered members to conduct their pre-purchase research by accessing vendor supplied content through a websites network. TechTarget, Inc. was founded in 1999 and is headquartered in Newton, Massachusetts."
TTMI,2018-01-01,19770000,139958000,NA,124214000,191997000,429581000,213950000,213950000,-53898000,15231000,2658592000,2444642000,2229011000,-73992000,193921000,124727000,124214000,NA,income_statement,Electronic Components,"TTM Technologies, Inc.","TTM Technologies, Inc., together with its subsidiaries, manufactures printed circuit boards (PCBs) worldwide. The company operates through two segments, PCB and E-M Solutions. The company offers a range of PCB products, radio-frequency (RF) components, and electro-mechanical solutions, including conventional PCBs, RF and microwave circuits, high density interconnect PCBs, substrate-like PCBs, flexible PCBs, rigid-flex PCBs, custom assemblies and system integration products, IC substrates, passive RF components, advanced ceramic RF components, multi-chip modules, and beamforming and switching networks. It also produces printed circuits with heavy copper cores, and embedded and press-fit coins; PCBs with electrically passive heat sinks; and PCBs with electrically active thermal cores. In addition, it offers various services, including design for manufacturability, PCB layout design, simulation and testing, and quick turnaround services. The company serves original equipment manufacturers and electronic manufacturing services companies that primarily serve the aerospace and defense, automotive, cellular phone, computing, medical/industrial/instrumentation, and networking/communications end markets of the electronics industry; and the U.S. government. TTM Technologies, Inc. was founded in 1978 and is headquartered in Santa Ana, California."
TTMI,2018-12-31,19770000,89768000,NA,173584000,219471000,461934000,182782000,182782000,-78958000,-83816000,2847261000,2664479000,2385327000,-93014000,193921000,173584000,173584000,NA,income_statement,Electronic Components,"TTM Technologies, Inc.","TTM Technologies, Inc., together with its subsidiaries, manufactures printed circuit boards (PCBs) worldwide. The company operates through two segments, PCB and E-M Solutions. The company offers a range of PCB products, radio-frequency (RF) components, and electro-mechanical solutions, including conventional PCBs, RF and microwave circuits, high density interconnect PCBs, substrate-like PCBs, flexible PCBs, rigid-flex PCBs, custom assemblies and system integration products, IC substrates, passive RF components, advanced ceramic RF components, multi-chip modules, and beamforming and switching networks. It also produces printed circuits with heavy copper cores, and embedded and press-fit coins; PCBs with electrically passive heat sinks; and PCBs with electrically active thermal cores. In addition, it offers various services, including design for manufacturability, PCB layout design, simulation and testing, and quick turnaround services. The company serves original equipment manufacturers and electronic manufacturing services companies that primarily serve the aerospace and defense, automotive, cellular phone, computing, medical/industrial/instrumentation, and networking/communications end markets of the electronics industry; and the U.S. government. TTM Technologies, Inc. was founded in 1978 and is headquartered in Santa Ana, California."
TTMI,2019-12-30,19770000,46184000,NA,41301000,219205000,401683000,134004000,134004000,-83234000,4883000,2689308000,2555304000,2287625000,-87820000,193921000,41301000,41301000,NA,income_statement,Electronic Components,"TTM Technologies, Inc.","TTM Technologies, Inc., together with its subsidiaries, manufactures printed circuit boards (PCBs) worldwide. The company operates through two segments, PCB and E-M Solutions. The company offers a range of PCB products, radio-frequency (RF) components, and electro-mechanical solutions, including conventional PCBs, RF and microwave circuits, high density interconnect PCBs, substrate-like PCBs, flexible PCBs, rigid-flex PCBs, custom assemblies and system integration products, IC substrates, passive RF components, advanced ceramic RF components, multi-chip modules, and beamforming and switching networks. It also produces printed circuits with heavy copper cores, and embedded and press-fit coins; PCBs with electrically passive heat sinks; and PCBs with electrically active thermal cores. In addition, it offers various services, including design for manufacturability, PCB layout design, simulation and testing, and quick turnaround services. The company serves original equipment manufacturers and electronic manufacturing services companies that primarily serve the aerospace and defense, automotive, cellular phone, computing, medical/industrial/instrumentation, and networking/communications end markets of the electronics industry; and the U.S. government. TTM Technologies, Inc. was founded in 1978 and is headquartered in Santa Ana, California."
TTMI,2020-12-28,19770000,-46277000,NA,177535000,186359000,364858000,119891000,119891000,-73156000,-29891000,2105322000,1985431000,1740464000,-166168000,193921000,-16386000,177535000,NA,income_statement,Electronic Components,"TTM Technologies, Inc.","TTM Technologies, Inc., together with its subsidiaries, manufactures printed circuit boards (PCBs) worldwide. The company operates through two segments, PCB and E-M Solutions. The company offers a range of PCB products, radio-frequency (RF) components, and electro-mechanical solutions, including conventional PCBs, RF and microwave circuits, high density interconnect PCBs, substrate-like PCBs, flexible PCBs, rigid-flex PCBs, custom assemblies and system integration products, IC substrates, passive RF components, advanced ceramic RF components, multi-chip modules, and beamforming and switching networks. It also produces printed circuits with heavy copper cores, and embedded and press-fit coins; PCBs with electrically passive heat sinks; and PCBs with electrically active thermal cores. In addition, it offers various services, including design for manufacturability, PCB layout design, simulation and testing, and quick turnaround services. The company serves original equipment manufacturers and electronic manufacturing services companies that primarily serve the aerospace and defense, automotive, cellular phone, computing, medical/industrial/instrumentation, and networking/communications end markets of the electronics industry; and the U.S. government. TTM Technologies, Inc. was founded in 1978 and is headquartered in Santa Ana, California."
TTNP,2016-12-31,NA,5135000,NA,5135000,4596000,8939000,4343000,4343000,-369000,0,15065000,10722000,6126000,792000,NA,5135000,5135000,NA,income_statement,Biotechnology,"Titan Pharmaceuticals, Inc.","Titan Pharmaceuticals, Inc., a pharmaceutical company, develops therapeutics for the treatment of chronic diseases. It develops products based on ProNeura, a proprietary long-term drug delivery platform that focuses primarily on the treatment for chronic diseases. The company also develops ProNeura-Ropinirole, an implant to provide delivery of ropinirole, a dopamine agonist for the treatment of Parkinson's disease; and triiodothyronine, an implant for the treatment of hypothyroidism. Titan Pharmaceuticals, Inc. was incorporated in 1992 and is based in South San Francisco, California."
TTNP,2017-12-31,NA,-14307000,NA,-14307000,5069000,-9433000,-14502000,-14502000,-369000,0,215000,14717000,9648000,195000,NA,-14307000,-14307000,NA,income_statement,Biotechnology,"Titan Pharmaceuticals, Inc.","Titan Pharmaceuticals, Inc., a pharmaceutical company, develops therapeutics for the treatment of chronic diseases. It develops products based on ProNeura, a proprietary long-term drug delivery platform that focuses primarily on the treatment for chronic diseases. The company also develops ProNeura-Ropinirole, an implant to provide delivery of ropinirole, a dopamine agonist for the treatment of Parkinson's disease; and triiodothyronine, an implant for the treatment of hypothyroidism. Titan Pharmaceuticals, Inc. was incorporated in 1992 and is based in South San Francisco, California."
TTNP,2018-12-31,NA,-9023000,NA,-9023000,6866000,-1398000,-8264000,-8264000,-887000,0,6618000,14882000,8016000,-759000,NA,-9023000,-9308000,NA,income_statement,Biotechnology,"Titan Pharmaceuticals, Inc.","Titan Pharmaceuticals, Inc., a pharmaceutical company, develops therapeutics for the treatment of chronic diseases. It develops products based on ProNeura, a proprietary long-term drug delivery platform that focuses primarily on the treatment for chronic diseases. The company also develops ProNeura-Ropinirole, an implant to provide delivery of ropinirole, a dopamine agonist for the treatment of Parkinson's disease; and triiodothyronine, an implant for the treatment of hypothyroidism. Titan Pharmaceuticals, Inc. was incorporated in 1992 and is based in South San Francisco, California."
TTNP,2019-12-31,NA,-16458000,NA,-16458000,11925000,-4919000,-16844000,-16844000,-967000,0,3611000,20455000,8530000,386000,NA,-16458000,-16458000,NA,income_statement,Biotechnology,"Titan Pharmaceuticals, Inc.","Titan Pharmaceuticals, Inc., a pharmaceutical company, develops therapeutics for the treatment of chronic diseases. It develops products based on ProNeura, a proprietary long-term drug delivery platform that focuses primarily on the treatment for chronic diseases. The company also develops ProNeura-Ropinirole, an implant to provide delivery of ropinirole, a dopamine agonist for the treatment of Parkinson's disease; and triiodothyronine, an implant for the treatment of hypothyroidism. Titan Pharmaceuticals, Inc. was incorporated in 1992 and is based in South San Francisco, California."
TTOO,2016-12-31,NA,-54804000,NA,-54804000,24077000,-26801000,-50878000,-50878000,-4098000,0,4080000,54958000,30881000,-3926000,NA,-54804000,-54804000,NA,income_statement,Diagnostics & Research,"T2 Biosystems, Inc.","T2 Biosystems, Inc., an in vitro diagnostics company, develops diagnostic products and product candidates in the United States and internationally. It provides T2 Magnetic Resonance technology that enables detection of pathogens, biomarkers, and other abnormalities in various unpurified patient sample types, including whole blood, plasma, serum, saliva, sputum, cerebral spinal fluid, and urine. The company also offers T2Dx Instrument, a bench-top instrument for detecting pathogens associated with sepsis and Lyme disease, and other applications, as well as T2Candida Panel that identifies the species of Candida, a fungal pathogen known to cause sepsis directly from whole blood. In addition, it provides T2Bacteria Panel, a multiplex diagnostic panel that detects various bacterial pathogens associated with sepsis; T2SARS-CoV-2 Panel, a COVID-19 molecular diagnostic test; and T2Resistance Panel for the early and sensitive detection of carbapenemase-resistance markers. Further, it develops T2Cauris Panel, a multi-drug resistant pathogen; and T2Lyme Panel for the detection of various strains of Lyme disease-causing bacteria. The company has collaboration agreements with Canon U.S. Life Sciences, Inc. to develop a diagnostic test panel to detect Lyme disease; and Allergan Sales, LLC to develop detection diagnostic test panel that adds one additional bacteria species to the existing T2Bacteria product candidate, as well as for testing drug resistance directly in whole blood. T2 Biosystems, Inc. was founded in 2006 and is headquartered in Lexington, Massachusetts."
TTOO,2017-12-31,NA,-62428000,NA,-62428000,22757000,-28524000,-51281000,-51281000,-6669000,0,4666000,55947000,33190000,-11147000,NA,-62428000,-62428000,NA,income_statement,Diagnostics & Research,"T2 Biosystems, Inc.","T2 Biosystems, Inc., an in vitro diagnostics company, develops diagnostic products and product candidates in the United States and internationally. It provides T2 Magnetic Resonance technology that enables detection of pathogens, biomarkers, and other abnormalities in various unpurified patient sample types, including whole blood, plasma, serum, saliva, sputum, cerebral spinal fluid, and urine. The company also offers T2Dx Instrument, a bench-top instrument for detecting pathogens associated with sepsis and Lyme disease, and other applications, as well as T2Candida Panel that identifies the species of Candida, a fungal pathogen known to cause sepsis directly from whole blood. In addition, it provides T2Bacteria Panel, a multiplex diagnostic panel that detects various bacterial pathogens associated with sepsis; T2SARS-CoV-2 Panel, a COVID-19 molecular diagnostic test; and T2Resistance Panel for the early and sensitive detection of carbapenemase-resistance markers. Further, it develops T2Cauris Panel, a multi-drug resistant pathogen; and T2Lyme Panel for the detection of various strains of Lyme disease-causing bacteria. The company has collaboration agreements with Canon U.S. Life Sciences, Inc. to develop a diagnostic test panel to detect Lyme disease; and Allergan Sales, LLC to develop detection diagnostic test panel that adds one additional bacteria species to the existing T2Bacteria product candidate, as well as for testing drug resistance directly in whole blood. T2 Biosystems, Inc. was founded in 2006 and is headquartered in Lexington, Massachusetts."
TTOO,2018-12-31,NA,-51153000,NA,-51153000,25697000,-18710000,-44407000,-44407000,-6682000,0,10500000,54907000,29210000,-6746000,NA,-51153000,-51153000,NA,income_statement,Diagnostics & Research,"T2 Biosystems, Inc.","T2 Biosystems, Inc., an in vitro diagnostics company, develops diagnostic products and product candidates in the United States and internationally. It provides T2 Magnetic Resonance technology that enables detection of pathogens, biomarkers, and other abnormalities in various unpurified patient sample types, including whole blood, plasma, serum, saliva, sputum, cerebral spinal fluid, and urine. The company also offers T2Dx Instrument, a bench-top instrument for detecting pathogens associated with sepsis and Lyme disease, and other applications, as well as T2Candida Panel that identifies the species of Candida, a fungal pathogen known to cause sepsis directly from whole blood. In addition, it provides T2Bacteria Panel, a multiplex diagnostic panel that detects various bacterial pathogens associated with sepsis; T2SARS-CoV-2 Panel, a COVID-19 molecular diagnostic test; and T2Resistance Panel for the early and sensitive detection of carbapenemase-resistance markers. Further, it develops T2Cauris Panel, a multi-drug resistant pathogen; and T2Lyme Panel for the detection of various strains of Lyme disease-causing bacteria. The company has collaboration agreements with Canon U.S. Life Sciences, Inc. to develop a diagnostic test panel to detect Lyme disease; and Allergan Sales, LLC to develop detection diagnostic test panel that adds one additional bacteria species to the existing T2Bacteria product candidate, as well as for testing drug resistance directly in whole blood. T2 Biosystems, Inc. was founded in 2006 and is headquartered in Lexington, Massachusetts."
TTOO,2019-12-31,NA,-59006000,NA,-59006000,27304000,-24754000,-52058000,-52058000,-7348000,0,8335000,60393000,33089000,-6948000,NA,-59006000,-59006000,NA,income_statement,Diagnostics & Research,"T2 Biosystems, Inc.","T2 Biosystems, Inc., an in vitro diagnostics company, develops diagnostic products and product candidates in the United States and internationally. It provides T2 Magnetic Resonance technology that enables detection of pathogens, biomarkers, and other abnormalities in various unpurified patient sample types, including whole blood, plasma, serum, saliva, sputum, cerebral spinal fluid, and urine. The company also offers T2Dx Instrument, a bench-top instrument for detecting pathogens associated with sepsis and Lyme disease, and other applications, as well as T2Candida Panel that identifies the species of Candida, a fungal pathogen known to cause sepsis directly from whole blood. In addition, it provides T2Bacteria Panel, a multiplex diagnostic panel that detects various bacterial pathogens associated with sepsis; T2SARS-CoV-2 Panel, a COVID-19 molecular diagnostic test; and T2Resistance Panel for the early and sensitive detection of carbapenemase-resistance markers. Further, it develops T2Cauris Panel, a multi-drug resistant pathogen; and T2Lyme Panel for the detection of various strains of Lyme disease-causing bacteria. The company has collaboration agreements with Canon U.S. Life Sciences, Inc. to develop a diagnostic test panel to detect Lyme disease; and Allergan Sales, LLC to develop detection diagnostic test panel that adds one additional bacteria species to the existing T2Bacteria product candidate, as well as for testing drug resistance directly in whole blood. T2 Biosystems, Inc. was founded in 2006 and is headquartered in Lexington, Massachusetts."
TTWO,2017-03-31,137915000,76965000,NA,67303000,496862000,776955000,111471000,111471000,-29569000,9662000,1779748000,1668277000,1002793000,-34506000,NA,67303000,66028000,NA,income_statement,NA,NA,NA
TTWO,2018-03-31,196373000,136625000,NA,173533000,503920000,895641000,151379000,151379000,-22269000,-36908000,1792892000,1641513000,897251000,-14754000,NA,173533000,173374000,NA,income_statement,NA,NA,NA
TTWO,2019-03-31,230170000,232785000,NA,333837000,672634000,1152176000,209140000,209140000,-8032000,-101052000,2668394000,2459254000,1516218000,23645000,NA,333837000,333837000,NA,income_statement,NA,NA,NA
TTWO,2020-03-31,296398000,458439000,NA,404459000,776659000,1546520000,425350000,425350000,-2637000,53980000,3088970000,2663620000,1542450000,33089000,NA,404459000,404459000,NA,income_statement,NA,NA,NA
TURN,2016-12-31,NA,-16364593,NA,-16366360,5332797,1792190,-3586116,-3586116,-886874,1767,1792190,5378306,0,-12778477,NA,-16366360,-16366360,4885,income_statement,Asset Management,180 Degree Capital Corp.,"180 Degree Capital Corp. is a principal investment firm. It is focused on investing in and providing value-added assistance through constructive activism to companies that are substantially undervalued, small, and publicly traded. It typically focuses on less than $250 million market capitalization (microcap) public companies in the United States. It seeks that the result of constructive activism leads to a reversal in direction for the share price of the investee companies. It also seeks active engagement with management of the investee companies and prefers to take a board seat. It also co-invests. 180 Degree Capital Corp. was founded in August 1981 and is based in Montclair, New Jersey."
TURN,2017-12-31,NA,9430596,NA,9417743,3964998,1229923,-2758466,-2758466,NA,12853,1229923,3988389,0,12189062,NA,9417743,9417743,4885,income_statement,Asset Management,180 Degree Capital Corp.,"180 Degree Capital Corp. is a principal investment firm. It is focused on investing in and providing value-added assistance through constructive activism to companies that are substantially undervalued, small, and publicly traded. It typically focuses on less than $250 million market capitalization (microcap) public companies in the United States. It seeks that the result of constructive activism leads to a reversal in direction for the share price of the investee companies. It also seeks active engagement with management of the investee companies and prefers to take a board seat. It also co-invests. 180 Degree Capital Corp. was founded in August 1981 and is based in Montclair, New Jersey."
TURN,2018-12-31,NA,997782,NA,991779,3030779,685836,-2349828,-2349828,NA,6003,685836,3035664,0,3347610,NA,991779,991779,4885,income_statement,Asset Management,180 Degree Capital Corp.,"180 Degree Capital Corp. is a principal investment firm. It is focused on investing in and providing value-added assistance through constructive activism to companies that are substantially undervalued, small, and publicly traded. It typically focuses on less than $250 million market capitalization (microcap) public companies in the United States. It seeks that the result of constructive activism leads to a reversal in direction for the share price of the investee companies. It also seeks active engagement with management of the investee companies and prefers to take a board seat. It also co-invests. 180 Degree Capital Corp. was founded in August 1981 and is based in Montclair, New Jersey."
TURN,2019-12-31,NA,13180138,NA,13178871,5693065,791297,-4906983,-4906983,NA,1267,791297,5698280,0,18087121,NA,13178871,13178871,5215,income_statement,Asset Management,180 Degree Capital Corp.,"180 Degree Capital Corp. is a principal investment firm. It is focused on investing in and providing value-added assistance through constructive activism to companies that are substantially undervalued, small, and publicly traded. It typically focuses on less than $250 million market capitalization (microcap) public companies in the United States. It seeks that the result of constructive activism leads to a reversal in direction for the share price of the investee companies. It also seeks active engagement with management of the investee companies and prefers to take a board seat. It also co-invests. 180 Degree Capital Corp. was founded in August 1981 and is based in Montclair, New Jersey."
TUSK,2016-12-31,NA,-38568000,NA,-24140000,18048000,57604000,-32759000,-32759000,-4096000,-14428000,230625000,263384000,173021000,-5809000,NA,-24140000,-24140000,NA,income_statement,Oil & Gas Equipment & Services,"Mammoth Energy Services, Inc.","Mammoth Energy Services, Inc. operates as an oilfield service company. The company operates in three segments: Infrastructure Services, Pressure Pumping Services, and Natural Sand Proppant Services. The Infrastructure Services segment offers a range of services on electric transmission and distribution, networks and substation facilities, including the construction, upgrade, maintenance, and repair of high voltage transmission lines, substations, and lower voltage overhead and underground distribution systems; storm repair and restoration services; and commercial services comprising installation, maintenance, and repair of commercial wiring. The Pressure Pumping Services segment provides high-pressure hydraulic fracturing services to enhance the production of oil and natural gas from formations having low permeability. The Natural Sand Proppant Services segment is involved in mining, processing, and selling proppant for hydraulic fracturing; buying processed sand from suppliers on the spot market and reselling that sand; and providing logistics solutions to facilitate delivery of frac sand products. The company also offers other energy services, including contract land and directional drilling, coil tubing, pressure control, flowback, cementing, acidizing, equipment rental, crude oil hauling, and remote accommodation services. It serves government-funded utilities, private and public investor owned utilities, co-operative utilities, independent oil and natural gas producers and land-based drilling contractors in North America. The company was founded in 2014 and is headquartered in Oklahoma City, Oklahoma."
TUSK,2017-12-31,NA,61796000,NA,58964000,49886000,208927000,66917000,66917000,-4310000,2832000,691496000,624579000,482569000,-5121000,NA,58964000,58964000,NA,income_statement,Oil & Gas Equipment & Services,"Mammoth Energy Services, Inc.","Mammoth Energy Services, Inc. operates as an oilfield service company. The company operates in three segments: Infrastructure Services, Pressure Pumping Services, and Natural Sand Proppant Services. The Infrastructure Services segment offers a range of services on electric transmission and distribution, networks and substation facilities, including the construction, upgrade, maintenance, and repair of high voltage transmission lines, substations, and lower voltage overhead and underground distribution systems; storm repair and restoration services; and commercial services comprising installation, maintenance, and repair of commercial wiring. The Pressure Pumping Services segment provides high-pressure hydraulic fracturing services to enhance the production of oil and natural gas from formations having low permeability. The Natural Sand Proppant Services segment is involved in mining, processing, and selling proppant for hydraulic fracturing; buying processed sand from suppliers on the spot market and reselling that sand; and providing logistics solutions to facilitate delivery of frac sand products. The company also offers other energy services, including contract land and directional drilling, coil tubing, pressure control, flowback, cementing, acidizing, equipment rental, crude oil hauling, and remote accommodation services. It serves government-funded utilities, private and public investor owned utilities, co-operative utilities, independent oil and natural gas producers and land-based drilling contractors in North America. The company was founded in 2014 and is headquartered in Oklahoma City, Oklahoma."
TUSK,2018-12-31,NA,389228000,NA,235965000,73097000,596280000,403306000,403306000,-3187000,153263000,1690084000,1286778000,1093804000,-14078000,NA,235965000,235965000,NA,income_statement,Oil & Gas Equipment & Services,"Mammoth Energy Services, Inc.","Mammoth Energy Services, Inc. operates as an oilfield service company. The company operates in three segments: Infrastructure Services, Pressure Pumping Services, and Natural Sand Proppant Services. The Infrastructure Services segment offers a range of services on electric transmission and distribution, networks and substation facilities, including the construction, upgrade, maintenance, and repair of high voltage transmission lines, substations, and lower voltage overhead and underground distribution systems; storm repair and restoration services; and commercial services comprising installation, maintenance, and repair of commercial wiring. The Pressure Pumping Services segment provides high-pressure hydraulic fracturing services to enhance the production of oil and natural gas from formations having low permeability. The Natural Sand Proppant Services segment is involved in mining, processing, and selling proppant for hydraulic fracturing; buying processed sand from suppliers on the spot market and reselling that sand; and providing logistics solutions to facilitate delivery of frac sand products. The company also offers other energy services, including contract land and directional drilling, coil tubing, pressure control, flowback, cementing, acidizing, equipment rental, crude oil hauling, and remote accommodation services. It serves government-funded utilities, private and public investor owned utilities, co-operative utilities, independent oil and natural gas producers and land-based drilling contractors in North America. The company was founded in 2014 and is headquartered in Oklahoma City, Oklahoma."
TUSK,2019-12-31,NA,-91125000,NA,-79044000,51552000,81224000,-87361000,-87361000,-4958000,-12081000,625012000,712373000,543788000,-3764000,NA,-79044000,-79044000,NA,income_statement,Oil & Gas Equipment & Services,"Mammoth Energy Services, Inc.","Mammoth Energy Services, Inc. operates as an oilfield service company. The company operates in three segments: Infrastructure Services, Pressure Pumping Services, and Natural Sand Proppant Services. The Infrastructure Services segment offers a range of services on electric transmission and distribution, networks and substation facilities, including the construction, upgrade, maintenance, and repair of high voltage transmission lines, substations, and lower voltage overhead and underground distribution systems; storm repair and restoration services; and commercial services comprising installation, maintenance, and repair of commercial wiring. The Pressure Pumping Services segment provides high-pressure hydraulic fracturing services to enhance the production of oil and natural gas from formations having low permeability. The Natural Sand Proppant Services segment is involved in mining, processing, and selling proppant for hydraulic fracturing; buying processed sand from suppliers on the spot market and reselling that sand; and providing logistics solutions to facilitate delivery of frac sand products. The company also offers other energy services, including contract land and directional drilling, coil tubing, pressure control, flowback, cementing, acidizing, equipment rental, crude oil hauling, and remote accommodation services. It serves government-funded utilities, private and public investor owned utilities, co-operative utilities, independent oil and natural gas producers and land-based drilling contractors in North America. The company was founded in 2014 and is headquartered in Oklahoma City, Oklahoma."
TVTY,2016-12-31,NA,78064000,NA,-129111000,39478000,143878000,100315000,100315000,-17318000,21973000,500998000,400683000,357120000,-22251000,-184706000,56091000,-129111000,NA,income_statement,Medical Care Facilities,"Tivity Health, Inc.","Tivity Health, Inc. provides fitness, nutrition, and social connection solutions in the United States. It operates through two segments, Healthcare and Nutrition. The Healthcare segment offers SilverSneakers senior fitness program to the members of Medicare advantage and Medicare supplement programs; Prime fitness, a fitness facility access program through commercial health plans, employers, and other sponsoring organizations; health plans through WholeHealth Living program; and health services, such as chiropractic care, acupuncture, physical therapy, occupational therapy, speech therapy, and others. The Nutrition segment provides weight management products and services under the Nutrisystem, South Beach Diet, and Wisely Well names. This segment sells pre-packaged foods comprising frozen and non-frozen, and shelf-stable products directly to weight loss program participants primarily through the Internet and telephone; QVC, a television shopping network; and retailers. The company was formerly known as Healthways, Inc. and changed its name to Tivity Health, Inc. in January 2017. Tivity Health, Inc. was founded in 1981 and is headquartered in Franklin, Tennessee."
TVTY,2017-12-31,NA,104783000,NA,63715000,39705000,166681000,123619000,123619000,-15613000,43553000,556942000,433323000,390261000,-18836000,2485000,61230000,63715000,NA,income_statement,Medical Care Facilities,"Tivity Health, Inc.","Tivity Health, Inc. provides fitness, nutrition, and social connection solutions in the United States. It operates through two segments, Healthcare and Nutrition. The Healthcare segment offers SilverSneakers senior fitness program to the members of Medicare advantage and Medicare supplement programs; Prime fitness, a fitness facility access program through commercial health plans, employers, and other sponsoring organizations; health plans through WholeHealth Living program; and health services, such as chiropractic care, acupuncture, physical therapy, occupational therapy, speech therapy, and others. The Nutrition segment provides weight management products and services under the Nutrisystem, South Beach Diet, and Wisely Well names. This segment sells pre-packaged foods comprising frozen and non-frozen, and shelf-stable products directly to weight loss program participants primarily through the Internet and telephone; QVC, a television shopping network; and retailers. The company was formerly known as Healthways, Inc. and changed its name to Tivity Health, Inc. in January 2017. Tivity Health, Inc. was founded in 1981 and is headquartered in Franklin, Tennessee."
TVTY,2018-12-31,NA,124948000,NA,98803000,46194000,187966000,137105000,137105000,-8733000,27046000,606299000,469194000,418333000,-12157000,901000,97902000,98803000,NA,income_statement,Medical Care Facilities,"Tivity Health, Inc.","Tivity Health, Inc. provides fitness, nutrition, and social connection solutions in the United States. It operates through two segments, Healthcare and Nutrition. The Healthcare segment offers SilverSneakers senior fitness program to the members of Medicare advantage and Medicare supplement programs; Prime fitness, a fitness facility access program through commercial health plans, employers, and other sponsoring organizations; health plans through WholeHealth Living program; and health services, such as chiropractic care, acupuncture, physical therapy, occupational therapy, speech therapy, and others. The Nutrition segment provides weight management products and services under the Nutrisystem, South Beach Diet, and Wisely Well names. This segment sells pre-packaged foods comprising frozen and non-frozen, and shelf-stable products directly to weight loss program participants primarily through the Internet and telephone; QVC, a television shopping network; and retailers. The company was formerly known as Healthways, Inc. and changed its name to Tivity Health, Inc. in January 2017. Tivity Health, Inc. was founded in 1981 and is headquartered in Franklin, Tennessee."
TVTY,2019-12-31,NA,-326409000,NA,-286821000,236144000,453100000,166181000,166181000,-76566000,-39588000,1131157000,964976000,678057000,-492590000,NA,-286821000,-286821000,NA,income_statement,Medical Care Facilities,"Tivity Health, Inc.","Tivity Health, Inc. provides fitness, nutrition, and social connection solutions in the United States. It operates through two segments, Healthcare and Nutrition. The Healthcare segment offers SilverSneakers senior fitness program to the members of Medicare advantage and Medicare supplement programs; Prime fitness, a fitness facility access program through commercial health plans, employers, and other sponsoring organizations; health plans through WholeHealth Living program; and health services, such as chiropractic care, acupuncture, physical therapy, occupational therapy, speech therapy, and others. The Nutrition segment provides weight management products and services under the Nutrisystem, South Beach Diet, and Wisely Well names. This segment sells pre-packaged foods comprising frozen and non-frozen, and shelf-stable products directly to weight loss program participants primarily through the Internet and telephone; QVC, a television shopping network; and retailers. The company was formerly known as Healthways, Inc. and changed its name to Tivity Health, Inc. in January 2017. Tivity Health, Inc. was founded in 1981 and is headquartered in Franklin, Tennessee."
TW,2017-12-31,NA,89777000,1214157000,83648000,316728000,532955000,0,147612000,NA,6129000,562968000,415356000,30013000,-57835000,NA,83648000,83648000,1200000,income_statement,Capital Markets,Tradeweb Markets Inc.,"Tradeweb Markets Inc. builds and operates electronic marketplaces in the United States, Europe, Asia, and internationally. The company's marketplaces facilitate trading in a range of asset classes, including rates, credit, money markets, and equities. It offers pre-trade data and analytics, trade execution, and trade processing, as well as post-trade data, analytics, and reporting services. The company provides flexible order and trading systems to institutional investors in 40 markets across 25 currencies. It also offers a range of electronic, voice, and hybrid platforms to approximately 300 dealers and financial institutions on electronic or hybrid markets with Dealerweb platform; and trading solutions for financial advisory companies and traders with Tradeweb Direct platform. The company serves a network of approximately 2,500 clients in the institutional, wholesale, and retail client sectors. Its customers include asset managers, hedge funds, insurance companies, central banks, banks and dealers, proprietary trading firms, retail brokerage and financial advisory firms, and regional dealers. The company was founded in 1996 and is headquartered in New York, New York. Tradeweb Markets Inc. is a subsidiary of BCP York Holdings."
TW,2018-12-31,NA,174782000,1214157000,159467000,366976000,647903000,0,199099000,NA,15315000,684408000,485309000,36505000,-24317000,NA,159467000,159467000,1200000,income_statement,Capital Markets,Tradeweb Markets Inc.,"Tradeweb Markets Inc. builds and operates electronic marketplaces in the United States, Europe, Asia, and internationally. The company's marketplaces facilitate trading in a range of asset classes, including rates, credit, money markets, and equities. It offers pre-trade data and analytics, trade execution, and trade processing, as well as post-trade data, analytics, and reporting services. The company provides flexible order and trading systems to institutional investors in 40 markets across 25 currencies. It also offers a range of electronic, voice, and hybrid platforms to approximately 300 dealers and financial institutions on electronic or hybrid markets with Dealerweb platform; and trading solutions for financial advisory companies and traders with Tradeweb Direct platform. The company serves a network of approximately 2,500 clients in the institutional, wholesale, and retail client sectors. Its customers include asset managers, hedge funds, insurance companies, central banks, banks and dealers, proprietary trading firms, retail brokerage and financial advisory firms, and regional dealers. The company was founded in 1996 and is headquartered in New York, New York. Tradeweb Markets Inc. is a subsidiary of BCP York Holdings."
TW,2019-12-31,NA,225326000,1214157000,126121000,405932000,736281000,0,189819000,NA,52302000,775566000,585747000,39285000,35507000,NA,173024000,83769000,1200000,income_statement,Capital Markets,Tradeweb Markets Inc.,"Tradeweb Markets Inc. builds and operates electronic marketplaces in the United States, Europe, Asia, and internationally. The company's marketplaces facilitate trading in a range of asset classes, including rates, credit, money markets, and equities. It offers pre-trade data and analytics, trade execution, and trade processing, as well as post-trade data, analytics, and reporting services. The company provides flexible order and trading systems to institutional investors in 40 markets across 25 currencies. It also offers a range of electronic, voice, and hybrid platforms to approximately 300 dealers and financial institutions on electronic or hybrid markets with Dealerweb platform; and trading solutions for financial advisory companies and traders with Tradeweb Direct platform. The company serves a network of approximately 2,500 clients in the institutional, wholesale, and retail client sectors. Its customers include asset managers, hedge funds, insurance companies, central banks, banks and dealers, proprietary trading firms, retail brokerage and financial advisory firms, and regional dealers. The company was founded in 1996 and is headquartered in New York, New York. Tradeweb Markets Inc. is a subsidiary of BCP York Holdings."
TW,2020-12-31,NA,274464000,NA,166296000,428015000,844843000,0,263039000,NA,56074000,892343000,629304000,47500000,11425000,NA,218390000,166296000,NA,income_statement,Capital Markets,Tradeweb Markets Inc.,"Tradeweb Markets Inc. builds and operates electronic marketplaces in the United States, Europe, Asia, and internationally. The company's marketplaces facilitate trading in a range of asset classes, including rates, credit, money markets, and equities. It offers pre-trade data and analytics, trade execution, and trade processing, as well as post-trade data, analytics, and reporting services. The company provides flexible order and trading systems to institutional investors in 40 markets across 25 currencies. It also offers a range of electronic, voice, and hybrid platforms to approximately 300 dealers and financial institutions on electronic or hybrid markets with Dealerweb platform; and trading solutions for financial advisory companies and traders with Tradeweb Direct platform. The company serves a network of approximately 2,500 clients in the institutional, wholesale, and retail client sectors. Its customers include asset managers, hedge funds, insurance companies, central banks, banks and dealers, proprietary trading firms, retail brokerage and financial advisory firms, and regional dealers. The company was founded in 1996 and is headquartered in New York, New York. Tradeweb Markets Inc. is a subsidiary of BCP York Holdings."
TWIN,2017-06-30,NA,-9529000,646000,-6294000,52773000,48232000,-4541000,-4541000,-303000,-3414000,168182000,172723000,119950000,-4988000,NA,-6115000,-6294000,-1577000,income_statement,Specialty Industrial Machinery,"Twin Disc, Incorporated","Twin Disc, Incorporated designs, manufactures, and sells marine and heavy duty off-highway power transmission equipment worldwide. It operates through two segments, Manufacturing and Distribution. The company's products include marine transmissions, azimuth drives, surface drives, propellers, and boat management systems, as well as power-shift transmissions, hydraulic torque converters, power take-offs, industrial clutches, and controls systems. It also provides non-twin disc manufactured products. The company sells its products through a direct sales force and distributor network to customers primarily in the pleasure craft, commercial, and military marine markets, as well as in the energy and natural resources, government, and industrial markets. Twin Disc, Incorporated was founded in 1918 and is headquartered in Racine, Wisconsin."
TWIN,2018-06-30,NA,14420000,619000,9528000,62310000,80641000,18331000,18331000,-282000,4773000,240733000,222402000,160092000,-3911000,NA,9647000,9306000,-1577000,income_statement,Specialty Industrial Machinery,"Twin Disc, Incorporated","Twin Disc, Incorporated designs, manufactures, and sells marine and heavy duty off-highway power transmission equipment worldwide. It operates through two segments, Manufacturing and Distribution. The company's products include marine transmissions, azimuth drives, surface drives, propellers, and boat management systems, as well as power-shift transmissions, hydraulic torque converters, power take-offs, industrial clutches, and controls systems. It also provides non-twin disc manufactured products. The company sells its products through a direct sales force and distributor network to customers primarily in the pleasure craft, commercial, and military marine markets, as well as in the energy and natural resources, government, and industrial markets. Twin Disc, Incorporated was founded in 1918 and is headquartered in Racine, Wisconsin."
TWIN,2019-06-30,NA,14507000,602000,10673000,73160000,89641000,16481000,16481000,-1927000,3711000,302663000,286182000,213022000,-1974000,NA,10796000,10525000,-1577000,income_statement,Specialty Industrial Machinery,"Twin Disc, Incorporated","Twin Disc, Incorporated designs, manufactures, and sells marine and heavy duty off-highway power transmission equipment worldwide. It operates through two segments, Manufacturing and Distribution. The company's products include marine transmissions, azimuth drives, surface drives, propellers, and boat management systems, as well as power-shift transmissions, hydraulic torque converters, power take-offs, industrial clutches, and controls systems. It also provides non-twin disc manufactured products. The company sells its products through a direct sales force and distributor network to customers primarily in the pleasure craft, commercial, and military marine markets, as well as in the energy and natural resources, government, and industrial markets. Twin Disc, Incorporated was founded in 1918 and is headquartered in Racine, Wisconsin."
TWIN,2020-06-30,NA,-43740000,569000,-39817000,64635000,61941000,-2694000,-2694000,-1860000,-4169000,246838000,249532000,184897000,-41046000,NA,-39571000,-39817000,NA,income_statement,Specialty Industrial Machinery,"Twin Disc, Incorporated","Twin Disc, Incorporated designs, manufactures, and sells marine and heavy duty off-highway power transmission equipment worldwide. It operates through two segments, Manufacturing and Distribution. The company's products include marine transmissions, azimuth drives, surface drives, propellers, and boat management systems, as well as power-shift transmissions, hydraulic torque converters, power take-offs, industrial clutches, and controls systems. It also provides non-twin disc manufactured products. The company sells its products through a direct sales force and distributor network to customers primarily in the pleasure craft, commercial, and military marine markets, as well as in the energy and natural resources, government, and industrial markets. Twin Disc, Incorporated was founded in 1918 and is headquartered in Racine, Wisconsin."
TWNK,2016-12-31,NA,44617000,334192000,52807000,109147000,314157000,183958000,183958000,-67033000,-7323000,727586000,543628000,413429000,-139341000,NA,51940000,-4404000,15945000,income_statement,Packaged Foods,"Hostess Brands, Inc.","Hostess Brands, Inc., a packaged food company, develops, manufactures, markets, sells, and distributes fresh sweet baked goods in the United States. It primarily offer a range of snack cakes, donuts, sweet rolls, breakfast pastries, snack pies, and related products. The company operates in two segments, Sweet Baked Goods and In-Store Bakery. The Sweet Baked Goods segment offers fresh and frozen sweet baked goods and bread products under the Hostess, Dolly Madison, Cloverhill, and Big Texas brands, as well as store branded products. The In-Store Bakery segment primarily provides Superior on Main branded eclairs, madeleines, brownies, and iced cookies in the bakery section of grocery and club stores. The company was formerly known as Gores Holdings, Inc. and changed its name to Hostess Brands, Inc. in November 2016. Hostess Brands, Inc. was founded in 1919 and is based in Lenexa, Kansas."
TWNK,2017-12-31,NA,190904000,342240000,223897000,118033000,326898000,183770000,183770000,-39174000,-67204000,776188000,592418000,449290000,7134000,NA,258108000,223897000,1240000,income_statement,Packaged Foods,"Hostess Brands, Inc.","Hostess Brands, Inc., a packaged food company, develops, manufactures, markets, sells, and distributes fresh sweet baked goods in the United States. It primarily offer a range of snack cakes, donuts, sweet rolls, breakfast pastries, snack pies, and related products. The company operates in two segments, Sweet Baked Goods and In-Store Bakery. The Sweet Baked Goods segment offers fresh and frozen sweet baked goods and bread products under the Hostess, Dolly Madison, Cloverhill, and Big Texas brands, as well as store branded products. The In-Store Bakery segment primarily provides Superior on Main branded eclairs, madeleines, brownies, and iced cookies in the bakery section of grocery and club stores. The company was formerly known as Gores Holdings, Inc. and changed its name to Hostess Brands, Inc. in November 2016. Hostess Brands, Inc. was founded in 1919 and is based in Lenexa, Kansas."
TWNK,2018-12-31,NA,94380000,350454000,62895000,117900000,277414000,132826000,132826000,-39404000,12954000,850389000,717563000,572975000,-38446000,NA,81426000,62895000,2631000,income_statement,Packaged Foods,"Hostess Brands, Inc.","Hostess Brands, Inc., a packaged food company, develops, manufactures, markets, sells, and distributes fresh sweet baked goods in the United States. It primarily offer a range of snack cakes, donuts, sweet rolls, breakfast pastries, snack pies, and related products. The company operates in two segments, Sweet Baked Goods and In-Store Bakery. The Sweet Baked Goods segment offers fresh and frozen sweet baked goods and bread products under the Hostess, Dolly Madison, Cloverhill, and Big Texas brands, as well as store branded products. The In-Store Bakery segment primarily provides Superior on Main branded eclairs, madeleines, brownies, and iced cookies in the bakery section of grocery and club stores. The company was formerly known as Gores Holdings, Inc. and changed its name to Hostess Brands, Inc. in November 2016. Hostess Brands, Inc. was founded in 1919 and is based in Lenexa, Kansas."
TWNK,2019-12-31,NA,94457000,94432000,63115000,139917000,301397000,133931000,133931000,-39370000,16892000,907675000,773744000,606278000,-39474000,NA,77565000,63115000,4172000,income_statement,Packaged Foods,"Hostess Brands, Inc.","Hostess Brands, Inc., a packaged food company, develops, manufactures, markets, sells, and distributes fresh sweet baked goods in the United States. It primarily offer a range of snack cakes, donuts, sweet rolls, breakfast pastries, snack pies, and related products. The company operates in two segments, Sweet Baked Goods and In-Store Bakery. The Sweet Baked Goods segment offers fresh and frozen sweet baked goods and bread products under the Hostess, Dolly Madison, Cloverhill, and Big Texas brands, as well as store branded products. The In-Store Bakery segment primarily provides Superior on Main branded eclairs, madeleines, brownies, and iced cookies in the bakery section of grocery and club stores. The company was formerly known as Gores Holdings, Inc. and changed its name to Hostess Brands, Inc. in November 2016. Hostess Brands, Inc. was founded in 1919 and is based in Lenexa, Kansas."
TWOU,2017-12-31,45926000,-30720000,NA,-29423000,213588000,229376000,-30138000,-30138000,-87000,-1297000,286752000,316890000,57376000,-582000,NA,-29423000,-29423000,NA,income_statement,Education & Training Services,"2U, Inc.","2U, Inc. operates as an education technology company in the United States, Hong Kong, South Africa, and the United Kingdom. It operates in two segments, Graduate Program Segment and Short Course Segment. The Graduate Program Segment targets students seeking a full graduate degree. The Short Course Segment targets working professionals seeking career advancement through skills attainment. The company builds, delivers, and supports online graduate programs and certificates for working adults through its 2U Operating System, a platform that provides front-end and back-end cloud-based SaaS technology and technology-enabled services to university clients. The company was formerly known as 2Tor Inc. and changed its name to 2U, Inc. in October 2012. 2U, Inc. was founded in 2008 and is headquartered in Lanham, Maryland."
TWOU,2018-12-31,63812000,-43197000,NA,-38330000,304004000,321276000,-46540000,-46540000,-108000,-4867000,411769000,458309000,90493000,3343000,NA,-38330000,-38330000,NA,income_statement,Education & Training Services,"2U, Inc.","2U, Inc. operates as an education technology company in the United States, Hong Kong, South Africa, and the United Kingdom. It operates in two segments, Graduate Program Segment and Short Course Segment. The Graduate Program Segment targets students seeking a full graduate degree. The Short Course Segment targets working professionals seeking career advancement through skills attainment. The company builds, delivers, and supports online graduate programs and certificates for working adults through its 2U Operating System, a platform that provides front-end and back-end cloud-based SaaS technology and technology-enabled services to university clients. The company was formerly known as 2Tor Inc. and changed its name to 2U, Inc. in October 2012. 2U, Inc. was founded in 2008 and is headquartered in Lanham, Maryland."
TWOU,2019-12-31,115473000,-255082000,NA,-235222000,454548000,412511000,-157510000,-157510000,-13419000,-19860000,574671000,732181000,162160000,-97572000,NA,-235222000,-235222000,NA,income_statement,Education & Training Services,"2U, Inc.","2U, Inc. operates as an education technology company in the United States, Hong Kong, South Africa, and the United Kingdom. It operates in two segments, Graduate Program Segment and Short Course Segment. The Graduate Program Segment targets students seeking a full graduate degree. The Short Course Segment targets working professionals seeking career advancement through skills attainment. The company builds, delivers, and supports online graduate programs and certificates for working adults through its 2U Operating System, a platform that provides front-end and back-end cloud-based SaaS technology and technology-enabled services to university clients. The company was formerly known as 2Tor Inc. and changed its name to 2U, Inc. in October 2012. 2U, Inc. was founded in 2008 and is headquartered in Lanham, Maryland."
TWOU,2020-12-31,155949000,-217998000,NA,-216484000,563700000,540714000,-178935000,-178935000,-27317000,-1514000,774533000,953468000,233819000,-39063000,NA,-216484000,-216484000,NA,income_statement,Education & Training Services,"2U, Inc.","2U, Inc. operates as an education technology company in the United States, Hong Kong, South Africa, and the United Kingdom. It operates in two segments, Graduate Program Segment and Short Course Segment. The Graduate Program Segment targets students seeking a full graduate degree. The Short Course Segment targets working professionals seeking career advancement through skills attainment. The company builds, delivers, and supports online graduate programs and certificates for working adults through its 2U Operating System, a platform that provides front-end and back-end cloud-based SaaS technology and technology-enabled services to university clients. The company was formerly known as 2Tor Inc. and changed its name to 2U, Inc. in October 2012. 2U, Inc. was founded in 2008 and is headquartered in Lanham, Maryland."
TWST,2017-09-30,19169000,-59030000,NA,-59310000,26060000,-13253000,-58482000,-58482000,-905000,280000,10767000,69249000,24020000,-548000,NA,-59310000,-59310000,NA,income_statement,Diagnostics & Research,Twist Bioscience Corporation,"Twist Bioscience Corporation, a synthetic biology company, manufactures and sells synthetic DNA-based products. The company's DNA synthesis platform enables the manufacturing of synthetic DNA by writing DNA on a silicon chip. It offers synthetic DNA-based products, including synthetic genes, tools for sample preparation, antibody libraries for drug discovery and development, and DNA as a digital data storage medium. The company has a collaboration agreements with ImmunoPrecise Antibodies Ltd.; and Victorian Clinical Genetic Services. Twist Bioscience Corporation was founded in 2013 and is headquartered in South San Francisco, California."
TWST,2018-09-30,20347000,-70994000,NA,-71236000,43450000,-6762000,-70559000,-70559000,-1313000,242000,25427000,95986000,32189000,-435000,NA,-71236000,-71236000,NA,income_statement,Diagnostics & Research,Twist Bioscience Corporation,"Twist Bioscience Corporation, a synthetic biology company, manufactures and sells synthetic DNA-based products. The company's DNA synthesis platform enables the manufacturing of synthetic DNA by writing DNA on a silicon chip. It offers synthetic DNA-based products, including synthetic genes, tools for sample preparation, antibody libraries for drug discovery and development, and DNA as a digital data storage medium. The company has a collaboration agreements with ImmunoPrecise Antibodies Ltd.; and Victorian Clinical Genetic Services. Twist Bioscience Corporation was founded in 2013 and is headquartered in South San Francisco, California."
TWST,2019-09-30,35683000,-107377000,NA,-107669000,80126000,6959000,-108850000,-108850000,-1294000,292000,54385000,163235000,47426000,1473000,NA,-107669000,-107669000,NA,income_statement,Diagnostics & Research,Twist Bioscience Corporation,"Twist Bioscience Corporation, a synthetic biology company, manufactures and sells synthetic DNA-based products. The company's DNA synthesis platform enables the manufacturing of synthetic DNA by writing DNA on a silicon chip. It offers synthetic DNA-based products, including synthetic genes, tools for sample preparation, antibody libraries for drug discovery and development, and DNA as a digital data storage medium. The company has a collaboration agreements with ImmunoPrecise Antibodies Ltd.; and Victorian Clinical Genetic Services. Twist Bioscience Corporation was founded in 2013 and is headquartered in South San Francisco, California."
TWST,2020-09-30,43006000,-139549000,NA,-139931000,103267000,28694000,-117579000,-117579000,-787000,382000,90100000,207679000,61406000,-21970000,NA,-139931000,-139931000,NA,income_statement,Diagnostics & Research,Twist Bioscience Corporation,"Twist Bioscience Corporation, a synthetic biology company, manufactures and sells synthetic DNA-based products. The company's DNA synthesis platform enables the manufacturing of synthetic DNA by writing DNA on a silicon chip. It offers synthetic DNA-based products, including synthetic genes, tools for sample preparation, antibody libraries for drug discovery and development, and DNA as a digital data storage medium. The company has a collaboration agreements with ImmunoPrecise Antibodies Ltd.; and Victorian Clinical Genetic Services. Twist Bioscience Corporation was founded in 2013 and is headquartered in South San Francisco, California."
TWTR,2017-12-31,542010000,-95418000,NA,-108063000,1001307000,1582057000,38740000,38740000,-105237000,12645000,2443299000,2404559000,861242000,-134158000,NA,-108063000,-108063000,NA,income_statement,NA,NA,NA
TWTR,2018-12-31,553858000,423544000,NA,1205596000,1070179000,2077362000,453325000,453325000,-132606000,-782052000,3042359000,2589034000,964997000,-29781000,NA,1205596000,1205596000,NA,income_statement,NA,NA,NA
TWTR,2019-12-31,682281000,390139000,NA,1465659000,1273634000,2322288000,366373000,366373000,-138180000,-1075520000,3459329000,3092956000,1137041000,23766000,NA,1465659000,1465659000,NA,income_statement,NA,NA,NA
TWTR,2020-12-31,873011000,-50939000,NA,-1135626000,1450292000,2349961000,26658000,26658000,-152878000,1084687000,3716349000,3689691000,1366388000,-77597000,NA,-1135626000,-1135626000,NA,income_statement,NA,NA,NA
TXG,2017-12-31,32164000,-18741000,NA,-18762000,46736000,60525000,-18375000,-18375000,-811000,21000,71085000,89460000,10560000,-366000,NA,-18762000,-18762000,NA,income_statement,Health Information Services,"10x Genomics, Inc.","10x Genomics, Inc., a life science technology company, develops and sells instruments, consumables, and software for analyzing biological systems in North America, Europe, the Middle East, Africa, China, and the Asia Pacific. Its company offers chromium instruments, enzymes, microfluidic chips, slides, reagents, and other consumable products. The company's single cell solution runs on its chromium instruments, which include single cell gene expression for measuring gene activity on a cell-by-cell basis; single cell immune profiling for measuring the activity of immune cells and their targets; single cell ATAC for measuring epigenetics, including the physical organization of DNA; single cell CNV for measuring cellular heterogeneity through DNA changes, such as copy number variation; and visium spatial gene expression solution that measures the spatial gene expression patterns across a tissue sample. It serves various academic, government, biopharmaceutical, biotechnology, and other institutions. The company was formerly known as 10X Technologies, Inc. and changed its name to 10X Genomics, Inc. in November 2014. 10x Genomics, Inc. was founded in 2012 and is headquartered in Pleasanton, California."
TXG,2018-12-31,47537000,-112398000,NA,-112485000,87936000,125052000,-10421000,-10421000,-2409000,87000,146313000,156734000,21261000,-101977000,NA,-112485000,-112485000,NA,income_statement,Health Information Services,"10x Genomics, Inc.","10x Genomics, Inc., a life science technology company, develops and sells instruments, consumables, and software for analyzing biological systems in North America, Europe, the Middle East, Africa, China, and the Asia Pacific. Its company offers chromium instruments, enzymes, microfluidic chips, slides, reagents, and other consumable products. The company's single cell solution runs on its chromium instruments, which include single cell gene expression for measuring gene activity on a cell-by-cell basis; single cell immune profiling for measuring the activity of immune cells and their targets; single cell ATAC for measuring epigenetics, including the physical organization of DNA; single cell CNV for measuring cellular heterogeneity through DNA changes, such as copy number variation; and visium spatial gene expression solution that measures the spatial gene expression patterns across a tissue sample. It serves various academic, government, biopharmaceutical, biotechnology, and other institutions. The company was formerly known as 10X Technologies, Inc. and changed its name to 10X Genomics, Inc. in November 2014. 10x Genomics, Inc. was founded in 2012 and is headquartered in Pleasanton, California."
TXG,2019-12-31,83097000,-31033000,NA,-31251000,130834000,214060000,129000,129000,-3079000,218000,245893000,245764000,31833000,-31162000,NA,-31251000,-31251000,NA,income_statement,Health Information Services,"10x Genomics, Inc.","10x Genomics, Inc., a life science technology company, develops and sells instruments, consumables, and software for analyzing biological systems in North America, Europe, the Middle East, Africa, China, and the Asia Pacific. Its company offers chromium instruments, enzymes, microfluidic chips, slides, reagents, and other consumable products. The company's single cell solution runs on its chromium instruments, which include single cell gene expression for measuring gene activity on a cell-by-cell basis; single cell immune profiling for measuring the activity of immune cells and their targets; single cell ATAC for measuring epigenetics, including the physical organization of DNA; single cell CNV for measuring cellular heterogeneity through DNA changes, such as copy number variation; and visium spatial gene expression solution that measures the spatial gene expression patterns across a tissue sample. It serves various academic, government, biopharmaceutical, biotechnology, and other institutions. The company was formerly known as 10X Technologies, Inc. and changed its name to 10X Genomics, Inc. in November 2014. 10x Genomics, Inc. was founded in 2012 and is headquartered in Pleasanton, California."
TXG,2020-12-31,123375000,-534476000,NA,-542731000,202326000,240377000,-85324000,-85324000,-1682000,8255000,298845000,384169000,58468000,-449152000,NA,-542731000,-542731000,NA,income_statement,Health Information Services,"10x Genomics, Inc.","10x Genomics, Inc., a life science technology company, develops and sells instruments, consumables, and software for analyzing biological systems in North America, Europe, the Middle East, Africa, China, and the Asia Pacific. Its company offers chromium instruments, enzymes, microfluidic chips, slides, reagents, and other consumable products. The company's single cell solution runs on its chromium instruments, which include single cell gene expression for measuring gene activity on a cell-by-cell basis; single cell immune profiling for measuring the activity of immune cells and their targets; single cell ATAC for measuring epigenetics, including the physical organization of DNA; single cell CNV for measuring cellular heterogeneity through DNA changes, such as copy number variation; and visium spatial gene expression solution that measures the spatial gene expression patterns across a tissue sample. It serves various academic, government, biopharmaceutical, biotechnology, and other institutions. The company was formerly known as 10X Technologies, Inc. and changed its name to 10X Genomics, Inc. in November 2014. 10x Genomics, Inc. was founded in 2012 and is headquartered in Pleasanton, California."
TXMD,2016-12-31,53943477,-89875459,NA,-89875459,51348414,15170742,-90253600,-90253600,-4677834,0,19356450,109610050,4185708,378141,NA,-89875459,-89875459,NA,income_statement,Drug Manufacturers—Specialty & Generic,"TherapeuticsMD, Inc.","TherapeuticsMD, Inc. operates as a women's healthcare company in the United States. The company offers IMVEXXY for the treatment of moderate-to-severe dyspareunia; BIJUVA, a bio-identical hormone therapy combination of 17Ã-estradiol and progesterone for the treatment of moderate-to-severe vasomotor symptoms; and ANNOVERA, a ring-shaped contraceptive vaginal system. Its preclinical projects include the development of TX-005HR, a progesterone-alone transdermal cream; TX-006HR, an estradiol and progesterone transdermal cream; and TX-00THR and TX-0008HR, which are transdermal patch product candidates. The company's clinical development product is TX-009HR, an oral progesterone and estradiol formulation. It also manufactures and distributes branded and generic prescription prenatal vitamins under the vitaTrue, vitaPearl, vitaMedMD, and BocaGreenMD Prena1 brands. The company sells its prescription prenatal vitamin and hormone therapy drug products to wholesale distributors and retail pharmacy distributors. TherapeuticsMD, Inc. is headquartered in Boca Raton, Florida."
TXMD,2017-12-31,33852993,-76925380,NA,-76925380,57703370,14140770,-77628710,-77628710,-4677834,0,16777713,94406423,2636943,703330,NA,-76925380,-76925380,NA,income_statement,Drug Manufacturers—Specialty & Generic,"TherapeuticsMD, Inc.","TherapeuticsMD, Inc. operates as a women's healthcare company in the United States. The company offers IMVEXXY for the treatment of moderate-to-severe dyspareunia; BIJUVA, a bio-identical hormone therapy combination of 17Ã-estradiol and progesterone for the treatment of moderate-to-severe vasomotor symptoms; and ANNOVERA, a ring-shaped contraceptive vaginal system. Its preclinical projects include the development of TX-005HR, a progesterone-alone transdermal cream; TX-006HR, an estradiol and progesterone transdermal cream; and TX-00THR and TX-0008HR, which are transdermal patch product candidates. The company's clinical development product is TX-009HR, an oral progesterone and estradiol formulation. It also manufactures and distributes branded and generic prescription prenatal vitamins under the vitaTrue, vitaPearl, vitaMedMD, and BocaGreenMD Prena1 brands. The company sells its prescription prenatal vitamin and hormone therapy drug products to wholesale distributors and retail pharmacy distributors. TherapeuticsMD, Inc. is headquartered in Boca Raton, Florida."
TXMD,2018-12-31,27299138,-132617160,NA,-132617160,115988954,13361808,-130220170,-130220170,-4677834,0,16099460,146319630,2737652,-2396990,NA,-132617160,-132617160,NA,income_statement,Drug Manufacturers—Specialty & Generic,"TherapeuticsMD, Inc.","TherapeuticsMD, Inc. operates as a women's healthcare company in the United States. The company offers IMVEXXY for the treatment of moderate-to-severe dyspareunia; BIJUVA, a bio-identical hormone therapy combination of 17Ã-estradiol and progesterone for the treatment of moderate-to-severe vasomotor symptoms; and ANNOVERA, a ring-shaped contraceptive vaginal system. Its preclinical projects include the development of TX-005HR, a progesterone-alone transdermal cream; TX-006HR, an estradiol and progesterone transdermal cream; and TX-00THR and TX-0008HR, which are transdermal patch product candidates. The company's clinical development product is TX-009HR, an oral progesterone and estradiol formulation. It also manufactures and distributes branded and generic prescription prenatal vitamins under the vitaTrue, vitaPearl, vitaMedMD, and BocaGreenMD Prena1 brands. The company sells its prescription prenatal vitamin and hormone therapy drug products to wholesale distributors and retail pharmacy distributors. TherapeuticsMD, Inc. is headquartered in Boca Raton, Florida."
TXMD,2019-12-31,19792212,-176144999,NA,-176144999,174112612,43312352,-151205258,-151205258,-17382215,0,49646937,200852195,6334585,-24939741,NA,-176144999,-176144999,NA,income_statement,Drug Manufacturers—Specialty & Generic,"TherapeuticsMD, Inc.","TherapeuticsMD, Inc. operates as a women's healthcare company in the United States. The company offers IMVEXXY for the treatment of moderate-to-severe dyspareunia; BIJUVA, a bio-identical hormone therapy combination of 17Ã-estradiol and progesterone for the treatment of moderate-to-severe vasomotor symptoms; and ANNOVERA, a ring-shaped contraceptive vaginal system. Its preclinical projects include the development of TX-005HR, a progesterone-alone transdermal cream; TX-006HR, an estradiol and progesterone transdermal cream; and TX-00THR and TX-0008HR, which are transdermal patch product candidates. The company's clinical development product is TX-009HR, an oral progesterone and estradiol formulation. It also manufactures and distributes branded and generic prescription prenatal vitamins under the vitaTrue, vitaPearl, vitaMedMD, and BocaGreenMD Prena1 brands. The company sells its prescription prenatal vitamin and hormone therapy drug products to wholesale distributors and retail pharmacy distributors. TherapeuticsMD, Inc. is headquartered in Boca Raton, Florida."
TXN,2017-12-31,1508000000,6080000000,NA,3682000000,1754000000,9614000000,6034000000,6034000000,-78000000,2398000000,14961000000,8927000000,5347000000,46000000,NA,3682000000,3648000000,NA,income_statement,NA,NA,NA
TXN,2018-12-31,1559000000,6686000000,NA,5580000000,1716000000,10277000000,6684000000,6684000000,-125000000,1106000000,15784000000,9100000000,5507000000,2000000,NA,5580000000,5537000000,NA,income_statement,NA,NA,NA
TXN,2019-12-31,1544000000,5728000000,NA,5017000000,1650000000,9164000000,5682000000,5682000000,-170000000,711000000,14383000000,8701000000,5219000000,46000000,NA,5017000000,4985000000,NA,income_statement,NA,NA,NA
TXN,2020-12-31,1530000000,6017000000,NA,5595000000,1616000000,9269000000,5925000000,5925000000,-190000000,422000000,14461000000,8536000000,5192000000,92000000,NA,5595000000,5568000000,NA,income_statement,NA,NA,NA
TXRH,2017-12-26,NA,186117000,12312000,131526000,122894000,437427000,201760000,201760000,-1577000,48581000,2219531000,2017771000,1782104000,-15643000,NA,137536000,131526000,NA,income_statement,Restaurants,"Texas Roadhouse, Inc.","Texas Roadhouse, Inc., together with its subsidiaries, operates casual dining restaurants in the United States and internationally. The company operates and franchises Texas Roadhouse and Bubba's 33 restaurants. As of December 31, 2019, it operated 514 domestic restaurants and 97 franchise restaurants. Texas Roadhouse, Inc. was founded in 1993 and is based in Louisville, Kentucky."
TXRH,2018-12-25,NA,188551000,15139000,158225000,151763000,461597000,189567000,189567000,-591000,24257000,2457449000,2267882000,1995852000,-1016000,NA,164294000,158225000,NA,income_statement,Restaurants,"Texas Roadhouse, Inc.","Texas Roadhouse, Inc., together with its subsidiaries, operates casual dining restaurants in the United States and internationally. The company operates and franchises Texas Roadhouse and Bubba's 33 restaurants. As of December 31, 2019, it operated 514 domestic restaurants and 97 franchise restaurants. Texas Roadhouse, Inc. was founded in 1993 and is based in Louisville, Kentucky."
TXRH,2019-12-31,NA,213915000,15175000,174452000,167689000,514513000,211124000,211124000,-4091000,32397000,2756163000,2545039000,2241650000,2791000,NA,181518000,174452000,NA,income_statement,Restaurants,"Texas Roadhouse, Inc.","Texas Roadhouse, Inc., together with its subsidiaries, operates casual dining restaurants in the United States and internationally. The company operates and franchises Texas Roadhouse and Bubba's 33 restaurants. As of December 31, 2019, it operated 514 domestic restaurants and 97 franchise restaurants. Texas Roadhouse, Inc. was founded in 1993 and is based in Louisville, Kentucky."
TXRH,2020-12-29,NA,19253000,15546000,31255000,119503000,283586000,26107000,26107000,-4091000,-15672000,2398123000,2372016000,2114537000,-6854000,NA,34925000,31255000,NA,income_statement,Restaurants,"Texas Roadhouse, Inc.","Texas Roadhouse, Inc., together with its subsidiaries, operates casual dining restaurants in the United States and internationally. The company operates and franchises Texas Roadhouse and Bubba's 33 restaurants. As of December 31, 2019, it operated 514 domestic restaurants and 97 franchise restaurants. Texas Roadhouse, Inc. was founded in 1993 and is based in Louisville, Kentucky."
TXT,2017-12-30,NA,762000000,NA,307000000,1305000000,2342000000,1037000000,1037000000,-145000000,456000000,14198000000,13161000000,11856000000,-275000000,1000000,306000000,307000000,NA,income_statement,NA,NA,NA
TXT,2018-12-29,NA,1384000000,NA,1222000000,1199000000,2347000000,1148000000,1148000000,-135000000,162000000,13972000000,12824000000,11625000000,236000000,NA,1222000000,1222000000,NA,income_statement,NA,NA,NA
TXT,2021-01-02,NA,282000000,NA,309000000,122000000,751000000,629000000,629000000,-145000000,-27000000,11651000000,11022000000,10900000000,-347000000,NA,309000000,309000000,NA,income_statement,NA,NA,NA
TYHT,2017-06-30,NA,9872282,1087376,8469654,3294257,10816302,7446071,7446071,-148793,1252637,33592337,26146266,22776035,2426211,NA,8619645,8469654,75974,income_statement,Drug Manufacturers—Specialty & Generic,"Shineco, Inc.","Shineco, Inc., through its subsidiaries, produces, distributes, and sells health and well-being focused plant-based products in China. It processes and distributes traditional Chinese herbal medicine products, as well as other pharmaceutical products directly to individual customers. The company also plants, processes, and distributes green and organic vegetables and fruits; and grows, cultivates, and sells yew trees that are used for the production of anti-cancer medication, as well as ornamental bonsai trees for purifying indoor air quality. In addition, it offers logistics services for agricultural products. Further, the company develops, manufactures, and distributes specialized fabrics, textiles, health supplements, and other byproducts derived from an indigenous Chinese plant Apocynum Venetum. The company sells its Chinese medicinal products and western medicines through wholesale customers; and its 13 Ankang retail pharmacies operating under the Sunsimiao Pharmacies name, as well as 66 pharmacies operated by third parties. Shineco, Inc. sells its decoction pieces on the Anhui Bozhou Chinese medicine transaction market to medical materials companies and Chinese patent medicine factories. The company sells its Luobuma textile products online through third party e-commerce websites, as well as through distributors under the Tenethealth brand; and yew trees and agricultural products primarily through its sales personnel, and group and institutional sales. The company was formerly known as Beijing Tenet Jove Technological Development Co., Ltd. and changed its name to Shineco, Inc. in June 2005. Shineco, Inc. was founded in 1997 and is based in Beijing, China."
TYHT,2018-06-30,NA,9652149,1053449,7587916,5515609,14891959,9271683,9271683,-133930,2123587,43897618,34625935,29005659,380466,NA,7528562,7587916,104667,income_statement,Drug Manufacturers—Specialty & Generic,"Shineco, Inc.","Shineco, Inc., through its subsidiaries, produces, distributes, and sells health and well-being focused plant-based products in China. It processes and distributes traditional Chinese herbal medicine products, as well as other pharmaceutical products directly to individual customers. The company also plants, processes, and distributes green and organic vegetables and fruits; and grows, cultivates, and sells yew trees that are used for the production of anti-cancer medication, as well as ornamental bonsai trees for purifying indoor air quality. In addition, it offers logistics services for agricultural products. Further, the company develops, manufactures, and distributes specialized fabrics, textiles, health supplements, and other byproducts derived from an indigenous Chinese plant Apocynum Venetum. The company sells its Chinese medicinal products and western medicines through wholesale customers; and its 13 Ankang retail pharmacies operating under the Sunsimiao Pharmacies name, as well as 66 pharmacies operated by third parties. Shineco, Inc. sells its decoction pieces on the Anhui Bozhou Chinese medicine transaction market to medical materials companies and Chinese patent medicine factories. The company sells its Luobuma textile products online through third party e-commerce websites, as well as through distributors under the Tenethealth brand; and yew trees and agricultural products primarily through its sales personnel, and group and institutional sales. The company was formerly known as Beijing Tenet Jove Technological Development Co., Ltd. and changed its name to Shineco, Inc. in June 2005. Shineco, Inc. was founded in 1997 and is based in Beijing, China."
TYHT,2019-06-30,NA,1669387,1100613,796189,8856181,9044134,115415,115415,-115384,787600,31220040,31104625,22175906,1553972,NA,881787,796189,72538,income_statement,Drug Manufacturers—Specialty & Generic,"Shineco, Inc.","Shineco, Inc., through its subsidiaries, produces, distributes, and sells health and well-being focused plant-based products in China. It processes and distributes traditional Chinese herbal medicine products, as well as other pharmaceutical products directly to individual customers. The company also plants, processes, and distributes green and organic vegetables and fruits; and grows, cultivates, and sells yew trees that are used for the production of anti-cancer medication, as well as ornamental bonsai trees for purifying indoor air quality. In addition, it offers logistics services for agricultural products. Further, the company develops, manufactures, and distributes specialized fabrics, textiles, health supplements, and other byproducts derived from an indigenous Chinese plant Apocynum Venetum. The company sells its Chinese medicinal products and western medicines through wholesale customers; and its 13 Ankang retail pharmacies operating under the Sunsimiao Pharmacies name, as well as 66 pharmacies operated by third parties. Shineco, Inc. sells its decoction pieces on the Anhui Bozhou Chinese medicine transaction market to medical materials companies and Chinese patent medicine factories. The company sells its Luobuma textile products online through third party e-commerce websites, as well as through distributors under the Tenethealth brand; and yew trees and agricultural products primarily through its sales personnel, and group and institutional sales. The company was formerly known as Beijing Tenet Jove Technological Development Co., Ltd. and changed its name to Shineco, Inc. in June 2005. Shineco, Inc. was founded in 1997 and is based in Beijing, China."
TYHT,2020-06-30,NA,-5420145,1186520,-6628672,9609424,6176952,-3489612,-3489612,-116438,1090396,23684626,27174238,17507674,-1930533,NA,-6510541,-6628672,57140,income_statement,Drug Manufacturers—Specialty & Generic,"Shineco, Inc.","Shineco, Inc., through its subsidiaries, produces, distributes, and sells health and well-being focused plant-based products in China. It processes and distributes traditional Chinese herbal medicine products, as well as other pharmaceutical products directly to individual customers. The company also plants, processes, and distributes green and organic vegetables and fruits; and grows, cultivates, and sells yew trees that are used for the production of anti-cancer medication, as well as ornamental bonsai trees for purifying indoor air quality. In addition, it offers logistics services for agricultural products. Further, the company develops, manufactures, and distributes specialized fabrics, textiles, health supplements, and other byproducts derived from an indigenous Chinese plant Apocynum Venetum. The company sells its Chinese medicinal products and western medicines through wholesale customers; and its 13 Ankang retail pharmacies operating under the Sunsimiao Pharmacies name, as well as 66 pharmacies operated by third parties. Shineco, Inc. sells its decoction pieces on the Anhui Bozhou Chinese medicine transaction market to medical materials companies and Chinese patent medicine factories. The company sells its Luobuma textile products online through third party e-commerce websites, as well as through distributors under the Tenethealth brand; and yew trees and agricultural products primarily through its sales personnel, and group and institutional sales. The company was formerly known as Beijing Tenet Jove Technological Development Co., Ltd. and changed its name to Shineco, Inc. in June 2005. Shineco, Inc. was founded in 1997 and is based in Beijing, China."
TYL,2017-12-31,47324000,163456000,NA,169571000,175914000,399377000,162758000,162758000,-804000,-6115000,840899000,678141000,441522000,698000,NA,169571000,169571000,NA,income_statement,NA,NA,NA
TYL,2018-12-31,63264000,155870000,NA,147462000,207605000,439578000,152492000,152492000,-770000,8408000,935282000,782790000,495704000,3378000,NA,147462000,147462000,NA,income_statement,NA,NA,NA
TYL,2019-12-31,81342000,159838000,NA,146527000,256646000,516900000,157467000,157467000,-1750000,13311000,1086427000,928960000,569527000,2371000,NA,146527000,146527000,NA,income_statement,NA,NA,NA
TYL,2020-12-31,88363000,175042000,NA,194820000,259561000,542512000,172926000,172926000,-610000,-19778000,1116663000,943737000,574151000,2116000,NA,194820000,194820000,NA,income_statement,NA,NA,NA
TYME,2017-03-31,6111587,-15206781,NA,-15206781,9095194,0,-15206781,-15206781,-7415,0,0,15206781,0,0,NA,-15206781,-15206781,NA,income_statement,Biotechnology,"Tyme Technologies, Inc.","Tyme Technologies, Inc., a clinical-stage biotechnology company, develops cancer metabolism-based therapies (CMBTs) in the United States. Its lead candidate is the SM-88, a CMBT that is in a Phase II/III clinical trial to treat across 15 types of cancer, including pancreatic, lung, breast, prostate, sarcoma, and lymphoma. The company also offers TYME-18, a CMBT compound that is in preclinical stage for the treatment of solid tumors. Tyme Technologies, Inc. has a research collaboration with NYU Langone Health to advance the development of treatments for patients with metastatic cancers, including pancreatic cancer, as well as with Mayo Clinic; and a strategic collaboration with Eagle Pharmaceuticals, Inc. to advance oral SM-88 for the treatment of patients with cancer. The company was formerly known as Global Group Enterprises Corp. Tyme Technologies, Inc. was founded in 2011 and is headquartered in New York, New York."
TYME,2018-03-31,8839661,-18969493,NA,-18969493,10520217,0,-19359878,-19359878,-7415,0,0,19359878,0,390385,NA,-18969493,-18969493,NA,income_statement,Biotechnology,"Tyme Technologies, Inc.","Tyme Technologies, Inc., a clinical-stage biotechnology company, develops cancer metabolism-based therapies (CMBTs) in the United States. Its lead candidate is the SM-88, a CMBT that is in a Phase II/III clinical trial to treat across 15 types of cancer, including pancreatic, lung, breast, prostate, sarcoma, and lymphoma. The company also offers TYME-18, a CMBT compound that is in preclinical stage for the treatment of solid tumors. Tyme Technologies, Inc. has a research collaboration with NYU Langone Health to advance the development of treatments for patients with metastatic cancers, including pancreatic cancer, as well as with Mayo Clinic; and a strategic collaboration with Eagle Pharmaceuticals, Inc. to advance oral SM-88 for the treatment of patients with cancer. The company was formerly known as Global Group Enterprises Corp. Tyme Technologies, Inc. was founded in 2011 and is headquartered in New York, New York."
TYME,2019-03-31,14719481,-32983115,NA,-32983115,14586165,0,-29305646,-29305646,-7415,0,0,29305646,0,-3677469,NA,-32983115,-32983115,NA,income_statement,Biotechnology,"Tyme Technologies, Inc.","Tyme Technologies, Inc., a clinical-stage biotechnology company, develops cancer metabolism-based therapies (CMBTs) in the United States. Its lead candidate is the SM-88, a CMBT that is in a Phase II/III clinical trial to treat across 15 types of cancer, including pancreatic, lung, breast, prostate, sarcoma, and lymphoma. The company also offers TYME-18, a CMBT compound that is in preclinical stage for the treatment of solid tumors. Tyme Technologies, Inc. has a research collaboration with NYU Langone Health to advance the development of treatments for patients with metastatic cancers, including pancreatic cancer, as well as with Mayo Clinic; and a strategic collaboration with Eagle Pharmaceuticals, Inc. to advance oral SM-88 for the treatment of patients with cancer. The company was formerly known as Global Group Enterprises Corp. Tyme Technologies, Inc. was founded in 2011 and is headquartered in New York, New York."
TYME,2020-03-31,12955879,-22000556,NA,-22000556,12804493,0,-25760372,-25760372,-114243,0,0,25760372,0,3759816,NA,-22000556,-22000556,NA,income_statement,Biotechnology,"Tyme Technologies, Inc.","Tyme Technologies, Inc., a clinical-stage biotechnology company, develops cancer metabolism-based therapies (CMBTs) in the United States. Its lead candidate is the SM-88, a CMBT that is in a Phase II/III clinical trial to treat across 15 types of cancer, including pancreatic, lung, breast, prostate, sarcoma, and lymphoma. The company also offers TYME-18, a CMBT compound that is in preclinical stage for the treatment of solid tumors. Tyme Technologies, Inc. has a research collaboration with NYU Langone Health to advance the development of treatments for patients with metastatic cancers, including pancreatic cancer, as well as with Mayo Clinic; and a strategic collaboration with Eagle Pharmaceuticals, Inc. to advance oral SM-88 for the treatment of patients with cancer. The company was formerly known as Global Group Enterprises Corp. Tyme Technologies, Inc. was founded in 2011 and is headquartered in New York, New York."
TZOO,2016-12-31,9096000,9999000,NA,6631000,81126000,100408000,10186000,10186000,NA,3992000,114263000,104077000,13855000,-187000,624000,6007000,6631000,NA,income_statement,Travel Services,Travelzoo,"Travelzoo provides travel, entertainment, and local deals from travel and entertainment companies, and local businesses in the Asia Pacific, Europe, and North America. Its publications and products include Travelzoo Website; Travelzoo iPhone and Android apps; Travelzoo Top 20 email newsletter; and Newsflash email alert service. The company also operates the Travelzoo Network, a network of third-party Websites that list travel deals published by the company; and Local Deals and Getaway listings, which allow its members to purchase vouchers for deals from local businesses, such as spas, hotels, and restaurants. It serves airlines, hotels, cruise lines, vacations packagers, tour operators, destinations, car rental companies, travel agents, theater and performing arts groups, restaurants, spas, and activity companies. Travelzoo Inc. was founded in 1998 and is headquartered in New York, New York."
TZOO,2017-12-31,9224000,4718000,NA,3530000,79846000,93615000,4545000,4545000,NA,3126000,106524000,101979000,12909000,173000,1938000,1592000,3530000,NA,income_statement,Travel Services,Travelzoo,"Travelzoo provides travel, entertainment, and local deals from travel and entertainment companies, and local businesses in the Asia Pacific, Europe, and North America. Its publications and products include Travelzoo Website; Travelzoo iPhone and Android apps; Travelzoo Top 20 email newsletter; and Newsflash email alert service. The company also operates the Travelzoo Network, a network of third-party Websites that list travel deals published by the company; and Local Deals and Getaway listings, which allow its members to purchase vouchers for deals from local businesses, such as spas, hotels, and restaurants. It serves airlines, hotels, cruise lines, vacations packagers, tour operators, destinations, car rental companies, travel agents, theater and performing arts groups, restaurants, spas, and activity companies. Travelzoo Inc. was founded in 1998 and is headquartered in New York, New York."
TZOO,2018-12-31,8993000,8286000,NA,4661000,81823000,99054000,8238000,8238000,NA,3625000,111322000,103084000,12268000,48000,NA,4661000,4661000,NA,income_statement,Travel Services,Travelzoo,"Travelzoo provides travel, entertainment, and local deals from travel and entertainment companies, and local businesses in the Asia Pacific, Europe, and North America. Its publications and products include Travelzoo Website; Travelzoo iPhone and Android apps; Travelzoo Top 20 email newsletter; and Newsflash email alert service. The company also operates the Travelzoo Network, a network of third-party Websites that list travel deals published by the company; and Local Deals and Getaway listings, which allow its members to purchase vouchers for deals from local businesses, such as spas, hotels, and restaurants. It serves airlines, hotels, cruise lines, vacations packagers, tour operators, destinations, car rental companies, travel agents, theater and performing arts groups, restaurants, spas, and activity companies. Travelzoo Inc. was founded in 1998 and is headquartered in New York, New York."
TZOO,2019-12-31,6885000,8949000,NA,4155000,83174000,99523000,9464000,9464000,NA,4794000,111412000,101948000,11889000,-515000,NA,4155000,4155000,NA,income_statement,Travel Services,Travelzoo,"Travelzoo provides travel, entertainment, and local deals from travel and entertainment companies, and local businesses in the Asia Pacific, Europe, and North America. Its publications and products include Travelzoo Website; Travelzoo iPhone and Android apps; Travelzoo Top 20 email newsletter; and Newsflash email alert service. The company also operates the Travelzoo Network, a network of third-party Websites that list travel deals published by the company; and Local Deals and Getaway listings, which allow its members to purchase vouchers for deals from local businesses, such as spas, hotels, and restaurants. It serves airlines, hotels, cruise lines, vacations packagers, tour operators, destinations, car rental companies, travel agents, theater and performing arts groups, restaurants, spas, and activity companies. Travelzoo Inc. was founded in 1998 and is headquartered in New York, New York."
UAA,2017-12-31,NA,-10309000,NA,-48260000,2091322000,2256491000,156969000,156969000,-34538000,37951000,4989244000,4832275000,2732753000,-167278000,NA,-48260000,-48260000,NA,income_statement,NA,NA,NA
UAA,2018-12-31,NA,-66854000,NA,-46302000,2176239000,2361271000,178932000,178932000,-33568000,-20552000,5193185000,5014253000,2831914000,-245786000,NA,-46302000,-46302000,NA,income_statement,NA,NA,NA
UAA,2019-12-31,NA,162163000,NA,92139000,2222163000,2470533000,242270000,242270000,-21240000,70024000,5267132000,5024862000,2796599000,-80107000,NA,92139000,92139000,NA,income_statement,NA,NA,NA
UAA,2020-12-31,NA,-499790000,NA,-549177000,2171934000,2172471000,537000,537000,-47259000,49387000,4474667000,4474130000,2302196000,-500327000,NA,-549177000,-549177000,NA,income_statement,NA,NA,NA
UAL,2017-12-31,NA,3023000000,NA,2143000000,1652000000,12771000000,3690000000,3690000000,-552000000,880000000,37784000000,34094000000,25013000000,-667000000,NA,2143000000,2143000000,5333000000,income_statement,NA,NA,NA
UAL,2018-12-31,NA,2648000000,NA,2122000000,1769000000,13194000000,3670000000,3670000000,-605000000,526000000,41303000000,37633000000,28109000000,-1022000000,NA,2122000000,2122000000,5590000000,income_statement,NA,NA,NA
UAL,2019-12-31,NA,3914000000,NA,3009000000,1863000000,14782000000,4568000000,4568000000,-646000000,905000000,43259000000,38691000000,28477000000,-654000000,NA,3009000000,3009000000,6063000000,income_statement,NA,NA,NA
UAL,2020-12-31,NA,-8822000000,NA,-7069000000,459000000,-2542000000,-8975000000,-8975000000,-992000000,-1753000000,15355000000,24330000000,17897000000,153000000,NA,-7069000000,-7069000000,3486000000,income_statement,NA,NA,NA
UBCP,2017-12-31,NA,5590000,NA,3546000,10990000,19239000,0,5795000,NA,2044000,19239000,13444000,0,-205000,NA,3546000,3431000,2454000,income_statement,Banks—Regional,"United Bancorp, Inc.","United Bancorp, Inc. operates as the bank holding company for Unified Bank that provides commercial and retail banking services in Ohio. It accepts demand, savings, and time deposits, as well as grants commercial, real estate, and consumer loans. The company also offers brokerage services. As of April 23, 2020, it operated through a network of nineteen banking offices in the Ohio counties of Athens, Belmont, Carroll, Fairfield, Harrison, Jefferson, and Tuscarawas; and a loan production office in Wheeling, West Virginia. The company was founded in 1902 and is headquartered in Martins Ferry, Ohio."
UBCP,2018-12-31,NA,5082000,NA,4282000,12062000,21405000,0,6576000,NA,800000,21405000,14829000,0,-1494000,NA,4282000,4068000,2767000,income_statement,Banks—Regional,"United Bancorp, Inc.","United Bancorp, Inc. operates as the bank holding company for Unified Bank that provides commercial and retail banking services in Ohio. It accepts demand, savings, and time deposits, as well as grants commercial, real estate, and consumer loans. The company also offers brokerage services. As of April 23, 2020, it operated through a network of nineteen banking offices in the Ohio counties of Athens, Belmont, Carroll, Fairfield, Harrison, Jefferson, and Tuscarawas; and a loan production office in Wheeling, West Virginia. The company was founded in 1902 and is headquartered in Martins Ferry, Ohio."
UBCP,2019-12-31,NA,7409000,NA,6810000,13318000,23891000,0,7489000,NA,599000,23891000,16402000,0,-80000,NA,6810000,6554000,3084000,income_statement,Banks—Regional,"United Bancorp, Inc.","United Bancorp, Inc. operates as the bank holding company for Unified Bank that provides commercial and retail banking services in Ohio. It accepts demand, savings, and time deposits, as well as grants commercial, real estate, and consumer loans. The company also offers brokerage services. As of April 23, 2020, it operated through a network of nineteen banking offices in the Ohio counties of Athens, Belmont, Carroll, Fairfield, Harrison, Jefferson, and Tuscarawas; and a loan production office in Wheeling, West Virginia. The company was founded in 1902 and is headquartered in Martins Ferry, Ohio."
UBCP,2020-12-31,NA,8582333,NA,7953483,NA,26472767,0,8582333,NA,628850,26472767,17890434,0,0,NA,7953483,7953483,17890434,income_statement,Banks—Regional,"United Bancorp, Inc.","United Bancorp, Inc. operates as the bank holding company for Unified Bank that provides commercial and retail banking services in Ohio. It accepts demand, savings, and time deposits, as well as grants commercial, real estate, and consumer loans. The company also offers brokerage services. As of April 23, 2020, it operated through a network of nineteen banking offices in the Ohio counties of Athens, Belmont, Carroll, Fairfield, Harrison, Jefferson, and Tuscarawas; and a loan production office in Wheeling, West Virginia. The company was founded in 1902 and is headquartered in Martins Ferry, Ohio."
UBFO,2017-12-31,NA,15679000,NA,8640000,16916000,35482000,0,16029000,NA,7039000,35482000,19453000,0,-350000,NA,8640000,8640000,2537000,income_statement,Banks—Regional,United Security Bancshares,"United Security Bancshares operates as the bank holding company for United Security Bank, a state-chartered bank that provides a range of commercial banking services to the business and professional community, and individuals in California. The company accepts various deposit products, including personal and business checking accounts, savings accounts, interest-bearing negotiable order of withdrawal accounts, money market accounts, and time certificates of deposit. It also offers real estate mortgage, commercial and industrial, real estate construction, and consumer loans, as well as agricultural, installment, and student loans. In addition, the company provides online and mobile banking, safe deposit boxes, payroll direct deposit, cashier's check, cash management, traveler's check, money order, foreign draft, and interactive teller and ATM services. As of October 15, 2020, it operated through 12 full-service branch offices in Fresno, Bakersfield, Campbell, Caruthers, Coalinga, Firebaugh, Mendota, Oakhurst, San Joaquin, and Taft. The company was founded in 1987 and is headquartered in Fresno, California."
UBFO,2018-12-31,NA,19349000,NA,14017000,18202000,40110000,0,19678000,NA,5332000,40110000,20432000,0,-329000,NA,14017000,14017000,2230000,income_statement,Banks—Regional,United Security Bancshares,"United Security Bancshares operates as the bank holding company for United Security Bank, a state-chartered bank that provides a range of commercial banking services to the business and professional community, and individuals in California. The company accepts various deposit products, including personal and business checking accounts, savings accounts, interest-bearing negotiable order of withdrawal accounts, money market accounts, and time certificates of deposit. It also offers real estate mortgage, commercial and industrial, real estate construction, and consumer loans, as well as agricultural, installment, and student loans. In addition, the company provides online and mobile banking, safe deposit boxes, payroll direct deposit, cashier's check, cash management, traveler's check, money order, foreign draft, and interactive teller and ATM services. As of October 15, 2020, it operated through 12 full-service branch offices in Fresno, Bakersfield, Campbell, Caruthers, Coalinga, Firebaugh, Mendota, Oakhurst, San Joaquin, and Taft. The company was founded in 1987 and is headquartered in Fresno, California."
UBFO,2019-12-31,NA,21269000,NA,15172000,18577000,42548000,0,21677000,NA,6097000,42548000,20871000,0,-408000,NA,15172000,15172000,2294000,income_statement,Banks—Regional,United Security Bancshares,"United Security Bancshares operates as the bank holding company for United Security Bank, a state-chartered bank that provides a range of commercial banking services to the business and professional community, and individuals in California. The company accepts various deposit products, including personal and business checking accounts, savings accounts, interest-bearing negotiable order of withdrawal accounts, money market accounts, and time certificates of deposit. It also offers real estate mortgage, commercial and industrial, real estate construction, and consumer loans, as well as agricultural, installment, and student loans. In addition, the company provides online and mobile banking, safe deposit boxes, payroll direct deposit, cashier's check, cash management, traveler's check, money order, foreign draft, and interactive teller and ATM services. As of October 15, 2020, it operated through 12 full-service branch offices in Fresno, Bakersfield, Campbell, Caruthers, Coalinga, Firebaugh, Mendota, Oakhurst, San Joaquin, and Taft. The company was founded in 1987 and is headquartered in Fresno, California."
UBFO,2020-12-31,NA,12412000,NA,8961000,17841000,33717000,0,13533000,NA,3451000,33717000,20184000,0,-1121000,NA,8961000,8961000,2343000,income_statement,Banks—Regional,United Security Bancshares,"United Security Bancshares operates as the bank holding company for United Security Bank, a state-chartered bank that provides a range of commercial banking services to the business and professional community, and individuals in California. The company accepts various deposit products, including personal and business checking accounts, savings accounts, interest-bearing negotiable order of withdrawal accounts, money market accounts, and time certificates of deposit. It also offers real estate mortgage, commercial and industrial, real estate construction, and consumer loans, as well as agricultural, installment, and student loans. In addition, the company provides online and mobile banking, safe deposit boxes, payroll direct deposit, cashier's check, cash management, traveler's check, money order, foreign draft, and interactive teller and ATM services. As of October 15, 2020, it operated through 12 full-service branch offices in Fresno, Bakersfield, Campbell, Caruthers, Coalinga, Firebaugh, Mendota, Oakhurst, San Joaquin, and Taft. The company was founded in 1987 and is headquartered in Fresno, California."
UBOH,2017-12-31,NA,6725000,NA,3846000,16017000,29103000,0,7996000,NA,2879000,29103000,21107000,0,-1271000,NA,3846000,3846000,5090000,income_statement,Banks—Regional,"United Bancshares, Inc.","United Bancshares, Inc. operates as the bank holding company for The Union Bank Company that provides various commercial and consumer banking services. The company accepts various deposits products, such as checking, savings, demand deposit, money market deposit, term certificate, and individual retirement accounts, as well as certificates of deposit. Its loan products include commercial and residential real estate, agricultural, commercial and industrial, home equity, and various types of consumer and small business administration loans. The company also offers wealth management, treasury management, online and mobile banking, automatic teller machine, bill pay, safe deposit box rental, payment, and other personalized services. The company operates seventeen banking centers and two loan production offices in northwest and central Ohio. United Bancshares, Inc. was founded in 1904 and is headquartered in Columbus Grove, Ohio."
UBOH,2018-12-31,NA,9749000,NA,8220000,20844000,37185000,0,9749000,NA,1529000,37185000,27436000,0,0,NA,8220000,8220000,6592000,income_statement,Banks—Regional,"United Bancshares, Inc.","United Bancshares, Inc. operates as the bank holding company for The Union Bank Company that provides various commercial and consumer banking services. The company accepts various deposits products, such as checking, savings, demand deposit, money market deposit, term certificate, and individual retirement accounts, as well as certificates of deposit. Its loan products include commercial and residential real estate, agricultural, commercial and industrial, home equity, and various types of consumer and small business administration loans. The company also offers wealth management, treasury management, online and mobile banking, automatic teller machine, bill pay, safe deposit box rental, payment, and other personalized services. The company operates seventeen banking centers and two loan production offices in northwest and central Ohio. United Bancshares, Inc. was founded in 1904 and is headquartered in Columbus Grove, Ohio."
UBOH,2019-12-31,NA,12276000,NA,10661000,23641000,41413000,0,10296000,NA,1615000,41413000,31117000,0,1980000,NA,10661000,10661000,7476000,income_statement,Banks—Regional,"United Bancshares, Inc.","United Bancshares, Inc. operates as the bank holding company for The Union Bank Company that provides various commercial and consumer banking services. The company accepts various deposits products, such as checking, savings, demand deposit, money market deposit, term certificate, and individual retirement accounts, as well as certificates of deposit. Its loan products include commercial and residential real estate, agricultural, commercial and industrial, home equity, and various types of consumer and small business administration loans. The company also offers wealth management, treasury management, online and mobile banking, automatic teller machine, bill pay, safe deposit box rental, payment, and other personalized services. The company operates seventeen banking centers and two loan production offices in northwest and central Ohio. United Bancshares, Inc. was founded in 1904 and is headquartered in Columbus Grove, Ohio."
UBOH,2020-12-31,NA,16677000,NA,13755000,NA,53842000,0,16677000,NA,2922000,53842000,37165000,0,0,NA,13755000,13755000,37165000,income_statement,Banks—Regional,"United Bancshares, Inc.","United Bancshares, Inc. operates as the bank holding company for The Union Bank Company that provides various commercial and consumer banking services. The company accepts various deposits products, such as checking, savings, demand deposit, money market deposit, term certificate, and individual retirement accounts, as well as certificates of deposit. Its loan products include commercial and residential real estate, agricultural, commercial and industrial, home equity, and various types of consumer and small business administration loans. The company also offers wealth management, treasury management, online and mobile banking, automatic teller machine, bill pay, safe deposit box rental, payment, and other personalized services. The company operates seventeen banking centers and two loan production offices in northwest and central Ohio. United Bancshares, Inc. was founded in 1904 and is headquartered in Columbus Grove, Ohio."
UBSI,2017-12-31,NA,284827000,NA,150581000,276523000,652236000,0,297881000,NA,134246000,652236000,354355000,0,-13054000,NA,150581000,150343000,77832000,income_statement,Banks—Regional,"United Bankshares, Inc.","United Bankshares, Inc., a financial holding company, primarily provides commercial and retail banking products and services in the United States. It operates through two segments, Community Banking and Mortgage Banking. The company accepts checking, savings, and time and money market accounts; individual retirement accounts; and demand deposits, statement and special savings, and interest-bearing checking accounts. It also offers personal, commercial, floor plan, and student loans; construction and real estate loans; and consumer loans, including credit card and home equity loans. In addition, the company provides safe deposit boxes, wire transfers, and other banking products and services; investment, security, and trust services; services to correspondent banks, including check clearing, safekeeping, and buying and selling federal funds; automated teller machine services; and Internet and telephone banking services. Further, it offers community banking services, such as asset management, real property title insurance, financial planning, mortgage banking, and brokerage services. The company operates 138 full-service offices, which consists of 51 offices in West Virginia; 82 offices in the Shenandoah Valley region of Virginia and the Northern Virginia, Maryland, and Washington, D.C. metropolitan areas; 4 offices in southwestern Pennsylvania; and 1 office in southeastern Ohio. United Bankshares, Inc. was incorporated in 1982 and is headquartered in Charleston, West Virginia."
UBSI,2018-12-31,NA,327165000,NA,256342000,279391000,692581000,0,339310000,NA,70823000,692581000,353271000,0,-12145000,NA,256342000,255878000,73880000,income_statement,Banks—Regional,"United Bankshares, Inc.","United Bankshares, Inc., a financial holding company, primarily provides commercial and retail banking products and services in the United States. It operates through two segments, Community Banking and Mortgage Banking. The company accepts checking, savings, and time and money market accounts; individual retirement accounts; and demand deposits, statement and special savings, and interest-bearing checking accounts. It also offers personal, commercial, floor plan, and student loans; construction and real estate loans; and consumer loans, including credit card and home equity loans. In addition, the company provides safe deposit boxes, wire transfers, and other banking products and services; investment, security, and trust services; services to correspondent banks, including check clearing, safekeeping, and buying and selling federal funds; automated teller machine services; and Internet and telephone banking services. Further, it offers community banking services, such as asset management, real property title insurance, financial planning, mortgage banking, and brokerage services. The company operates 138 full-service offices, which consists of 51 offices in West Virginia; 82 offices in the Shenandoah Valley region of Virginia and the Northern Virginia, Maryland, and Washington, D.C. metropolitan areas; 4 offices in southwestern Pennsylvania; and 1 office in southeastern Ohio. United Bankshares, Inc. was incorporated in 1982 and is headquartered in Charleston, West Virginia."
UBSI,2019-12-31,NA,324439000,NA,260099000,286081000,704813000,0,341259000,NA,64340000,704813000,363554000,0,-16820000,NA,260099000,259504000,77473000,income_statement,Banks—Regional,"United Bankshares, Inc.","United Bankshares, Inc., a financial holding company, primarily provides commercial and retail banking products and services in the United States. It operates through two segments, Community Banking and Mortgage Banking. The company accepts checking, savings, and time and money market accounts; individual retirement accounts; and demand deposits, statement and special savings, and interest-bearing checking accounts. It also offers personal, commercial, floor plan, and student loans; construction and real estate loans; and consumer loans, including credit card and home equity loans. In addition, the company provides safe deposit boxes, wire transfers, and other banking products and services; investment, security, and trust services; services to correspondent banks, including check clearing, safekeeping, and buying and selling federal funds; automated teller machine services; and Internet and telephone banking services. Further, it offers community banking services, such as asset management, real property title insurance, financial planning, mortgage banking, and brokerage services. The company operates 138 full-service offices, which consists of 51 offices in West Virginia; 82 offices in the Shenandoah Valley region of Virginia and the Northern Virginia, Maryland, and Washington, D.C. metropolitan areas; 4 offices in southwestern Pennsylvania; and 1 office in southeastern Ohio. United Bankshares, Inc. was incorporated in 1982 and is headquartered in Charleston, West Virginia."
UBSI,2020-12-31,NA,359740000,NA,289023000,408915000,966957000,0,446810000,NA,70717000,966957000,520147000,0,-87070000,NA,289023000,289023000,111232000,income_statement,Banks—Regional,"United Bankshares, Inc.","United Bankshares, Inc., a financial holding company, primarily provides commercial and retail banking products and services in the United States. It operates through two segments, Community Banking and Mortgage Banking. The company accepts checking, savings, and time and money market accounts; individual retirement accounts; and demand deposits, statement and special savings, and interest-bearing checking accounts. It also offers personal, commercial, floor plan, and student loans; construction and real estate loans; and consumer loans, including credit card and home equity loans. In addition, the company provides safe deposit boxes, wire transfers, and other banking products and services; investment, security, and trust services; services to correspondent banks, including check clearing, safekeeping, and buying and selling federal funds; automated teller machine services; and Internet and telephone banking services. Further, it offers community banking services, such as asset management, real property title insurance, financial planning, mortgage banking, and brokerage services. The company operates 138 full-service offices, which consists of 51 offices in West Virginia; 82 offices in the Shenandoah Valley region of Virginia and the Northern Virginia, Maryland, and Washington, D.C. metropolitan areas; 4 offices in southwestern Pennsylvania; and 1 office in southeastern Ohio. United Bankshares, Inc. was incorporated in 1982 and is headquartered in Charleston, West Virginia."
UBX,2016-12-31,NA,-30404000,NA,-30404000,5137000,-13707000,-18844000,-18844000,-2183000,0,0,18844000,13707000,-11560000,NA,-30404000,-30404000,NA,income_statement,Biotechnology,"Unity Biotechnology, Inc.","Unity Biotechnology, Inc., a biotechnology company, engages in the research and development of therapeutics to extend human health span. The company's lead drug candidates include UBX0101 that is in Phase II clinical trial for musculoskeletal/ osteoarthritis disease, as well as Phase Ib clinical trial for moderate-to-severe osteoarthritis of the knee; UBX1325, which is Phase I clinical trial for the treatment of diabetic macular edema; and UBX1967 for the treatment of ophthalmologic diseases. It is also developing programs in pulmonary disorders and neurological disorders, as well as kidney and liver diseases. The company was formerly known as Forge, Inc. and changed its name to Unity Biotechnology, Inc. in January 2015. Unity Biotechnology, Inc. was founded in 2009 and is headquartered in South San Francisco, California."
UBX,2017-12-31,NA,-44656000,NA,-44656000,9617000,-35991000,-45608000,-45608000,NA,0,1382000,46990000,37373000,952000,NA,-44656000,-44656000,NA,income_statement,Biotechnology,"Unity Biotechnology, Inc.","Unity Biotechnology, Inc., a biotechnology company, engages in the research and development of therapeutics to extend human health span. The company's lead drug candidates include UBX0101 that is in Phase II clinical trial for musculoskeletal/ osteoarthritis disease, as well as Phase Ib clinical trial for moderate-to-severe osteoarthritis of the knee; UBX1325, which is Phase I clinical trial for the treatment of diabetic macular edema; and UBX1967 for the treatment of ophthalmologic diseases. It is also developing programs in pulmonary disorders and neurological disorders, as well as kidney and liver diseases. The company was formerly known as Forge, Inc. and changed its name to Unity Biotechnology, Inc. in January 2015. Unity Biotechnology, Inc. was founded in 2009 and is headquartered in South San Francisco, California."
UBX,2018-12-31,NA,-76398000,NA,-76398000,16016000,-58907000,-74923000,-74923000,NA,0,0,74923000,58907000,-1475000,NA,-76398000,-76398000,NA,income_statement,Biotechnology,"Unity Biotechnology, Inc.","Unity Biotechnology, Inc., a biotechnology company, engages in the research and development of therapeutics to extend human health span. The company's lead drug candidates include UBX0101 that is in Phase II clinical trial for musculoskeletal/ osteoarthritis disease, as well as Phase Ib clinical trial for moderate-to-severe osteoarthritis of the knee; UBX1325, which is Phase I clinical trial for the treatment of diabetic macular edema; and UBX1967 for the treatment of ophthalmologic diseases. It is also developing programs in pulmonary disorders and neurological disorders, as well as kidney and liver diseases. The company was formerly known as Forge, Inc. and changed its name to Unity Biotechnology, Inc. in January 2015. Unity Biotechnology, Inc. was founded in 2009 and is headquartered in South San Francisco, California."
UBX,2019-12-31,NA,-82177000,NA,-82177000,20046000,-70957000,-91003000,-91003000,NA,0,0,91003000,70957000,8826000,NA,-82177000,-82177000,NA,income_statement,Biotechnology,"Unity Biotechnology, Inc.","Unity Biotechnology, Inc., a biotechnology company, engages in the research and development of therapeutics to extend human health span. The company's lead drug candidates include UBX0101 that is in Phase II clinical trial for musculoskeletal/ osteoarthritis disease, as well as Phase Ib clinical trial for moderate-to-severe osteoarthritis of the knee; UBX1325, which is Phase I clinical trial for the treatment of diabetic macular edema; and UBX1967 for the treatment of ophthalmologic diseases. It is also developing programs in pulmonary disorders and neurological disorders, as well as kidney and liver diseases. The company was formerly known as Forge, Inc. and changed its name to Unity Biotechnology, Inc. in January 2015. Unity Biotechnology, Inc. was founded in 2009 and is headquartered in South San Francisco, California."
UCBIO,2017-12-31,NA,172834000,NA,67821000,221857000,440445000,0,197418000,NA,105013000,440445000,243027000,0,-24584000,NA,67821000,67250000,20187000,income_statement,Banks—Regional,"United Community Banks, Inc. -","United Community Banks, Inc. operates as the bank holding company for United Community Bank that provides various banking products and services. The company accepts checking, savings, money market, negotiable order of withdrawal, time, and other deposit accounts, as well as certificates of deposit. Its loan products include commercial real estate, commercial and industrial, commercial construction, residential mortgage and construction, consumer direct loans, and indirect auto loans, as well as home equity lines of credits. The company also offers investment products; insurance products, including life insurance, long-term care insurance, and tax-deferred annuities; reinsurance on a property insurance contract; and payment processing, merchant, wire transfer, brokerage and advisory, and other financial services. It serves individuals, small businesses, mid-sized commercial businesses, and non-profit organizations. The company operates through 163 locations in Georgia, North Carolina, South Carolina, and Tennessee. United Community Banks, Inc. was founded in 1950 and is based in Blairsville, Georgia."
UCBIO,2018-12-31,NA,215926000,NA,166111000,259643000,522211000,0,236677000,NA,49815000,522211000,285534000,0,-20751000,NA,166111000,164927000,25553000,income_statement,Banks—Regional,"United Community Banks, Inc. -","United Community Banks, Inc. operates as the bank holding company for United Community Bank that provides various banking products and services. The company accepts checking, savings, money market, negotiable order of withdrawal, time, and other deposit accounts, as well as certificates of deposit. Its loan products include commercial real estate, commercial and industrial, commercial construction, residential mortgage and construction, consumer direct loans, and indirect auto loans, as well as home equity lines of credits. The company also offers investment products; insurance products, including life insurance, long-term care insurance, and tax-deferred annuities; reinsurance on a property insurance contract; and payment processing, merchant, wire transfer, brokerage and advisory, and other financial services. It serves individuals, small businesses, mid-sized commercial businesses, and non-profit organizations. The company operates through 163 locations in Georgia, North Carolina, South Carolina, and Tennessee. United Community Banks, Inc. was founded in 1950 and is based in Blairsville, Georgia."
UCBIO,2019-12-31,NA,238712000,NA,185721000,280991000,559307000,0,250581000,NA,52991000,559307000,308726000,0,-11869000,NA,185721000,184346000,25976000,income_statement,Banks—Regional,"United Community Banks, Inc. -","United Community Banks, Inc. operates as the bank holding company for United Community Bank that provides various banking products and services. The company accepts checking, savings, money market, negotiable order of withdrawal, time, and other deposit accounts, as well as certificates of deposit. Its loan products include commercial real estate, commercial and industrial, commercial construction, residential mortgage and construction, consumer direct loans, and indirect auto loans, as well as home equity lines of credits. The company also offers investment products; insurance products, including life insurance, long-term care insurance, and tax-deferred annuities; reinsurance on a property insurance contract; and payment processing, merchant, wire transfer, brokerage and advisory, and other financial services. It serves individuals, small businesses, mid-sized commercial businesses, and non-profit organizations. The company operates through 163 locations in Georgia, North Carolina, South Carolina, and Tennessee. United Community Banks, Inc. was founded in 1950 and is based in Blairsville, Georgia."
UCBIO,2020-12-31,NA,209445000,NA,164089000,324527000,577434000,0,226613000,NA,45356000,577434000,350821000,0,-17168000,NA,164089000,159269000,26294000,income_statement,Banks—Regional,"United Community Banks, Inc. -","United Community Banks, Inc. operates as the bank holding company for United Community Bank that provides various banking products and services. The company accepts checking, savings, money market, negotiable order of withdrawal, time, and other deposit accounts, as well as certificates of deposit. Its loan products include commercial real estate, commercial and industrial, commercial construction, residential mortgage and construction, consumer direct loans, and indirect auto loans, as well as home equity lines of credits. The company also offers investment products; insurance products, including life insurance, long-term care insurance, and tax-deferred annuities; reinsurance on a property insurance contract; and payment processing, merchant, wire transfer, brokerage and advisory, and other financial services. It serves individuals, small businesses, mid-sized commercial businesses, and non-profit organizations. The company operates through 163 locations in Georgia, North Carolina, South Carolina, and Tennessee. United Community Banks, Inc. was founded in 1950 and is based in Blairsville, Georgia."
UCL,2017-12-31,13255000,-19260000,NA,-19260000,33859000,29532000,-17362000,-17362000,-3299000,0,85845000,103207000,56313000,-1898000,NA,-19260000,-20950000,-220000,income_statement,Telecom Services,uCloudlink Group Inc.,"uCloudlink Group Inc. operates as a mobile data traffic sharing marketplace in the telecommunications industry. The company provides uCloudlink 1.0, a model that focuses on cross-border travelers that need mobile data connectivity services in various countries; and operates portable Wi-Fi services under the Roamingman brand in China, Malaysia, and Singapore, which provides global mobile data connectivity services, as well as offers GlocalMe portable Wi-Fi terminals and cloud SIM architecture for mobile virtual network operators, mobile network operators (MNOs), and portable Wi-Fi terminal rental companies. It also offers uCloudlink 2.0, a model that provides mobile data connectivity services to local users through various MNOs; GlocalMe Inside, an implementation solutions for smartphones and other smart hardware terminals, which enables them to access its cloud SIM architecture and SIM card pool; and GlocalMe, a world phone series. In addition, the company provides IoT modules with GlocalMe Inside implementation to meet the demand for mobile data from various terminals, and provide integrated network solutions to its customers; SIM cards with prepaid data packages; and value added services, such as advertisement. Further, it's platform-as-a-service/ software-as-a-service offers modules, such as customer relationship management, company, and SIM card enterprise resource planning and management. The company was founded in 2014 and is headquartered in Kowloon, Hong Kong."
UCL,2018-12-31,20401000,-26557000,NA,-26557000,49577000,46155000,-23164000,-23164000,-3385000,0,126399000,149563000,80244000,-3393000,NA,-26557000,-28766000,-659000,income_statement,Telecom Services,uCloudlink Group Inc.,"uCloudlink Group Inc. operates as a mobile data traffic sharing marketplace in the telecommunications industry. The company provides uCloudlink 1.0, a model that focuses on cross-border travelers that need mobile data connectivity services in various countries; and operates portable Wi-Fi services under the Roamingman brand in China, Malaysia, and Singapore, which provides global mobile data connectivity services, as well as offers GlocalMe portable Wi-Fi terminals and cloud SIM architecture for mobile virtual network operators, mobile network operators (MNOs), and portable Wi-Fi terminal rental companies. It also offers uCloudlink 2.0, a model that provides mobile data connectivity services to local users through various MNOs; GlocalMe Inside, an implementation solutions for smartphones and other smart hardware terminals, which enables them to access its cloud SIM architecture and SIM card pool; and GlocalMe, a world phone series. In addition, the company provides IoT modules with GlocalMe Inside implementation to meet the demand for mobile data from various terminals, and provide integrated network solutions to its customers; SIM cards with prepaid data packages; and value added services, such as advertisement. Further, it's platform-as-a-service/ software-as-a-service offers modules, such as customer relationship management, company, and SIM card enterprise resource planning and management. The company was founded in 2014 and is headquartered in Kowloon, Hong Kong."
UCL,2019-12-31,15108000,5264000,NA,5207000,44591000,64918000,7063000,7063000,-438000,57000,158381000,151318000,93463000,-1799000,NA,5207000,2371000,-1844000,income_statement,Telecom Services,uCloudlink Group Inc.,"uCloudlink Group Inc. operates as a mobile data traffic sharing marketplace in the telecommunications industry. The company provides uCloudlink 1.0, a model that focuses on cross-border travelers that need mobile data connectivity services in various countries; and operates portable Wi-Fi services under the Roamingman brand in China, Malaysia, and Singapore, which provides global mobile data connectivity services, as well as offers GlocalMe portable Wi-Fi terminals and cloud SIM architecture for mobile virtual network operators, mobile network operators (MNOs), and portable Wi-Fi terminal rental companies. It also offers uCloudlink 2.0, a model that provides mobile data connectivity services to local users through various MNOs; GlocalMe Inside, an implementation solutions for smartphones and other smart hardware terminals, which enables them to access its cloud SIM architecture and SIM card pool; and GlocalMe, a world phone series. In addition, the company provides IoT modules with GlocalMe Inside implementation to meet the demand for mobile data from various terminals, and provide integrated network solutions to its customers; SIM cards with prepaid data packages; and value added services, such as advertisement. Further, it's platform-as-a-service/ software-as-a-service offers modules, such as customer relationship management, company, and SIM card enterprise resource planning and management. The company was founded in 2014 and is headquartered in Kowloon, Hong Kong."
UCTT,2017-12-29,11700000,87000000,14700000,75100000,66500000,167700000,89500000,89500000,-2200000,11900000,924400000,834900000,756700000,-2500000,NA,75100000,75100000,NA,income_statement,Semiconductor Equipment & Materials,"Ultra Clean Holdings, Inc.","Ultra Clean Holdings, Inc. designs, develops, prototypes, engineers, manufactures, and tests production tools, modules, and subsystems for the semiconductor and display capital equipment industries in the United States and internationally. The company provides subsystems, such as wafer cleaning modules; chemical delivery modules that deliver gases and reactive chemicals in a liquid or gaseous form from a centralized subsystem to the reaction chamber; frame assemblies, a support structures fabricated from steel tubing or folded sheet metal; process modules, a subsystems of semiconductor manufacturing tools that process integrated circuits onto wafers; and top-plate assemblies. It also offers various industrial and automation production equipment products; gas delivery systems, which include one or more gas lines, such as weldments, filters, mass flow controllers, regulators, pressure transducers and valves, component heaters, and an integrated electronic and/or pneumatic control system; fluid delivery systems consists of one or more chemical delivery units, including PFA tubing, filters, flow controllers, regulators, component heaters, and an integrated electronic and/or pneumatic control system; precision robotic systems that are used when accurate controlled motion is required; and other high level assemblies. In addition, the company provides tool chamber parts cleaning and coating services; micro-contamination analysis services for tool parts, wafers and depositions, chemicals, cleanroom materials, deionized water, and airborne molecular contamination; and analytical verification services for process tool chamber part cleaning. It primarily serves original equipment manufacturing customers in the semiconductor capital equipment and semiconductor integrated device manufacturing industries, as well as display, consumer, medical, energy, industrial, and research equipment industries. The company was founded in 1991 and is headquartered in Hayward, California."
UCTT,2018-12-28,13300000,52300000,14700000,36600000,91800000,175800000,70700000,70700000,-10000000,15300000,1096500000,1025800000,920700000,-18400000,NA,37000000,36600000,NA,income_statement,Semiconductor Equipment & Materials,"Ultra Clean Holdings, Inc.","Ultra Clean Holdings, Inc. designs, develops, prototypes, engineers, manufactures, and tests production tools, modules, and subsystems for the semiconductor and display capital equipment industries in the United States and internationally. The company provides subsystems, such as wafer cleaning modules; chemical delivery modules that deliver gases and reactive chemicals in a liquid or gaseous form from a centralized subsystem to the reaction chamber; frame assemblies, a support structures fabricated from steel tubing or folded sheet metal; process modules, a subsystems of semiconductor manufacturing tools that process integrated circuits onto wafers; and top-plate assemblies. It also offers various industrial and automation production equipment products; gas delivery systems, which include one or more gas lines, such as weldments, filters, mass flow controllers, regulators, pressure transducers and valves, component heaters, and an integrated electronic and/or pneumatic control system; fluid delivery systems consists of one or more chemical delivery units, including PFA tubing, filters, flow controllers, regulators, component heaters, and an integrated electronic and/or pneumatic control system; precision robotic systems that are used when accurate controlled motion is required; and other high level assemblies. In addition, the company provides tool chamber parts cleaning and coating services; micro-contamination analysis services for tool parts, wafers and depositions, chemicals, cleanroom materials, deionized water, and airborne molecular contamination; and analytical verification services for process tool chamber part cleaning. It primarily serves original equipment manufacturing customers in the semiconductor capital equipment and semiconductor integrated device manufacturing industries, as well as display, consumer, medical, energy, industrial, and research equipment industries. The company was founded in 1991 and is headquartered in Hayward, California."
UCTT,2019-12-27,14600000,2300000,15800000,-9400000,134900000,196800000,47300000,47300000,-25600000,10000000,1066200000,1018900000,869400000,-45000000,NA,-7700000,-9400000,NA,income_statement,Semiconductor Equipment & Materials,"Ultra Clean Holdings, Inc.","Ultra Clean Holdings, Inc. designs, develops, prototypes, engineers, manufactures, and tests production tools, modules, and subsystems for the semiconductor and display capital equipment industries in the United States and internationally. The company provides subsystems, such as wafer cleaning modules; chemical delivery modules that deliver gases and reactive chemicals in a liquid or gaseous form from a centralized subsystem to the reaction chamber; frame assemblies, a support structures fabricated from steel tubing or folded sheet metal; process modules, a subsystems of semiconductor manufacturing tools that process integrated circuits onto wafers; and top-plate assemblies. It also offers various industrial and automation production equipment products; gas delivery systems, which include one or more gas lines, such as weldments, filters, mass flow controllers, regulators, pressure transducers and valves, component heaters, and an integrated electronic and/or pneumatic control system; fluid delivery systems consists of one or more chemical delivery units, including PFA tubing, filters, flow controllers, regulators, component heaters, and an integrated electronic and/or pneumatic control system; precision robotic systems that are used when accurate controlled motion is required; and other high level assemblies. In addition, the company provides tool chamber parts cleaning and coating services; micro-contamination analysis services for tool parts, wafers and depositions, chemicals, cleanroom materials, deionized water, and airborne molecular contamination; and analytical verification services for process tool chamber part cleaning. It primarily serves original equipment manufacturing customers in the semiconductor capital equipment and semiconductor integrated device manufacturing industries, as well as display, consumer, medical, energy, industrial, and research equipment industries. The company was founded in 1991 and is headquartered in Hayward, California."
UCTT,2020-12-25,14829000,99671000,18566000,77605000,155562000,292749000,122358000,122358000,-16852000,19281000,1398582000,1276224000,1105833000,-22687000,NA,80390000,77605000,NA,income_statement,Semiconductor Equipment & Materials,"Ultra Clean Holdings, Inc.","Ultra Clean Holdings, Inc. designs, develops, prototypes, engineers, manufactures, and tests production tools, modules, and subsystems for the semiconductor and display capital equipment industries in the United States and internationally. The company provides subsystems, such as wafer cleaning modules; chemical delivery modules that deliver gases and reactive chemicals in a liquid or gaseous form from a centralized subsystem to the reaction chamber; frame assemblies, a support structures fabricated from steel tubing or folded sheet metal; process modules, a subsystems of semiconductor manufacturing tools that process integrated circuits onto wafers; and top-plate assemblies. It also offers various industrial and automation production equipment products; gas delivery systems, which include one or more gas lines, such as weldments, filters, mass flow controllers, regulators, pressure transducers and valves, component heaters, and an integrated electronic and/or pneumatic control system; fluid delivery systems consists of one or more chemical delivery units, including PFA tubing, filters, flow controllers, regulators, component heaters, and an integrated electronic and/or pneumatic control system; precision robotic systems that are used when accurate controlled motion is required; and other high level assemblies. In addition, the company provides tool chamber parts cleaning and coating services; micro-contamination analysis services for tool parts, wafers and depositions, chemicals, cleanroom materials, deionized water, and airborne molecular contamination; and analytical verification services for process tool chamber part cleaning. It primarily serves original equipment manufacturing customers in the semiconductor capital equipment and semiconductor integrated device manufacturing industries, as well as display, consumer, medical, energy, industrial, and research equipment industries. The company was founded in 1991 and is headquartered in Hayward, California."
UDR,2017-12-31,NA,132415000,957702000,121558000,60966000,720374000,220086000,220086000,-128711000,-240000,1027048000,806962000,306674000,-87671000,NA,132655000,117850000,2860000,income_statement,NA,NA,NA
UDR,2018-12-31,NA,222230000,989892000,203106000,60983000,665949000,164487000,164487000,-134168000,688000,990704000,826217000,324755000,57743000,NA,221542000,199238000,4800000,income_statement,NA,NA,NA
UDR,2019-12-31,NA,203417000,1049437000,184965000,58033000,803910000,224022000,224022000,-170917000,3838000,1159966000,935944000,356056000,-20605000,NA,199579000,180861000,13932000,income_statement,NA,NA,NA
UDR,2020-12-31,NA,71515000,880685000,64266000,49885000,842077000,150801000,150801000,-153516000,2545000,1260009000,1109208000,417932000,-79286000,NA,68970000,60036000,22762000,income_statement,NA,NA,NA
UEIC,2017-12-31,21416000,7288000,NA,-10323000,127376000,165707000,16915000,16915000,-2700000,17611000,695790000,678875000,530083000,-9627000,NA,-10323000,-10323000,NA,income_statement,Consumer Electronics,Universal Electronics Inc.,"Universal Electronics Inc. designs, develops, and manufactures pre-programmed and universal control products, audio-video (AV) accessories, and intelligent wireless security and smart home products for consumer electronics, subscription broadcasting, home entertainment, automation, security, and hospitality and climate control markets. The company offers universal infrared and radio frequency (RF) remote controls; integrated circuits on which its software and universal device control database is embedded; and software, firmware, and technology solutions that enable devices, including televisions, set-top boxes, audio systems, smartphones, tablets, game controllers, and other consumer electronic devices to wirelessly connect and interact with home networks, as well as interactive services to control and deliver digital entertainment and information. It also provides proprietary and standards-based RF sensors designed for residential security, safety, and automation applications; AV accessories; and wall-mount and handheld thermostat controllers, and connected accessories for intelligent energy management systems. In addition, the company licenses intellectual property comprising its patented technologies, and database of home connectivity software and control codes. It serves service providers, original equipment manufacturers, retailers, private label brands, and pro-security dealers and companies in the computing industry. The company sells its products under the One For All brand in the United States, the People's Republic of China, rest of Asia, Europe, Latin America, and internationally. Universal Electronics Inc. was founded in 1986 and is headquartered in Scottsdale, Arizona."
UEIC,2018-12-31,23815000,26166000,NA,11924000,119454000,146711000,3442000,3442000,-5000000,14242000,680241000,676799000,533530000,22724000,NA,11924000,11924000,NA,income_statement,Consumer Electronics,Universal Electronics Inc.,"Universal Electronics Inc. designs, develops, and manufactures pre-programmed and universal control products, audio-video (AV) accessories, and intelligent wireless security and smart home products for consumer electronics, subscription broadcasting, home entertainment, automation, security, and hospitality and climate control markets. The company offers universal infrared and radio frequency (RF) remote controls; integrated circuits on which its software and universal device control database is embedded; and software, firmware, and technology solutions that enable devices, including televisions, set-top boxes, audio systems, smartphones, tablets, game controllers, and other consumer electronic devices to wirelessly connect and interact with home networks, as well as interactive services to control and deliver digital entertainment and information. It also provides proprietary and standards-based RF sensors designed for residential security, safety, and automation applications; AV accessories; and wall-mount and handheld thermostat controllers, and connected accessories for intelligent energy management systems. In addition, the company licenses intellectual property comprising its patented technologies, and database of home connectivity software and control codes. It serves service providers, original equipment manufacturers, retailers, private label brands, and pro-security dealers and companies in the computing industry. The company sells its products under the One For All brand in the United States, the People's Republic of China, rest of Asia, Europe, Latin America, and internationally. Universal Electronics Inc. was founded in 1986 and is headquartered in Scottsdale, Arizona."
UEIC,2019-12-31,29412000,10402000,NA,3630000,125276000,170303000,15615000,15615000,-4300000,6772000,753477000,737862000,583174000,-5213000,NA,3630000,3630000,NA,income_statement,Consumer Electronics,Universal Electronics Inc.,"Universal Electronics Inc. designs, develops, and manufactures pre-programmed and universal control products, audio-video (AV) accessories, and intelligent wireless security and smart home products for consumer electronics, subscription broadcasting, home entertainment, automation, security, and hospitality and climate control markets. The company offers universal infrared and radio frequency (RF) remote controls; integrated circuits on which its software and universal device control database is embedded; and software, firmware, and technology solutions that enable devices, including televisions, set-top boxes, audio systems, smartphones, tablets, game controllers, and other consumer electronic devices to wirelessly connect and interact with home networks, as well as interactive services to control and deliver digital entertainment and information. It also provides proprietary and standards-based RF sensors designed for residential security, safety, and automation applications; AV accessories; and wall-mount and handheld thermostat controllers, and connected accessories for intelligent energy management systems. In addition, the company licenses intellectual property comprising its patented technologies, and database of home connectivity software and control codes. It serves service providers, original equipment manufacturers, retailers, private label brands, and pro-security dealers and companies in the computing industry. The company sells its products under the One For All brand in the United States, the People's Republic of China, rest of Asia, Europe, Latin America, and internationally. Universal Electronics Inc. was founded in 1986 and is headquartered in Scottsdale, Arizona."
UEIC,2020-12-31,31450000,43905000,NA,38572000,107539000,176460000,37471000,37471000,-1422000,5333000,614680000,577209000,438220000,6434000,NA,38572000,38572000,NA,income_statement,Consumer Electronics,Universal Electronics Inc.,"Universal Electronics Inc. designs, develops, and manufactures pre-programmed and universal control products, audio-video (AV) accessories, and intelligent wireless security and smart home products for consumer electronics, subscription broadcasting, home entertainment, automation, security, and hospitality and climate control markets. The company offers universal infrared and radio frequency (RF) remote controls; integrated circuits on which its software and universal device control database is embedded; and software, firmware, and technology solutions that enable devices, including televisions, set-top boxes, audio systems, smartphones, tablets, game controllers, and other consumer electronic devices to wirelessly connect and interact with home networks, as well as interactive services to control and deliver digital entertainment and information. It also provides proprietary and standards-based RF sensors designed for residential security, safety, and automation applications; AV accessories; and wall-mount and handheld thermostat controllers, and connected accessories for intelligent energy management systems. In addition, the company licenses intellectual property comprising its patented technologies, and database of home connectivity software and control codes. It serves service providers, original equipment manufacturers, retailers, private label brands, and pro-security dealers and companies in the computing industry. The company sells its products under the One For All brand in the United States, the People's Republic of China, rest of Asia, Europe, Latin America, and internationally. Universal Electronics Inc. was founded in 1986 and is headquartered in Scottsdale, Arizona."
UEPS,2017-06-30,NA,117270000,2766000,73070000,171262000,317683000,105043000,105043000,-3484000,42506000,610066000,505023000,292383000,12227000,9945000,74764000,73070000,NA,income_statement,Software—Infrastructure,"Net 1 UEPS Technologies, Inc.","Net 1 UEPS Technologies, Inc. provides transaction processing services, financial inclusion products and services, and secure payment technologies in South Africa, the Republic of Korea, and internationally. It operates through three segments: South African Transaction Processing, International Transaction Processing, and Financial Inclusion and Applied Technologies. The South African Transaction Processing segment primarily offers transaction processing for retailers, utilities, and banks. The International Transaction Processing segment offers payment processing services to merchants and card issuers. The Financial Inclusion and Applied Technologies segment provides short-term loans and bank accounts. It also sells prepaid products, such as electricity and airtime, hardware and software, and life insurance products. In addition, this segment distributes starter packs; and provides financing to Cell C for expanding the components of Cell C's telecommunications infrastructure in South Africa. The company was incorporated in 1997 and is headquartered in Johannesburg, South Africa."
UEPS,2018-06-30,NA,96368000,95911000,62087000,130322000,216021000,75226000,75226000,-8569000,45106000,459575000,384349000,243554000,21142000,9945000,51262000,61052000,NA,income_statement,Software—Infrastructure,"Net 1 UEPS Technologies, Inc.","Net 1 UEPS Technologies, Inc. provides transaction processing services, financial inclusion products and services, and secure payment technologies in South Africa, the Republic of Korea, and internationally. It operates through three segments: South African Transaction Processing, International Transaction Processing, and Financial Inclusion and Applied Technologies. The South African Transaction Processing segment primarily offers transaction processing for retailers, utilities, and banks. The International Transaction Processing segment offers payment processing services to merchants and card issuers. The Financial Inclusion and Applied Technologies segment provides short-term loans and bank accounts. It also sells prepaid products, such as electricity and airtime, hardware and software, and life insurance products. In addition, this segment distributes starter packs; and provides financing to Cell C for expanding the components of Cell C's telecommunications infrastructure in South Africa. The company was incorporated in 1997 and is headquartered in Johannesburg, South Africa."
UEPS,2019-06-30,NA,-318185000,NA,-311007000,124351000,56240000,-80214000,-80214000,-9860000,-5072000,185936000,266150000,129696000,-237971000,754000,-313113000,-306640000,NA,income_statement,Software—Infrastructure,"Net 1 UEPS Technologies, Inc.","Net 1 UEPS Technologies, Inc. provides transaction processing services, financial inclusion products and services, and secure payment technologies in South Africa, the Republic of Korea, and internationally. It operates through three segments: South African Transaction Processing, International Transaction Processing, and Financial Inclusion and Applied Technologies. The South African Transaction Processing segment primarily offers transaction processing for retailers, utilities, and banks. The International Transaction Processing segment offers payment processing services to merchants and card issuers. The Financial Inclusion and Applied Technologies segment provides short-term loans and bank accounts. It also sells prepaid products, such as electricity and airtime, hardware and software, and life insurance products. In addition, this segment distributes starter packs; and provides financing to Cell C for expanding the components of Cell C's telecommunications infrastructure in South Africa. The company was incorporated in 1997 and is headquartered in Johannesburg, South Africa."
UEPS,2020-06-30,NA,-94558000,NA,-78358000,75256000,41991000,-37912000,-37912000,-7641000,2656000,150997000,188909000,109006000,-56646000,18856000,-97214000,-76827000,NA,income_statement,Software—Infrastructure,"Net 1 UEPS Technologies, Inc.","Net 1 UEPS Technologies, Inc. provides transaction processing services, financial inclusion products and services, and secure payment technologies in South Africa, the Republic of Korea, and internationally. It operates through three segments: South African Transaction Processing, International Transaction Processing, and Financial Inclusion and Applied Technologies. The South African Transaction Processing segment primarily offers transaction processing for retailers, utilities, and banks. The International Transaction Processing segment offers payment processing services to merchants and card issuers. The Financial Inclusion and Applied Technologies segment provides short-term loans and bank accounts. It also sells prepaid products, such as electricity and airtime, hardware and software, and life insurance products. In addition, this segment distributes starter packs; and provides financing to Cell C for expanding the components of Cell C's telecommunications infrastructure in South Africa. The company was incorporated in 1997 and is headquartered in Johannesburg, South Africa."
UFCS,2017-12-31,NA,15650000,NA,51023000,NA,15650000,15650000,15650000,NA,-29220000,1052737000,1037087000,1037087000,0,6153000,44870000,51023000,NA,income_statement,Insurance—Property & Casualty,"United Fire Group, Inc","United Fire Group, Inc., together with its subsidiaries, provides property and casualty insurance for individuals and businesses in the United States. The company offers commercial and personal lines of property and casualty insurance, as well as assumed reinsurance products. Its commercial policies include fire and allied lines, other liability, automobile, workers' compensation, and surety coverage; and personal lines comprise automobile, and fire and allied lines coverage, including homeowners. The company sells its products through a network of independent agencies. United Fire Group, Inc. was founded in 1946 and is headquartered in Cedar Rapids, Iowa."
UFCS,2018-12-31,NA,-9150000,NA,27650000,NA,-9150000,-9150000,-9150000,NA,-11405000,1070166000,1079316000,1079316000,0,25395000,2255000,27650000,NA,income_statement,Insurance—Property & Casualty,"United Fire Group, Inc","United Fire Group, Inc., together with its subsidiaries, provides property and casualty insurance for individuals and businesses in the United States. The company offers commercial and personal lines of property and casualty insurance, as well as assumed reinsurance products. Its commercial policies include fire and allied lines, other liability, automobile, workers' compensation, and surety coverage; and personal lines comprise automobile, and fire and allied lines coverage, including homeowners. The company sells its products through a network of independent agencies. United Fire Group, Inc. was founded in 1946 and is headquartered in Cedar Rapids, Iowa."
UFCS,2019-12-31,NA,16879000,NA,14820000,NA,16879000,16879000,16879000,NA,2059000,1201165000,1184286000,1184286000,0,NA,14820000,14820000,NA,income_statement,Insurance—Property & Casualty,"United Fire Group, Inc","United Fire Group, Inc., together with its subsidiaries, provides property and casualty insurance for individuals and businesses in the United States. The company offers commercial and personal lines of property and casualty insurance, as well as assumed reinsurance products. Its commercial policies include fire and allied lines, other liability, automobile, workers' compensation, and surety coverage; and personal lines comprise automobile, and fire and allied lines coverage, including homeowners. The company sells its products through a network of independent agencies. United Fire Group, Inc. was founded in 1946 and is headquartered in Cedar Rapids, Iowa."
UFCS,2020-12-31,NA,-169515000,NA,-112706000,NA,-154424000,-154424000,-154424000,NA,-56809000,1068627000,1223051000,1223051000,-15091000,NA,-112706000,-112706000,NA,income_statement,Insurance—Property & Casualty,"United Fire Group, Inc","United Fire Group, Inc., together with its subsidiaries, provides property and casualty insurance for individuals and businesses in the United States. The company offers commercial and personal lines of property and casualty insurance, as well as assumed reinsurance products. Its commercial policies include fire and allied lines, other liability, automobile, workers' compensation, and surety coverage; and personal lines comprise automobile, and fire and allied lines coverage, including homeowners. The company sells its products through a network of independent agencies. United Fire Group, Inc. was founded in 1946 and is headquartered in Cedar Rapids, Iowa."
UFPI,2016-12-31,NA,160671000,11286000,101179000,310152000,474590000,164438000,164438000,-4575000,55174000,3240493000,3076055000,2765903000,-3500000,NA,105497000,99584000,NA,income_statement,Lumber & Wood Production,"UFP Industries, Inc.","UFP Industries, Inc., through its subsidiaries, designs, manufactures, and markets wood and wood-alternative products in North America, Europe, Asia, and Australia. The company offers preserved and unpreserved dimensional lumber; outdoor living products, including wood and wood composite decking and related accessories, and decorative lawn and garden products; and engineered wood components, which include roof and floor trusses, wall panels, engineered floor systems, I-joists, and lumber packages. It also provides pallets, specialty crates, wooden boxes, and other containers and products that are used for packaging, shipping, and material handling applications; designs, manufactures, and installs interior fixtures that are used in retail and commercial structures; and provides lumber cut and shaped, plywood, oriented strand board, and dimensional lumber products for use in the construction of manufactured housings. In addition, the company supplies siding, electrical, and plumbing products to manufactured housing and recreational vehicle customers; and wood forms and related products to set or form concrete for various structures, such as parking garages, stadiums, and bridges. Further, it provides framing services; and specialty wood packaging, components, and packing materials for various industries. The company primarily sells its products under the roWood, Deckorators, UFP-Edge, Outdoor Essentials, Dimensions, and ProWood FR trademarks. It serves retail market comprising home center retailers, retail-oriented regional lumberyards, and contractor-oriented lumberyards; industrial market, including manufacturers and agricultural customers; and construction market, such as manufactured housing, residential construction, and commercial construction markets. The company was formerly known as Universal Forest Products, Inc. and changed its name to UFP Industries, Inc. in April 2020. UFP Industries, Inc. was founded in 1955 and is headquartered in Grand Rapids, Michigan."
UFPI,2017-12-30,NA,176007000,14547000,119512000,362220000,542826000,180606000,180606000,-6218000,51967000,3941182000,3760576000,3398356000,-4574000,NA,124040000,117287000,NA,income_statement,Lumber & Wood Production,"UFP Industries, Inc.","UFP Industries, Inc., through its subsidiaries, designs, manufactures, and markets wood and wood-alternative products in North America, Europe, Asia, and Australia. The company offers preserved and unpreserved dimensional lumber; outdoor living products, including wood and wood composite decking and related accessories, and decorative lawn and garden products; and engineered wood components, which include roof and floor trusses, wall panels, engineered floor systems, I-joists, and lumber packages. It also provides pallets, specialty crates, wooden boxes, and other containers and products that are used for packaging, shipping, and material handling applications; designs, manufactures, and installs interior fixtures that are used in retail and commercial structures; and provides lumber cut and shaped, plywood, oriented strand board, and dimensional lumber products for use in the construction of manufactured housings. In addition, the company supplies siding, electrical, and plumbing products to manufactured housing and recreational vehicle customers; and wood forms and related products to set or form concrete for various structures, such as parking garages, stadiums, and bridges. Further, it provides framing services; and specialty wood packaging, components, and packing materials for various industries. The company primarily sells its products under the roWood, Deckorators, UFP-Edge, Outdoor Essentials, Dimensions, and ProWood FR trademarks. It serves retail market comprising home center retailers, retail-oriented regional lumberyards, and contractor-oriented lumberyards; industrial market, including manufacturers and agricultural customers; and construction market, such as manufactured housing, residential construction, and commercial construction markets. The company was formerly known as Universal Forest Products, Inc. and changed its name to UFP Industries, Inc. in April 2020. UFP Industries, Inc. was founded in 1955 and is headquartered in Grand Rapids, Michigan."
UFPI,2018-12-29,NA,197853000,15281000,148598000,392235000,592894000,200659000,200659000,-8893000,45441000,4489180000,4288521000,3896286000,-2806000,NA,152412000,145202000,NA,income_statement,Lumber & Wood Production,"UFP Industries, Inc.","UFP Industries, Inc., through its subsidiaries, designs, manufactures, and markets wood and wood-alternative products in North America, Europe, Asia, and Australia. The company offers preserved and unpreserved dimensional lumber; outdoor living products, including wood and wood composite decking and related accessories, and decorative lawn and garden products; and engineered wood components, which include roof and floor trusses, wall panels, engineered floor systems, I-joists, and lumber packages. It also provides pallets, specialty crates, wooden boxes, and other containers and products that are used for packaging, shipping, and material handling applications; designs, manufactures, and installs interior fixtures that are used in retail and commercial structures; and provides lumber cut and shaped, plywood, oriented strand board, and dimensional lumber products for use in the construction of manufactured housings. In addition, the company supplies siding, electrical, and plumbing products to manufactured housing and recreational vehicle customers; and wood forms and related products to set or form concrete for various structures, such as parking garages, stadiums, and bridges. Further, it provides framing services; and specialty wood packaging, components, and packing materials for various industries. The company primarily sells its products under the roWood, Deckorators, UFP-Edge, Outdoor Essentials, Dimensions, and ProWood FR trademarks. It serves retail market comprising home center retailers, retail-oriented regional lumberyards, and contractor-oriented lumberyards; industrial market, including manufacturers and agricultural customers; and construction market, such as manufactured housing, residential construction, and commercial construction markets. The company was formerly known as Universal Forest Products, Inc. and changed its name to UFP Industries, Inc. in April 2020. UFP Industries, Inc. was founded in 1955 and is headquartered in Grand Rapids, Michigan."
UFPI,2019-12-28,NA,240674000,14018000,179650000,439047000,685518000,246471000,246471000,-8700000,58270000,4416009000,4169538000,3730491000,-5797000,NA,182404000,175154000,NA,income_statement,Lumber & Wood Production,"UFP Industries, Inc.","UFP Industries, Inc., through its subsidiaries, designs, manufactures, and markets wood and wood-alternative products in North America, Europe, Asia, and Australia. The company offers preserved and unpreserved dimensional lumber; outdoor living products, including wood and wood composite decking and related accessories, and decorative lawn and garden products; and engineered wood components, which include roof and floor trusses, wall panels, engineered floor systems, I-joists, and lumber packages. It also provides pallets, specialty crates, wooden boxes, and other containers and products that are used for packaging, shipping, and material handling applications; designs, manufactures, and installs interior fixtures that are used in retail and commercial structures; and provides lumber cut and shaped, plywood, oriented strand board, and dimensional lumber products for use in the construction of manufactured housings. In addition, the company supplies siding, electrical, and plumbing products to manufactured housing and recreational vehicle customers; and wood forms and related products to set or form concrete for various structures, such as parking garages, stadiums, and bridges. Further, it provides framing services; and specialty wood packaging, components, and packing materials for various industries. The company primarily sells its products under the roWood, Deckorators, UFP-Edge, Outdoor Essentials, Dimensions, and ProWood FR trademarks. It serves retail market comprising home center retailers, retail-oriented regional lumberyards, and contractor-oriented lumberyards; industrial market, including manufacturers and agricultural customers; and construction market, such as manufactured housing, residential construction, and commercial construction markets. The company was formerly known as Universal Forest Products, Inc. and changed its name to UFP Industries, Inc. in April 2020. UFP Industries, Inc. was founded in 1955 and is headquartered in Grand Rapids, Michigan."
UFPT,2016-12-31,NA,12317000,NA,7970000,24105000,34650000,10545000,10545000,-69000,4347000,146132000,135587000,111482000,1772000,NA,7970000,7970000,NA,income_statement,Packaging & Containers,"UFP Technologies, Inc.","UFP Technologies, Inc. designs and converts foams, plastics, composites, and natural fiber materials for the medical, automotive, consumer, electronics, industrial, and aerospace and defense markets in the United States. It offers single patient use surfaces, advanced wound care, infection prevention, and disposables for surgical procedures, endoscopic procedures, orthopedic implants, orthopedic appliances, biopharma drug manufacturing, etc.; molded components for automotive, aerospace, and defense markets; recycled protective packaging for B2C brands; and reusable cases and custom inserts. The company markets and sells its products through direct sales forces and independent manufacturer representatives. UFP Technologies, Inc. was founded in 1963 and is headquartered in Newburyport, Massachusetts."
UFPT,2017-12-31,NA,11859000,NA,9210000,23724000,35487000,11763000,11763000,-50000,2649000,147843000,136080000,112356000,96000,NA,9210000,9210000,NA,income_statement,Packaging & Containers,"UFP Technologies, Inc.","UFP Technologies, Inc. designs and converts foams, plastics, composites, and natural fiber materials for the medical, automotive, consumer, electronics, industrial, and aerospace and defense markets in the United States. It offers single patient use surfaces, advanced wound care, infection prevention, and disposables for surgical procedures, endoscopic procedures, orthopedic implants, orthopedic appliances, biopharma drug manufacturing, etc.; molded components for automotive, aerospace, and defense markets; recycled protective packaging for B2C brands; and reusable cases and custom inserts. The company markets and sells its products through direct sales forces and independent manufacturer representatives. UFP Technologies, Inc. was founded in 1963 and is headquartered in Newburyport, Massachusetts."
UFPT,2018-12-31,NA,18403000,NA,14311000,27654000,48308000,20654000,20654000,-1256000,4092000,190455000,169801000,142147000,-2187000,NA,14311000,14311000,NA,income_statement,Packaging & Containers,"UFP Technologies, Inc.","UFP Technologies, Inc. designs and converts foams, plastics, composites, and natural fiber materials for the medical, automotive, consumer, electronics, industrial, and aerospace and defense markets in the United States. It offers single patient use surfaces, advanced wound care, infection prevention, and disposables for surgical procedures, endoscopic procedures, orthopedic implants, orthopedic appliances, biopharma drug manufacturing, etc.; molded components for automotive, aerospace, and defense markets; recycled protective packaging for B2C brands; and reusable cases and custom inserts. The company markets and sells its products through direct sales forces and independent manufacturer representatives. UFP Technologies, Inc. was founded in 1963 and is headquartered in Newburyport, Massachusetts."
UFPT,2019-12-31,NA,23646000,NA,19750000,29251000,53959000,24708000,24708000,-1062000,3896000,198381000,173673000,144422000,-1450000,NA,19750000,19750000,NA,income_statement,Packaging & Containers,"UFP Technologies, Inc.","UFP Technologies, Inc. designs and converts foams, plastics, composites, and natural fiber materials for the medical, automotive, consumer, electronics, industrial, and aerospace and defense markets in the United States. It offers single patient use surfaces, advanced wound care, infection prevention, and disposables for surgical procedures, endoscopic procedures, orthopedic implants, orthopedic appliances, biopharma drug manufacturing, etc.; molded components for automotive, aerospace, and defense markets; recycled protective packaging for B2C brands; and reusable cases and custom inserts. The company markets and sells its products through direct sales forces and independent manufacturer representatives. UFP Technologies, Inc. was founded in 1963 and is headquartered in Newburyport, Massachusetts."
UG,2016-12-31,651828,3696067,NA,2581142,1852833,5894223,3389562,3389562,NA,1114925,10776867,7387305,4882644,306505,NA,2581142,2581142,NA,income_statement,Household & Personal Products,"United-Guardian, Inc.","United-Guardian, Inc. manufactures and markets cosmetic ingredients, pharmaceuticals, medical lubricants, and specialty industrial products in the United States and internationally. It offers cosmetic ingredients, including LUBRAJEL line of water-based moisturizing and lubricating gel formulations; LUBRAJEL PF and NORGEL, a preservative-free form of LUBRAJEL; LUBRAJEL NATURAL, which are natural ingredients for cosmetic use; LUBRAJEL MARINE; LUBRASIL, a special formulation of LUBRAJEL in which silicone oil is incorporated into a LUBRAJEL base; LUBRAJEL II XD; LUBRASLIDE and B-122 powdered lubricants that are used in the manufacture of pressed powders, eyeliners, and rouges; KLENSOFT, a surfactant, which is used in shampoos, shower gels, makeup removers, and other cosmetic formulations; and ORCHID COMPLEX, an oil-soluble base for skin creams, lotions, cleansers, and other cosmetics. The company's medical lubricants comprise LUBRAJEL RR and RC, which are water-based lubricant gels for urinary catheters; LUBRAJEL MG to lubricate urinary catheters, pre-lubricated enema tips, and other medical devices; LUBRAJEL LC and LUBRAJEL FA that are LUBRAJEL formulations for oral care; and LUBRAJEL FLUID to lubricate water-soluble products. Its pharmaceutical products consist of RENACIDIN, a prescription drug to prevent and dissolve calcifications in urethral catheters and the urinary bladder; and CLORPACTIN WCS-90, an antimicrobial product to treat infections in the urinary bladder. The company's industrial products include DESELEX, a sequestering and chelating agent used for manufacturing detergents; and THOROCLENS, a chlorine-based cleanser. It also conducts research and development, primarily related to the development of cosmetic ingredients. The company markets its products through marketing partners, distributors, and wholesalers. United-Guardian, Inc. was founded in 1942 and is headquartered in Hauppauge, New York."
UG,2017-12-31,646079,5550779,NA,3844290,1785160,7666853,5235614,5235614,NA,1706489,12968205,7732591,5301352,315165,NA,3844290,3844290,NA,income_statement,Household & Personal Products,"United-Guardian, Inc.","United-Guardian, Inc. manufactures and markets cosmetic ingredients, pharmaceuticals, medical lubricants, and specialty industrial products in the United States and internationally. It offers cosmetic ingredients, including LUBRAJEL line of water-based moisturizing and lubricating gel formulations; LUBRAJEL PF and NORGEL, a preservative-free form of LUBRAJEL; LUBRAJEL NATURAL, which are natural ingredients for cosmetic use; LUBRAJEL MARINE; LUBRASIL, a special formulation of LUBRAJEL in which silicone oil is incorporated into a LUBRAJEL base; LUBRAJEL II XD; LUBRASLIDE and B-122 powdered lubricants that are used in the manufacture of pressed powders, eyeliners, and rouges; KLENSOFT, a surfactant, which is used in shampoos, shower gels, makeup removers, and other cosmetic formulations; and ORCHID COMPLEX, an oil-soluble base for skin creams, lotions, cleansers, and other cosmetics. The company's medical lubricants comprise LUBRAJEL RR and RC, which are water-based lubricant gels for urinary catheters; LUBRAJEL MG to lubricate urinary catheters, pre-lubricated enema tips, and other medical devices; LUBRAJEL LC and LUBRAJEL FA that are LUBRAJEL formulations for oral care; and LUBRAJEL FLUID to lubricate water-soluble products. Its pharmaceutical products consist of RENACIDIN, a prescription drug to prevent and dissolve calcifications in urethral catheters and the urinary bladder; and CLORPACTIN WCS-90, an antimicrobial product to treat infections in the urinary bladder. The company's industrial products include DESELEX, a sequestering and chelating agent used for manufacturing detergents; and THOROCLENS, a chlorine-based cleanser. It also conducts research and development, primarily related to the development of cosmetic ingredients. The company markets its products through marketing partners, distributors, and wholesalers. United-Guardian, Inc. was founded in 1942 and is headquartered in Hauppauge, New York."
UG,2018-12-31,399517,5465854,NA,4352331,2122746,8102106,5579843,5579843,NA,1113523,13445565,7865722,5343459,-113989,NA,4352331,4352331,NA,income_statement,Household & Personal Products,"United-Guardian, Inc.","United-Guardian, Inc. manufactures and markets cosmetic ingredients, pharmaceuticals, medical lubricants, and specialty industrial products in the United States and internationally. It offers cosmetic ingredients, including LUBRAJEL line of water-based moisturizing and lubricating gel formulations; LUBRAJEL PF and NORGEL, a preservative-free form of LUBRAJEL; LUBRAJEL NATURAL, which are natural ingredients for cosmetic use; LUBRAJEL MARINE; LUBRASIL, a special formulation of LUBRAJEL in which silicone oil is incorporated into a LUBRAJEL base; LUBRAJEL II XD; LUBRASLIDE and B-122 powdered lubricants that are used in the manufacture of pressed powders, eyeliners, and rouges; KLENSOFT, a surfactant, which is used in shampoos, shower gels, makeup removers, and other cosmetic formulations; and ORCHID COMPLEX, an oil-soluble base for skin creams, lotions, cleansers, and other cosmetics. The company's medical lubricants comprise LUBRAJEL RR and RC, which are water-based lubricant gels for urinary catheters; LUBRAJEL MG to lubricate urinary catheters, pre-lubricated enema tips, and other medical devices; LUBRAJEL LC and LUBRAJEL FA that are LUBRAJEL formulations for oral care; and LUBRAJEL FLUID to lubricate water-soluble products. Its pharmaceutical products consist of RENACIDIN, a prescription drug to prevent and dissolve calcifications in urethral catheters and the urinary bladder; and CLORPACTIN WCS-90, an antimicrobial product to treat infections in the urinary bladder. The company's industrial products include DESELEX, a sequestering and chelating agent used for manufacturing detergents; and THOROCLENS, a chlorine-based cleanser. It also conducts research and development, primarily related to the development of cosmetic ingredients. The company markets its products through marketing partners, distributors, and wholesalers. United-Guardian, Inc. was founded in 1942 and is headquartered in Hauppauge, New York."
UG,2019-12-31,397391,6030370,NA,4761711,2148375,7941731,5395965,5395965,NA,1268659,13599084,8203119,5657353,634405,NA,4761711,4761711,NA,income_statement,Household & Personal Products,"United-Guardian, Inc.","United-Guardian, Inc. manufactures and markets cosmetic ingredients, pharmaceuticals, medical lubricants, and specialty industrial products in the United States and internationally. It offers cosmetic ingredients, including LUBRAJEL line of water-based moisturizing and lubricating gel formulations; LUBRAJEL PF and NORGEL, a preservative-free form of LUBRAJEL; LUBRAJEL NATURAL, which are natural ingredients for cosmetic use; LUBRAJEL MARINE; LUBRASIL, a special formulation of LUBRAJEL in which silicone oil is incorporated into a LUBRAJEL base; LUBRAJEL II XD; LUBRASLIDE and B-122 powdered lubricants that are used in the manufacture of pressed powders, eyeliners, and rouges; KLENSOFT, a surfactant, which is used in shampoos, shower gels, makeup removers, and other cosmetic formulations; and ORCHID COMPLEX, an oil-soluble base for skin creams, lotions, cleansers, and other cosmetics. The company's medical lubricants comprise LUBRAJEL RR and RC, which are water-based lubricant gels for urinary catheters; LUBRAJEL MG to lubricate urinary catheters, pre-lubricated enema tips, and other medical devices; LUBRAJEL LC and LUBRAJEL FA that are LUBRAJEL formulations for oral care; and LUBRAJEL FLUID to lubricate water-soluble products. Its pharmaceutical products consist of RENACIDIN, a prescription drug to prevent and dissolve calcifications in urethral catheters and the urinary bladder; and CLORPACTIN WCS-90, an antimicrobial product to treat infections in the urinary bladder. The company's industrial products include DESELEX, a sequestering and chelating agent used for manufacturing detergents; and THOROCLENS, a chlorine-based cleanser. It also conducts research and development, primarily related to the development of cosmetic ingredients. The company markets its products through marketing partners, distributors, and wholesalers. United-Guardian, Inc. was founded in 1942 and is headquartered in Hauppauge, New York."
UGRO,2016-12-31,NA,-1808861,NA,-1808861,3020352,1410900,-1609452,-1609452,-218430,0,7033273,8642725,5622373,-199409,NA,-1808861,-1808861,NA,income_statement,Farm & Heavy Construction Machinery,"urban-gro, Inc.","urban-gro, Inc. operates as an engineering design services company that integrates complex environmental equipment systems to create indoor cultivation facilities for the commercial horticulture market worldwide. It offers engineering and design services, including cultivation space programming, integrated cultivation design, and full-facility mechanical, electrical, and plumbing engineering; training services ranging from equipment standard operating procedure libraries to staff training sessions; facility and equipment commissioning services; program overview and pricing; and related-party hardware and software platforms. The company also offers an integrated suite of cultivation equipment systems and crop management products, which include environmental controls, fertigation, and irrigation distribution systems; freshwater, wastewater, and condensation treatment systems; light emitting diode, high-pressure sodium, and ceramic metal halide lighting systems; rolltop, multi-tier, and automated container benching systems; odor mitigation and microbial reduction systems; air flow systems; industrial spray applicators; pesticides and bio-controls; plant nutrition products; substrate and coco bag solutions; and Soleil technology data analytics platform that includes wireless environmental and substrate sensing and remote monitoring and support. urban-gro, Inc. was founded in 2014 and is based in Lafayette, Colorado."
UGRO,2017-12-31,NA,-2577395,NA,-2577395,5331990,3053686,-2363143,-2363143,-216576,0,12298015,14661158,9244329,-214252,NA,-2577395,-2577395,NA,income_statement,Farm & Heavy Construction Machinery,"urban-gro, Inc.","urban-gro, Inc. operates as an engineering design services company that integrates complex environmental equipment systems to create indoor cultivation facilities for the commercial horticulture market worldwide. It offers engineering and design services, including cultivation space programming, integrated cultivation design, and full-facility mechanical, electrical, and plumbing engineering; training services ranging from equipment standard operating procedure libraries to staff training sessions; facility and equipment commissioning services; program overview and pricing; and related-party hardware and software platforms. The company also offers an integrated suite of cultivation equipment systems and crop management products, which include environmental controls, fertigation, and irrigation distribution systems; freshwater, wastewater, and condensation treatment systems; light emitting diode, high-pressure sodium, and ceramic metal halide lighting systems; rolltop, multi-tier, and automated container benching systems; odor mitigation and microbial reduction systems; air flow systems; industrial spray applicators; pesticides and bio-controls; plant nutrition products; substrate and coco bag solutions; and Soleil technology data analytics platform that includes wireless environmental and substrate sensing and remote monitoring and support. urban-gro, Inc. was founded in 2014 and is based in Lafayette, Colorado."
UGRO,2018-12-31,NA,-3895873,NA,-3895873,8713509,6158751,-3800584,-3800584,-119961,0,20050776,23851360,13892025,-95289,NA,-3895873,-3895873,NA,income_statement,Farm & Heavy Construction Machinery,"urban-gro, Inc.","urban-gro, Inc. operates as an engineering design services company that integrates complex environmental equipment systems to create indoor cultivation facilities for the commercial horticulture market worldwide. It offers engineering and design services, including cultivation space programming, integrated cultivation design, and full-facility mechanical, electrical, and plumbing engineering; training services ranging from equipment standard operating procedure libraries to staff training sessions; facility and equipment commissioning services; program overview and pricing; and related-party hardware and software platforms. The company also offers an integrated suite of cultivation equipment systems and crop management products, which include environmental controls, fertigation, and irrigation distribution systems; freshwater, wastewater, and condensation treatment systems; light emitting diode, high-pressure sodium, and ceramic metal halide lighting systems; rolltop, multi-tier, and automated container benching systems; odor mitigation and microbial reduction systems; air flow systems; industrial spray applicators; pesticides and bio-controls; plant nutrition products; substrate and coco bag solutions; and Soleil technology data analytics platform that includes wireless environmental and substrate sensing and remote monitoring and support. urban-gro, Inc. was founded in 2014 and is based in Lafayette, Colorado."
UGRO,2019-12-31,NA,-8350573,NA,-8350573,10223810,6626209,-5428027,-5428027,-704230,0,24189803,29617830,17563594,-2922546,NA,-8350573,-8350573,NA,income_statement,Farm & Heavy Construction Machinery,"urban-gro, Inc.","urban-gro, Inc. operates as an engineering design services company that integrates complex environmental equipment systems to create indoor cultivation facilities for the commercial horticulture market worldwide. It offers engineering and design services, including cultivation space programming, integrated cultivation design, and full-facility mechanical, electrical, and plumbing engineering; training services ranging from equipment standard operating procedure libraries to staff training sessions; facility and equipment commissioning services; program overview and pricing; and related-party hardware and software platforms. The company also offers an integrated suite of cultivation equipment systems and crop management products, which include environmental controls, fertigation, and irrigation distribution systems; freshwater, wastewater, and condensation treatment systems; light emitting diode, high-pressure sodium, and ceramic metal halide lighting systems; rolltop, multi-tier, and automated container benching systems; odor mitigation and microbial reduction systems; air flow systems; industrial spray applicators; pesticides and bio-controls; plant nutrition products; substrate and coco bag solutions; and Soleil technology data analytics platform that includes wireless environmental and substrate sensing and remote monitoring and support. urban-gro, Inc. was founded in 2014 and is based in Lafayette, Colorado."
UHAL,2017-03-31,NA,628358000,NA,398424000,902000,1164000000,714073000,714073000,-113406000,229934000,3421767000,2707694000,2257767000,-85715000,NA,398424000,398424000,NA,income_statement,Rental & Leasing Services,Amerco,"AMERCO operates as a do-it-yourself moving and storage operator for household and commercial goods in the United States and Canada. The company's Moving and Storage segment rents trucks, trailers, portable moving and storage units, specialty rental items, and self-storage spaces primarily to the household movers; and sells moving supplies, towing accessories, and propane. It also provides uhaul.com, an online marketplace that connects consumers to independent Moving Help service providers and independent self-storage affiliates; auto transport and tow dolly options to transport vehicles; and specialty boxes for dishes, computers, and sensitive electronic equipment, as well as tapes, security locks, and packing supplies. This segment rents its products and services through a network of approximately 2,065 company operated retail moving stores and 20,100 independent U-Haul dealers. As of March 31, 2020, it had a rental fleet of approximately 176,000 trucks, 127,000 trailers, and 41,000 towing devices; and 1,745 self-storage locations with approximately 774,000 rentable storage units. The company's Property and Casualty Insurance segment offers loss adjusting and claims handling services. It also provides moving and storage protection packages, such as Safemove and Safetow packages, which offer moving and towing customers with a damage waiver, cargo protection, and medical and life insurance coverage; Safestor that protects storage customers from loss on their goods in storage; Safestor Mobile, which protects customers stored belongings; and Safemove Plus, which provides rental customers with a layer of primary liability protection. The company's Life Insurance segment provides life and health insurance products primarily to the senior market through the direct writing and reinsuring of life insurance, medicare supplement, and annuity policies. AMERCO was founded in 1945 and is based in Reno, Nevada."
UHAL,2018-03-31,NA,637613000,NA,790583000,927000,1113079000,568905000,568905000,-126706000,-152970000,3601114000,3032209000,2488035000,68708000,NA,790583000,790583000,NA,income_statement,Rental & Leasing Services,Amerco,"AMERCO operates as a do-it-yourself moving and storage operator for household and commercial goods in the United States and Canada. The company's Moving and Storage segment rents trucks, trailers, portable moving and storage units, specialty rental items, and self-storage spaces primarily to the household movers; and sells moving supplies, towing accessories, and propane. It also provides uhaul.com, an online marketplace that connects consumers to independent Moving Help service providers and independent self-storage affiliates; auto transport and tow dolly options to transport vehicles; and specialty boxes for dishes, computers, and sensitive electronic equipment, as well as tapes, security locks, and packing supplies. This segment rents its products and services through a network of approximately 2,065 company operated retail moving stores and 20,100 independent U-Haul dealers. As of March 31, 2020, it had a rental fleet of approximately 176,000 trucks, 127,000 trailers, and 41,000 towing devices; and 1,745 self-storage locations with approximately 774,000 rentable storage units. The company's Property and Casualty Insurance segment offers loss adjusting and claims handling services. It also provides moving and storage protection packages, such as Safemove and Safetow packages, which offer moving and towing customers with a damage waiver, cargo protection, and medical and life insurance coverage; Safestor that protects storage customers from loss on their goods in storage; Safestor Mobile, which protects customers stored belongings; and Safemove Plus, which provides rental customers with a layer of primary liability protection. The company's Life Insurance segment provides life and health insurance products primarily to the senior market through the direct writing and reinsuring of life insurance, medicare supplement, and annuity policies. AMERCO was founded in 1945 and is based in Reno, Nevada."
UHAL,2019-03-31,NA,477529000,NA,370857000,1013000,1174986000,619930000,619930000,-142445000,106672000,3768707000,3148777000,2593721000,-142401000,NA,370857000,370857000,NA,income_statement,Rental & Leasing Services,Amerco,"AMERCO operates as a do-it-yourself moving and storage operator for household and commercial goods in the United States and Canada. The company's Moving and Storage segment rents trucks, trailers, portable moving and storage units, specialty rental items, and self-storage spaces primarily to the household movers; and sells moving supplies, towing accessories, and propane. It also provides uhaul.com, an online marketplace that connects consumers to independent Moving Help service providers and independent self-storage affiliates; auto transport and tow dolly options to transport vehicles; and specialty boxes for dishes, computers, and sensitive electronic equipment, as well as tapes, security locks, and packing supplies. This segment rents its products and services through a network of approximately 2,065 company operated retail moving stores and 20,100 independent U-Haul dealers. As of March 31, 2020, it had a rental fleet of approximately 176,000 trucks, 127,000 trailers, and 41,000 towing devices; and 1,745 self-storage locations with approximately 774,000 rentable storage units. The company's Property and Casualty Insurance segment offers loss adjusting and claims handling services. It also provides moving and storage protection packages, such as Safemove and Safetow packages, which offer moving and towing customers with a damage waiver, cargo protection, and medical and life insurance coverage; Safestor that protects storage customers from loss on their goods in storage; Safestor Mobile, which protects customers stored belongings; and Safemove Plus, which provides rental customers with a layer of primary liability protection. The company's Life Insurance segment provides life and health insurance products primarily to the senior market through the direct writing and reinsuring of life insurance, medicare supplement, and annuity policies. AMERCO was founded in 1945 and is based in Reno, Nevada."
UHAL,2020-03-31,NA,378124000,NA,442048000,1054000,1176433000,538316000,538316000,-160950000,-63924000,3978868000,3440552000,2802435000,-160192000,NA,442048000,442048000,NA,income_statement,Rental & Leasing Services,Amerco,"AMERCO operates as a do-it-yourself moving and storage operator for household and commercial goods in the United States and Canada. The company's Moving and Storage segment rents trucks, trailers, portable moving and storage units, specialty rental items, and self-storage spaces primarily to the household movers; and sells moving supplies, towing accessories, and propane. It also provides uhaul.com, an online marketplace that connects consumers to independent Moving Help service providers and independent self-storage affiliates; auto transport and tow dolly options to transport vehicles; and specialty boxes for dishes, computers, and sensitive electronic equipment, as well as tapes, security locks, and packing supplies. This segment rents its products and services through a network of approximately 2,065 company operated retail moving stores and 20,100 independent U-Haul dealers. As of March 31, 2020, it had a rental fleet of approximately 176,000 trucks, 127,000 trailers, and 41,000 towing devices; and 1,745 self-storage locations with approximately 774,000 rentable storage units. The company's Property and Casualty Insurance segment offers loss adjusting and claims handling services. It also provides moving and storage protection packages, such as Safemove and Safetow packages, which offer moving and towing customers with a damage waiver, cargo protection, and medical and life insurance coverage; Safestor that protects storage customers from loss on their goods in storage; Safestor Mobile, which protects customers stored belongings; and Safemove Plus, which provides rental customers with a layer of primary liability protection. The company's Life Insurance segment provides life and health insurance products primarily to the senior market through the direct writing and reinsuring of life insurance, medicare supplement, and annuity policies. AMERCO was founded in 1945 and is based in Reno, Nevada."
UHS,2016-12-31,NA,1156358000,73693000,702409000,97324000,4149343000,1281411000,1281411000,-125203000,409187000,9766210000,8484799000,5616867000,-125053000,NA,747171000,702095000,2354000000,income_statement,NA,NA,NA
UHS,2017-12-31,NA,1135009000,68624000,752303000,103127000,4324132000,1280178000,1280178000,-145250000,363697000,10409865000,9129687000,6085733000,-145169000,NA,771312000,751941000,2493062000,income_statement,NA,NA,NA
UHS,2018-12-31,NA,1034525000,80823000,779705000,106094000,4349088000,1228572000,1228572000,-156487000,236642000,10772278000,9543706000,6423190000,-194047000,NA,797883000,778614000,2561377000,income_statement,NA,NA,NA
UHS,2019-12-31,NA,1066337000,79099000,814854000,107809000,4538020000,1313539000,1313539000,-163202000,238794000,11378259000,10064720000,6840239000,-247202000,NA,827543000,812826000,2626280000,income_statement,NA,NA,NA
UIHC,2016-12-31,NA,7003000,20139000,5698000,63256000,71106000,7850000,7850000,-723000,1305000,487117000,479267000,416011000,-847000,NA,5698000,5698000,NA,income_statement,Insurance—Property & Casualty,United Insurance Holdings Corp.,"United Insurance Holdings Corp. operates as a property and casualty insurance holding company that sources, writes, and services residential personal and commercial property, and casualty insurance policies in the United States. The company offers structure, content, and liability coverage for standard single-family homeowners, renters, and condominium unit owners, as well as dwelling fire policies. It also provides commercial multi-peril property insurance for residential condominium associations, as well as loss or damage to buildings, inventory, and equipment caused by fire, wind, hail, water, theft, and vandalism. In addition, the company offers flood, equipment breakdown, and identity theft policies; and inland flood and cyber security insurance. It markets and distributes its products through a network of independent agencies in Connecticut, Florida, Georgia, Hawaii, Louisiana, Massachusetts, New Jersey, New York, North Carolina, Rhode Island, South Carolina, and Texas. United Insurance Holdings Corp. was founded in 1999 and is headquartered in St. Petersburg, Florida."
UIHC,2017-12-31,NA,910000,20139000,10145000,102437000,113441000,11004000,11004000,-3247000,-9235000,654420000,643416000,540979000,-10094000,NA,10145000,10145000,NA,income_statement,Insurance—Property & Casualty,United Insurance Holdings Corp.,"United Insurance Holdings Corp. operates as a property and casualty insurance holding company that sources, writes, and services residential personal and commercial property, and casualty insurance policies in the United States. The company offers structure, content, and liability coverage for standard single-family homeowners, renters, and condominium unit owners, as well as dwelling fire policies. It also provides commercial multi-peril property insurance for residential condominium associations, as well as loss or damage to buildings, inventory, and equipment caused by fire, wind, hail, water, theft, and vandalism. In addition, the company offers flood, equipment breakdown, and identity theft policies; and inland flood and cyber security insurance. It markets and distributes its products through a network of independent agencies in Connecticut, Florida, Georgia, Hawaii, Louisiana, Massachusetts, New Jersey, New York, North Carolina, Rhode Island, South Carolina, and Texas. United Insurance Holdings Corp. was founded in 1999 and is headquartered in St. Petersburg, Florida."
UIHC,2018-12-31,NA,-4239000,20139000,290000,106702000,112213000,5511000,5511000,-9866000,-4633000,723942000,718431000,611729000,-9750000,NA,394000,290000,NA,income_statement,Insurance—Property & Casualty,United Insurance Holdings Corp.,"United Insurance Holdings Corp. operates as a property and casualty insurance holding company that sources, writes, and services residential personal and commercial property, and casualty insurance policies in the United States. The company offers structure, content, and liability coverage for standard single-family homeowners, renters, and condominium unit owners, as well as dwelling fire policies. It also provides commercial multi-peril property insurance for residential condominium associations, as well as loss or damage to buildings, inventory, and equipment caused by fire, wind, hail, water, theft, and vandalism. In addition, the company offers flood, equipment breakdown, and identity theft policies; and inland flood and cyber security insurance. It markets and distributes its products through a network of independent agencies in Connecticut, Florida, Georgia, Hawaii, Louisiana, Massachusetts, New Jersey, New York, North Carolina, Rhode Island, South Carolina, and Texas. United Insurance Holdings Corp. was founded in 1999 and is headquartered in St. Petersburg, Florida."
UIHC,2019-12-31,NA,-32606000,20727000,-29872000,110299000,87355000,-22944000,-22944000,-9781000,-3121000,825116000,848060000,737761000,-9662000,NA,-29485000,-29872000,NA,income_statement,Insurance—Property & Casualty,United Insurance Holdings Corp.,"United Insurance Holdings Corp. operates as a property and casualty insurance holding company that sources, writes, and services residential personal and commercial property, and casualty insurance policies in the United States. The company offers structure, content, and liability coverage for standard single-family homeowners, renters, and condominium unit owners, as well as dwelling fire policies. It also provides commercial multi-peril property insurance for residential condominium associations, as well as loss or damage to buildings, inventory, and equipment caused by fire, wind, hail, water, theft, and vandalism. In addition, the company offers flood, equipment breakdown, and identity theft policies; and inland flood and cyber security insurance. It markets and distributes its products through a network of independent agencies in Connecticut, Florida, Georgia, Hawaii, Louisiana, Massachusetts, New Jersey, New York, North Carolina, Rhode Island, South Carolina, and Texas. United Insurance Holdings Corp. was founded in 1999 and is headquartered in St. Petersburg, Florida."
UK,2017-12-31,NA,-372815000,1359000,-355753000,117846000,-143028000,-284933000,-284933000,-78000,61000,167394000,452327000,310422000,-87882000,NA,-372876000,-355753000,NA,income_statement,Real Estate Services,Ucommune International Ltd,"Ucommune Group Holdings Limited engages in the long-term, on-demand, and short-term leasing of office spaces to freelancers, start-up entrepreneurs, small and medium enterprises, and corporations. The company also offers space design and build services, as well as management services to develop and manage office spaces for landlords. In addition, pal actit offers U Plus services, including individual services, such as catering, fitness, healthcare, training, and entertainment services; general corporate services, such as corporate secretary, human resources, legal, finance, IT support, and tax services; incubation and corporate venturing services; advertising and branding services; and community services. As of September 30, 2020, the company operated 158 spaces with approximately 58,000 workstations in the People's Republic of China. Further, it offers marketing services; interior design and construction services; and technology and Internet services. Ucommune Group Holdings Limited was founded in 2015 and is based in Beijing, the People's Republic of China."
UK,2018-12-31,NA,-443068000,198357000,-429592000,163581000,-215101000,-398847000,-398847000,-9902000,2087000,448508000,847355000,663609000,-44221000,NA,-445155000,-429592000,NA,income_statement,Real Estate Services,Ucommune International Ltd,"Ucommune Group Holdings Limited engages in the long-term, on-demand, and short-term leasing of office spaces to freelancers, start-up entrepreneurs, small and medium enterprises, and corporations. The company also offers space design and build services, as well as management services to develop and manage office spaces for landlords. In addition, pal actit offers U Plus services, including individual services, such as catering, fitness, healthcare, training, and entertainment services; general corporate services, such as corporate secretary, human resources, legal, finance, IT support, and tax services; incubation and corporate venturing services; advertising and branding services; and community services. As of September 30, 2020, the company operated 158 spaces with approximately 58,000 workstations in the People's Republic of China. Further, it offers marketing services; interior design and construction services; and technology and Internet services. Ucommune Group Holdings Limited was founded in 2015 and is based in Beijing, the People's Republic of China."
UK,2019-12-31,NA,-801801000,205975000,-791150000,257423000,-202034000,-474581000,-474581000,-16346000,4872000,1167358000,1641939000,1369392000,-327220000,NA,-806673000,-791150000,NA,income_statement,Real Estate Services,Ucommune International Ltd,"Ucommune Group Holdings Limited engages in the long-term, on-demand, and short-term leasing of office spaces to freelancers, start-up entrepreneurs, small and medium enterprises, and corporations. The company also offers space design and build services, as well as management services to develop and manage office spaces for landlords. In addition, pal actit offers U Plus services, including individual services, such as catering, fitness, healthcare, training, and entertainment services; general corporate services, such as corporate secretary, human resources, legal, finance, IT support, and tax services; incubation and corporate venturing services; advertising and branding services; and community services. As of September 30, 2020, the company operated 158 spaces with approximately 58,000 workstations in the People's Republic of China. Further, it offers marketing services; interior design and construction services; and technology and Internet services. Ucommune Group Holdings Limited was founded in 2015 and is based in Beijing, the People's Republic of China."
ULBI,2017-12-31,4737000,6295000,-154000,7648000,15019000,26232000,6476000,6476000,-183000,-1369000,85531000,79055000,59299000,-181000,NA,7664000,7648000,NA,income_statement,Specialty Industrial Machinery,Ultralife Corporation,"Ultralife Corporation, together with its subsidiaries, designs, manufactures, installs, and maintains power, and communication and electronics systems worldwide. The company serves government, defense, and commercial sectors. The company operates in two segments, Battery & Energy Products and Communications Systems. The Battery & Energy Products segment offers lithium 9-volt, cylindrical, thin lithium manganese dioxide, rechargeable, and other non-rechargeable batteries; lithium-ion cells, multi-kilowatt module lithium ion battery systems, and uninterruptable power supplies; and rugged military and commercial battery charging systems and accessories, including smart chargers, multi-bay charging systems, and various cables. The Communications Systems segment provides communications systems and accessories to support military communications systems, such as radio frequency amplifiers, power supplies and cables, connector assemblies, amplified speakers, equipment mounts, case equipment, man-portable systems, and integrated communication systems for fixed or vehicle applications comprising vehicle adapters, vehicle installed power enhanced rifleman appliquÃ© systems, and SATCOM systems. This segment's military communications systems and accessories are designed to enhance and extend the operation of communications equipment, such as vehicle-mounted, manpack, and handheld transceivers. It sells its products under the Ultralife, Lithium Power, McDowell Research, AMTI, ABLE, ACCUTRONICS, ACCUPRO, ENTELLION, SWE Southwest Electronic Energy Group, SWE DRILL-DATA, and SWE SEASAFE brands through original equipment manufacturers, and industrial and defense supply distributors, as well as directly to the United States and international defense departments. In addition, the company sells its 9-volt battery to the broader consumer market through national and regional retail chains and online retailers. The company was founded in 1990 and is headquartered in Newark, New York."
ULBI,2018-12-31,4508000,6613000,-85000,24930000,14520000,25583000,6555000,6555000,-63000,-18386000,87190000,80635000,61607000,58000,NA,24999000,24930000,NA,income_statement,Specialty Industrial Machinery,Ultralife Corporation,"Ultralife Corporation, together with its subsidiaries, designs, manufactures, installs, and maintains power, and communication and electronics systems worldwide. The company serves government, defense, and commercial sectors. The company operates in two segments, Battery & Energy Products and Communications Systems. The Battery & Energy Products segment offers lithium 9-volt, cylindrical, thin lithium manganese dioxide, rechargeable, and other non-rechargeable batteries; lithium-ion cells, multi-kilowatt module lithium ion battery systems, and uninterruptable power supplies; and rugged military and commercial battery charging systems and accessories, including smart chargers, multi-bay charging systems, and various cables. The Communications Systems segment provides communications systems and accessories to support military communications systems, such as radio frequency amplifiers, power supplies and cables, connector assemblies, amplified speakers, equipment mounts, case equipment, man-portable systems, and integrated communication systems for fixed or vehicle applications comprising vehicle adapters, vehicle installed power enhanced rifleman appliquÃ© systems, and SATCOM systems. This segment's military communications systems and accessories are designed to enhance and extend the operation of communications equipment, such as vehicle-mounted, manpack, and handheld transceivers. It sells its products under the Ultralife, Lithium Power, McDowell Research, AMTI, ABLE, ACCUTRONICS, ACCUPRO, ENTELLION, SWE Southwest Electronic Energy Group, SWE DRILL-DATA, and SWE SEASAFE brands through original equipment manufacturers, and industrial and defense supply distributors, as well as directly to the United States and international defense departments. In addition, the company sells its 9-volt battery to the broader consumer market through national and regional retail chains and online retailers. The company was founded in 1990 and is headquartered in Newark, New York."
ULBI,2019-12-31,6805000,6771000,24000,5205000,16992000,31429000,7632000,7632000,-382000,1457000,106795000,99163000,75366000,-861000,NA,5314000,5205000,NA,income_statement,Specialty Industrial Machinery,Ultralife Corporation,"Ultralife Corporation, together with its subsidiaries, designs, manufactures, installs, and maintains power, and communication and electronics systems worldwide. The company serves government, defense, and commercial sectors. The company operates in two segments, Battery & Energy Products and Communications Systems. The Battery & Energy Products segment offers lithium 9-volt, cylindrical, thin lithium manganese dioxide, rechargeable, and other non-rechargeable batteries; lithium-ion cells, multi-kilowatt module lithium ion battery systems, and uninterruptable power supplies; and rugged military and commercial battery charging systems and accessories, including smart chargers, multi-bay charging systems, and various cables. The Communications Systems segment provides communications systems and accessories to support military communications systems, such as radio frequency amplifiers, power supplies and cables, connector assemblies, amplified speakers, equipment mounts, case equipment, man-portable systems, and integrated communication systems for fixed or vehicle applications comprising vehicle adapters, vehicle installed power enhanced rifleman appliquÃ© systems, and SATCOM systems. This segment's military communications systems and accessories are designed to enhance and extend the operation of communications equipment, such as vehicle-mounted, manpack, and handheld transceivers. It sells its products under the Ultralife, Lithium Power, McDowell Research, AMTI, ABLE, ACCUTRONICS, ACCUPRO, ENTELLION, SWE Southwest Electronic Energy Group, SWE DRILL-DATA, and SWE SEASAFE brands through original equipment manufacturers, and industrial and defense supply distributors, as well as directly to the United States and international defense departments. In addition, the company sells its 9-volt battery to the broader consumer market through national and regional retail chains and online retailers. The company was founded in 1990 and is headquartered in Newark, New York."
ULBI,2020-12-31,5947000,7023000,123000,5232000,17511000,29159000,5701000,5701000,-436000,1692000,107712000,102011000,78553000,1322000,NA,5331000,5232000,NA,income_statement,Specialty Industrial Machinery,Ultralife Corporation,"Ultralife Corporation, together with its subsidiaries, designs, manufactures, installs, and maintains power, and communication and electronics systems worldwide. The company serves government, defense, and commercial sectors. The company operates in two segments, Battery & Energy Products and Communications Systems. The Battery & Energy Products segment offers lithium 9-volt, cylindrical, thin lithium manganese dioxide, rechargeable, and other non-rechargeable batteries; lithium-ion cells, multi-kilowatt module lithium ion battery systems, and uninterruptable power supplies; and rugged military and commercial battery charging systems and accessories, including smart chargers, multi-bay charging systems, and various cables. The Communications Systems segment provides communications systems and accessories to support military communications systems, such as radio frequency amplifiers, power supplies and cables, connector assemblies, amplified speakers, equipment mounts, case equipment, man-portable systems, and integrated communication systems for fixed or vehicle applications comprising vehicle adapters, vehicle installed power enhanced rifleman appliquÃ© systems, and SATCOM systems. This segment's military communications systems and accessories are designed to enhance and extend the operation of communications equipment, such as vehicle-mounted, manpack, and handheld transceivers. It sells its products under the Ultralife, Lithium Power, McDowell Research, AMTI, ABLE, ACCUTRONICS, ACCUPRO, ENTELLION, SWE Southwest Electronic Energy Group, SWE DRILL-DATA, and SWE SEASAFE brands through original equipment manufacturers, and industrial and defense supply distributors, as well as directly to the United States and international defense departments. In addition, the company sells its 9-volt battery to the broader consumer market through national and regional retail chains and online retailers. The company was founded in 1990 and is headquartered in Newark, New York."
ULH,2017-12-31,NA,17141000,NA,28153000,91012000,178821000,40814000,40814000,-9538000,-11012000,1216665000,1175851000,1037844000,-23673000,NA,28153000,28153000,NA,income_statement,Trucking,"Universal Logistics Holdings, I","Universal Logistics Holdings, Inc. provides transportation and logistics solutions in the United States, Mexico, Canada, and Colombia. It offers truckload services, which include dry van, flatbed, heavy-haul, and refrigerated operations; domestic and international freight forwarding, and customs brokerage services; and final mile and ground expedite services. The company transports various commodities comprising automotive parts, machinery, building materials, paper, food, consumer goods, furniture, steel, and other metals. It also provides value-added services for individual customer requirements, including material handling, consolidation, sequencing, sub-assembly, cross-dock, kitting, repacking, warehousing, and returnable container management; and intermodal support services comprising short-to-medium distance delivery of steamship and rail truck containers between the port or railhead, and the customer and drayage services. Universal Logistics Holdings, Inc. serves automotive, steel, oil and gas, alternative energy, and manufacturing industries, as well as other transportation companies who aggregate loads from various shippers. The company was formerly known as Universal Truckload Services, Inc. and changed its name to Universal Logistics Holdings, Inc. in April 2016. Universal Logistics Holdings, Inc. was founded in 1932 and is headquartered in Warren, Michigan."
ULH,2018-12-31,NA,69389000,NA,52178000,88879000,237598000,94294000,94294000,-14669000,17211000,1461708000,1367414000,1224110000,-24905000,NA,52178000,52178000,NA,income_statement,Trucking,"Universal Logistics Holdings, I","Universal Logistics Holdings, Inc. provides transportation and logistics solutions in the United States, Mexico, Canada, and Colombia. It offers truckload services, which include dry van, flatbed, heavy-haul, and refrigerated operations; domestic and international freight forwarding, and customs brokerage services; and final mile and ground expedite services. The company transports various commodities comprising automotive parts, machinery, building materials, paper, food, consumer goods, furniture, steel, and other metals. It also provides value-added services for individual customer requirements, including material handling, consolidation, sequencing, sub-assembly, cross-dock, kitting, repacking, warehousing, and returnable container management; and intermodal support services comprising short-to-medium distance delivery of steamship and rail truck containers between the port or railhead, and the customer and drayage services. Universal Logistics Holdings, Inc. serves automotive, steel, oil and gas, alternative energy, and manufacturing industries, as well as other transportation companies who aggregate loads from various shippers. The company was formerly known as Universal Truckload Services, Inc. and changed its name to Universal Logistics Holdings, Inc. in April 2016. Universal Logistics Holdings, Inc. was founded in 1932 and is headquartered in Warren, Michigan."
ULH,2019-12-31,NA,50186000,NA,37586000,98319000,263264000,90180000,90180000,-17085000,12600000,1511998000,1421818000,1248734000,-39994000,NA,37586000,37586000,NA,income_statement,Trucking,"Universal Logistics Holdings, I","Universal Logistics Holdings, Inc. provides transportation and logistics solutions in the United States, Mexico, Canada, and Colombia. It offers truckload services, which include dry van, flatbed, heavy-haul, and refrigerated operations; domestic and international freight forwarding, and customs brokerage services; and final mile and ground expedite services. The company transports various commodities comprising automotive parts, machinery, building materials, paper, food, consumer goods, furniture, steel, and other metals. It also provides value-added services for individual customer requirements, including material handling, consolidation, sequencing, sub-assembly, cross-dock, kitting, repacking, warehousing, and returnable container management; and intermodal support services comprising short-to-medium distance delivery of steamship and rail truck containers between the port or railhead, and the customer and drayage services. Universal Logistics Holdings, Inc. serves automotive, steel, oil and gas, alternative energy, and manufacturing industries, as well as other transportation companies who aggregate loads from various shippers. The company was formerly known as Universal Truckload Services, Inc. and changed its name to Universal Logistics Holdings, Inc. in April 2016. Universal Logistics Holdings, Inc. was founded in 1932 and is headquartered in Warren, Michigan."
ULH,2020-12-31,NA,63910000,NA,48132000,79180000,233680000,80359000,80359000,-14579000,15778000,1391083000,1310724000,1157403000,-16449000,NA,48132000,48132000,NA,income_statement,Trucking,"Universal Logistics Holdings, I","Universal Logistics Holdings, Inc. provides transportation and logistics solutions in the United States, Mexico, Canada, and Colombia. It offers truckload services, which include dry van, flatbed, heavy-haul, and refrigerated operations; domestic and international freight forwarding, and customs brokerage services; and final mile and ground expedite services. The company transports various commodities comprising automotive parts, machinery, building materials, paper, food, consumer goods, furniture, steel, and other metals. It also provides value-added services for individual customer requirements, including material handling, consolidation, sequencing, sub-assembly, cross-dock, kitting, repacking, warehousing, and returnable container management; and intermodal support services comprising short-to-medium distance delivery of steamship and rail truck containers between the port or railhead, and the customer and drayage services. Universal Logistics Holdings, Inc. serves automotive, steel, oil and gas, alternative energy, and manufacturing industries, as well as other transportation companies who aggregate loads from various shippers. The company was formerly known as Universal Truckload Services, Inc. and changed its name to Universal Logistics Holdings, Inc. in April 2016. Universal Logistics Holdings, Inc. was founded in 1932 and is headquartered in Warren, Michigan."
ULTA,2017-01-28,NA,655714000,NA,409760000,1073834000,1747229000,654824000,654824000,NA,245954000,4854737000,4199913000,3107508000,890000,NA,409760000,409760000,NA,income_statement,NA,NA,NA
ULTA,2018-02-03,NA,786859000,NA,555234000,1287232000,2096809000,785291000,785291000,NA,231625000,5884506000,5099215000,3787697000,1568000,NA,555234000,555234000,NA,income_statement,NA,NA,NA
ULTA,2019-02-02,NA,859141000,NA,658559000,1535464000,2409311000,854080000,854080000,NA,200582000,6716615000,5862535000,4307304000,5061000,NA,658559000,658559000,NA,income_statement,NA,NA,NA
ULTA,2020-02-01,NA,906150000,NA,705945000,2078777000,2999125000,901094000,901094000,NA,200205000,7398068000,6496974000,4398943000,5056000,NA,705945000,705945000,NA,income_statement,NA,NA,NA
UMBF,2017-12-31,NA,236346000,NA,247105000,634679000,941475000,0,259199000,NA,53370000,941475000,682276000,0,-22853000,64129000,182976000,247105000,47597000,income_statement,Banks—Regional,UMB Financial Corporation,"UMB Financial Corporation operates as the bank holding company for the UMB Bank that provides various banking and other financial services. The company operates through four segments: Commercial Banking, Institutional Banking, Personal Banking, and Healthcare Services. The Commercial Banking segment provides commercial loans and credit cards, letters of credit; loan syndication, consultative services, and various financial options; capital markets services, including asset-based financing, asset securitization, equity and mezzanine financing, factoring, and private and public placement of senior debt, as well as merger and acquisition consulting; and depository, account reconciliation, electronic fund transfer, controlled disbursements, lockbox, and remote deposit capture services. The Institutional Banking segment offers bond trading transactions, cash letter collections, investment portfolio accounting and safekeeping, asset/liability management reporting, and federal funds transactions; and fund administration and accounting, investor services and transfer agency, marketing and distribution, custody, and alternative investment services. The Personal Banking segment provides deposit accounts, retail credit cards, installment loans, home equity lines of credit, residential mortgages, and small business loans, as well as call center, internet banking and ATM network, private banking, brokerage, insurance, investment advisory, trust, and custody services. The Healthcare Services segment offers healthcare payment solutions comprising custodial services for health savings accounts, as well as private label and multipurpose debit cards. The company operates through a network of branches and offices in the states of Missouri, Kansas, Colorado, Illinois, Oklahoma, Texas, Arizona, Nebraska, Iowa, Pennsylvania, South Dakota, Indiana, Utah, Minnesota, California, and Wisconsin. UMB Financial Corporation was founded in 1913 and is headquartered in Kansas City, Missouri."
UMBF,2018-12-31,NA,223594000,NA,195513000,656825000,941394000,0,242053000,NA,27334000,941394000,699341000,0,-18459000,-747000,196260000,195513000,42516000,income_statement,Banks—Regional,UMB Financial Corporation,"UMB Financial Corporation operates as the bank holding company for the UMB Bank that provides various banking and other financial services. The company operates through four segments: Commercial Banking, Institutional Banking, Personal Banking, and Healthcare Services. The Commercial Banking segment provides commercial loans and credit cards, letters of credit; loan syndication, consultative services, and various financial options; capital markets services, including asset-based financing, asset securitization, equity and mezzanine financing, factoring, and private and public placement of senior debt, as well as merger and acquisition consulting; and depository, account reconciliation, electronic fund transfer, controlled disbursements, lockbox, and remote deposit capture services. The Institutional Banking segment offers bond trading transactions, cash letter collections, investment portfolio accounting and safekeeping, asset/liability management reporting, and federal funds transactions; and fund administration and accounting, investor services and transfer agency, marketing and distribution, custody, and alternative investment services. The Personal Banking segment provides deposit accounts, retail credit cards, installment loans, home equity lines of credit, residential mortgages, and small business loans, as well as call center, internet banking and ATM network, private banking, brokerage, insurance, investment advisory, trust, and custody services. The Healthcare Services segment offers healthcare payment solutions comprising custodial services for health savings accounts, as well as private label and multipurpose debit cards. The company operates through a network of branches and offices in the states of Missouri, Kansas, Colorado, Illinois, Oklahoma, Texas, Arizona, Nebraska, Iowa, Pennsylvania, South Dakota, Indiana, Utah, Minnesota, California, and Wisconsin. UMB Financial Corporation was founded in 1913 and is headquartered in Kansas City, Missouri."
UMBF,2019-12-31,NA,285965000,NA,243600000,716960000,1064825000,0,302960000,NA,42365000,1064825000,761865000,0,-16995000,NA,243600000,243600000,44905000,income_statement,Banks—Regional,UMB Financial Corporation,"UMB Financial Corporation operates as the bank holding company for the UMB Bank that provides various banking and other financial services. The company operates through four segments: Commercial Banking, Institutional Banking, Personal Banking, and Healthcare Services. The Commercial Banking segment provides commercial loans and credit cards, letters of credit; loan syndication, consultative services, and various financial options; capital markets services, including asset-based financing, asset securitization, equity and mezzanine financing, factoring, and private and public placement of senior debt, as well as merger and acquisition consulting; and depository, account reconciliation, electronic fund transfer, controlled disbursements, lockbox, and remote deposit capture services. The Institutional Banking segment offers bond trading transactions, cash letter collections, investment portfolio accounting and safekeeping, asset/liability management reporting, and federal funds transactions; and fund administration and accounting, investor services and transfer agency, marketing and distribution, custody, and alternative investment services. The Personal Banking segment provides deposit accounts, retail credit cards, installment loans, home equity lines of credit, residential mortgages, and small business loans, as well as call center, internet banking and ATM network, private banking, brokerage, insurance, investment advisory, trust, and custody services. The Healthcare Services segment offers healthcare payment solutions comprising custodial services for health savings accounts, as well as private label and multipurpose debit cards. The company operates through a network of branches and offices in the states of Missouri, Kansas, Colorado, Illinois, Oklahoma, Texas, Arizona, Nebraska, Iowa, Pennsylvania, South Dakota, Indiana, Utah, Minnesota, California, and Wisconsin. UMB Financial Corporation was founded in 1913 and is headquartered in Kansas City, Missouri."
UMBF,2020-12-31,NA,338890000,NA,286502000,742853000,1160895000,0,355686000,NA,52388000,1160895000,805209000,0,-16796000,NA,286502000,286502000,62356000,income_statement,Banks—Regional,UMB Financial Corporation,"UMB Financial Corporation operates as the bank holding company for the UMB Bank that provides various banking and other financial services. The company operates through four segments: Commercial Banking, Institutional Banking, Personal Banking, and Healthcare Services. The Commercial Banking segment provides commercial loans and credit cards, letters of credit; loan syndication, consultative services, and various financial options; capital markets services, including asset-based financing, asset securitization, equity and mezzanine financing, factoring, and private and public placement of senior debt, as well as merger and acquisition consulting; and depository, account reconciliation, electronic fund transfer, controlled disbursements, lockbox, and remote deposit capture services. The Institutional Banking segment offers bond trading transactions, cash letter collections, investment portfolio accounting and safekeeping, asset/liability management reporting, and federal funds transactions; and fund administration and accounting, investor services and transfer agency, marketing and distribution, custody, and alternative investment services. The Personal Banking segment provides deposit accounts, retail credit cards, installment loans, home equity lines of credit, residential mortgages, and small business loans, as well as call center, internet banking and ATM network, private banking, brokerage, insurance, investment advisory, trust, and custody services. The Healthcare Services segment offers healthcare payment solutions comprising custodial services for health savings accounts, as well as private label and multipurpose debit cards. The company operates through a network of branches and offices in the states of Missouri, Kansas, Colorado, Illinois, Oklahoma, Texas, Arizona, Nebraska, Iowa, Pennsylvania, South Dakota, Indiana, Utah, Minnesota, California, and Wisconsin. UMB Financial Corporation was founded in 1913 and is headquartered in Kansas City, Missouri."
UMPQ,2017-12-31,NA,349043000,NA,242313000,661877000,1096918000,0,379580000,NA,106730000,1096918000,717338000,0,-30537000,NA,242313000,242313000,55461000,income_statement,Banks—Regional,Umpqua Holdings Corporation,"Umpqua Holdings Corporation operates as the holding company of Umpqua Bank that provides commercial and retail banking, and retail brokerage services. It operates through four segments: Wholesale Bank, Wealth Management, Retail Bank, and Home Lending. The company offers deposit products, including non-interest bearing checking, interest bearing checking and savings, and money market accounts, as well as certificates of deposit. It also provides loans for corporate and commercial customers, such as accounts receivable and inventory financing, multi-family and equipment loans, commercial equipment leases, international trade, real estate construction loans, permanent financing products, and small business administration program financing, as well as capital markets and treasury management services. In addition, the company offers loan products for small businesses; commercial and industrial loans; residential real estate loans for the construction, purchase, and refinancing of residential owner-occupied and rental properties; and consumer loans comprising secured and unsecured personal loans, home equity and personal lines of credit, and motor vehicle loans. Further, it provides financial planning, trust, and investment services; treasury and cash management services; retail brokerage and investment advisory services; digital, mobile, telephone, text, and online banking services; and e-commerce services. The company serves middle market corporate, commercial, and business banking customers; individual investors; and high net worth individuals. As of December 31, 2019, it conducted commercial and retail banking activities at 274 locations in Oregon, Washington, California, Idaho, and Nevada. The company was founded in 1953 and is headquartered in Portland, Oregon."
UMPQ,2018-12-31,NA,422686000,NA,316263000,665575000,1162151000,0,445813000,NA,106423000,1162151000,716338000,0,-28727000,NA,316263000,316263000,50763000,income_statement,Banks—Regional,Umpqua Holdings Corporation,"Umpqua Holdings Corporation operates as the holding company of Umpqua Bank that provides commercial and retail banking, and retail brokerage services. It operates through four segments: Wholesale Bank, Wealth Management, Retail Bank, and Home Lending. The company offers deposit products, including non-interest bearing checking, interest bearing checking and savings, and money market accounts, as well as certificates of deposit. It also provides loans for corporate and commercial customers, such as accounts receivable and inventory financing, multi-family and equipment loans, commercial equipment leases, international trade, real estate construction loans, permanent financing products, and small business administration program financing, as well as capital markets and treasury management services. In addition, the company offers loan products for small businesses; commercial and industrial loans; residential real estate loans for the construction, purchase, and refinancing of residential owner-occupied and rental properties; and consumer loans comprising secured and unsecured personal loans, home equity and personal lines of credit, and motor vehicle loans. Further, it provides financial planning, trust, and investment services; treasury and cash management services; retail brokerage and investment advisory services; digital, mobile, telephone, text, and online banking services; and e-commerce services. The company serves middle market corporate, commercial, and business banking customers; individual investors; and high net worth individuals. As of December 31, 2019, it conducted commercial and retail banking activities at 274 locations in Oregon, Washington, California, Idaho, and Nevada. The company was founded in 1953 and is headquartered in Portland, Oregon."
UMPQ,2019-12-31,NA,468903000,NA,354095000,646558000,1187943000,0,489617000,NA,114808000,1187943000,698326000,0,-20714000,NA,354095000,354095000,51768000,income_statement,Banks—Regional,Umpqua Holdings Corporation,"Umpqua Holdings Corporation operates as the holding company of Umpqua Bank that provides commercial and retail banking, and retail brokerage services. It operates through four segments: Wholesale Bank, Wealth Management, Retail Bank, and Home Lending. The company offers deposit products, including non-interest bearing checking, interest bearing checking and savings, and money market accounts, as well as certificates of deposit. It also provides loans for corporate and commercial customers, such as accounts receivable and inventory financing, multi-family and equipment loans, commercial equipment leases, international trade, real estate construction loans, permanent financing products, and small business administration program financing, as well as capital markets and treasury management services. In addition, the company offers loan products for small businesses; commercial and industrial loans; residential real estate loans for the construction, purchase, and refinancing of residential owner-occupied and rental properties; and consumer loans comprising secured and unsecured personal loans, home equity and personal lines of credit, and motor vehicle loans. Further, it provides financial planning, trust, and investment services; treasury and cash management services; retail brokerage and investment advisory services; digital, mobile, telephone, text, and online banking services; and e-commerce services. The company serves middle market corporate, commercial, and business banking customers; individual investors; and high net worth individuals. As of December 31, 2019, it conducted commercial and retail banking activities at 274 locations in Oregon, Washington, California, Idaho, and Nevada. The company was founded in 1953 and is headquartered in Portland, Oregon."
UMPQ,2020-12-31,NA,-1456420000,NA,-1523420000,630897000,1089667000,0,346018000,NA,67000000,1089667000,743649000,0,-1802438000,NA,-1523420000,-1523420000,112752000,income_statement,Banks—Regional,Umpqua Holdings Corporation,"Umpqua Holdings Corporation operates as the holding company of Umpqua Bank that provides commercial and retail banking, and retail brokerage services. It operates through four segments: Wholesale Bank, Wealth Management, Retail Bank, and Home Lending. The company offers deposit products, including non-interest bearing checking, interest bearing checking and savings, and money market accounts, as well as certificates of deposit. It also provides loans for corporate and commercial customers, such as accounts receivable and inventory financing, multi-family and equipment loans, commercial equipment leases, international trade, real estate construction loans, permanent financing products, and small business administration program financing, as well as capital markets and treasury management services. In addition, the company offers loan products for small businesses; commercial and industrial loans; residential real estate loans for the construction, purchase, and refinancing of residential owner-occupied and rental properties; and consumer loans comprising secured and unsecured personal loans, home equity and personal lines of credit, and motor vehicle loans. Further, it provides financial planning, trust, and investment services; treasury and cash management services; retail brokerage and investment advisory services; digital, mobile, telephone, text, and online banking services; and e-commerce services. The company serves middle market corporate, commercial, and business banking customers; individual investors; and high net worth individuals. As of December 31, 2019, it conducted commercial and retail banking activities at 274 locations in Oregon, Washington, California, Idaho, and Nevada. The company was founded in 1953 and is headquartered in Portland, Oregon."
UNAM,2016-12-31,NA,-2114238,NA,-1404277,4926652,5384152,-2114238,-2114238,NA,-709961,35267724,37381962,29883572,0,NA,-1404277,-1404277,2571738,income_statement,Insurance—Property & Casualty,Unico American Corporation,"Unico American Corporation, through its subsidiaries, underwrites property and casualty insurance in Arizona, California, Nevada, Oregon, and Washington. It provides property, casualty, health, and life insurance products, as well as insurance premium financing and membership association services. The company's commercial property coverage insures against loss or damage to buildings, inventory, and equipment from natural disasters, including hurricanes, windstorms, hail, water, explosions, and severe winter weather, as well as other events, such as theft and vandalism, fires, storms, and financial loss due to business interruption resulting from covered property damage. It also provides commercial liability coverage that insures against third party liability from accidents occurring on the insured's premises or arising out of its operation; and writes policies to insure commercial property and commercial liability risks on a mono-line basis. In addition, the company offers group dental and vision insurance policies, as well as health and life insurance for individuals and groups. Unico American Corporation markets its insurance products primarily through a network of independent brokers and agents. The company was founded in 1969 and is headquartered in Calabasas, California."
UNAM,2017-12-31,NA,-9880221,NA,-8724984,5843714,-329342,-9880221,-9880221,NA,-1155237,36791482,46671703,37120824,0,NA,-8724984,-8724984,3707165,income_statement,Insurance—Property & Casualty,Unico American Corporation,"Unico American Corporation, through its subsidiaries, underwrites property and casualty insurance in Arizona, California, Nevada, Oregon, and Washington. It provides property, casualty, health, and life insurance products, as well as insurance premium financing and membership association services. The company's commercial property coverage insures against loss or damage to buildings, inventory, and equipment from natural disasters, including hurricanes, windstorms, hail, water, explosions, and severe winter weather, as well as other events, such as theft and vandalism, fires, storms, and financial loss due to business interruption resulting from covered property damage. It also provides commercial liability coverage that insures against third party liability from accidents occurring on the insured's premises or arising out of its operation; and writes policies to insure commercial property and commercial liability risks on a mono-line basis. In addition, the company offers group dental and vision insurance policies, as well as health and life insurance for individuals and groups. Unico American Corporation markets its insurance products primarily through a network of independent brokers and agents. The company was founded in 1969 and is headquartered in Calabasas, California."
UNAM,2018-12-31,NA,-3926792,NA,-3169559,4592841,3969521,-3926792,-3926792,NA,-757233,33612796,37539588,29643275,0,NA,-3169559,-3169559,3303472,income_statement,Insurance—Property & Casualty,Unico American Corporation,"Unico American Corporation, through its subsidiaries, underwrites property and casualty insurance in Arizona, California, Nevada, Oregon, and Washington. It provides property, casualty, health, and life insurance products, as well as insurance premium financing and membership association services. The company's commercial property coverage insures against loss or damage to buildings, inventory, and equipment from natural disasters, including hurricanes, windstorms, hail, water, explosions, and severe winter weather, as well as other events, such as theft and vandalism, fires, storms, and financial loss due to business interruption resulting from covered property damage. It also provides commercial liability coverage that insures against third party liability from accidents occurring on the insured's premises or arising out of its operation; and writes policies to insure commercial property and commercial liability risks on a mono-line basis. In addition, the company offers group dental and vision insurance policies, as well as health and life insurance for individuals and groups. Unico American Corporation markets its insurance products primarily through a network of independent brokers and agents. The company was founded in 1969 and is headquartered in Calabasas, California."
UNAM,2019-12-31,NA,-3249890,NA,-3115703,4067852,3662045,-3249890,-3249890,NA,-134187,31372814,34622704,27710769,0,NA,-3115703,-3115703,2844083,income_statement,Insurance—Property & Casualty,Unico American Corporation,"Unico American Corporation, through its subsidiaries, underwrites property and casualty insurance in Arizona, California, Nevada, Oregon, and Washington. It provides property, casualty, health, and life insurance products, as well as insurance premium financing and membership association services. The company's commercial property coverage insures against loss or damage to buildings, inventory, and equipment from natural disasters, including hurricanes, windstorms, hail, water, explosions, and severe winter weather, as well as other events, such as theft and vandalism, fires, storms, and financial loss due to business interruption resulting from covered property damage. It also provides commercial liability coverage that insures against third party liability from accidents occurring on the insured's premises or arising out of its operation; and writes policies to insure commercial property and commercial liability risks on a mono-line basis. In addition, the company offers group dental and vision insurance policies, as well as health and life insurance for individuals and groups. Unico American Corporation markets its insurance products primarily through a network of independent brokers and agents. The company was founded in 1969 and is headquartered in Calabasas, California."
UNB,2017-12-31,NA,12052000,NA,8449000,18057000,35957000,0,12052000,NA,3603000,35957000,23905000,0,-627000,NA,8449000,8449000,5848000,income_statement,Banks—Regional,"Union Bankshares, Inc.","Union Bankshares, Inc. operates as the bank holding company for Union Bank that provides retail, commercial, and municipal banking services in northern Vermont and New Hampshire. It offers retail depository services, such as personal checking, savings, money market, IRA/SEP/KEOGH, and health savings accounts, as well as certificates of deposit. The company also provides commercial real estate loans; consumer loans; and municipal loans; commercial loans for plant and equipment, working capital, real estate renovation, and other business purposes to business owners and investors; and residential real estate loans. In addition, it offers small business administration guaranteed, and residential construction and mortgage loans; online cash management services, including account reconciliation, credit card depository, automated clearing house origination, wire transfers, and night depository services; merchant credit card services; remote deposit capture services; and online mortgage application services. Further, the company provides business checking accounts; standby letters of credit, bank checks or money orders, and safe deposit boxes; ATM services; debit cards; and telephone, Internet, and mobile banking services; home improvement loans and overdraft; customer repurchase agreement sweeps; and asset management, fiduciary, and trust services. It offers retail banking services to individuals; and commercial banking services to small and medium sized corporations, partnerships, and sole proprietorships, as well as nonprofit organizations, local municipalities, and school districts. The company operates 20 banking offices, 2 loan centers, and various ATMs. Union Bankshares, Inc. was founded in 1891 and is headquartered in Morrisville, Vermont."
UNB,2018-12-31,NA,8345000,NA,7072000,23069000,37370000,0,8093000,NA,1273000,37370000,29277000,0,252000,NA,7072000,7072000,6208000,income_statement,Banks—Regional,"Union Bankshares, Inc.","Union Bankshares, Inc. operates as the bank holding company for Union Bank that provides retail, commercial, and municipal banking services in northern Vermont and New Hampshire. It offers retail depository services, such as personal checking, savings, money market, IRA/SEP/KEOGH, and health savings accounts, as well as certificates of deposit. The company also provides commercial real estate loans; consumer loans; and municipal loans; commercial loans for plant and equipment, working capital, real estate renovation, and other business purposes to business owners and investors; and residential real estate loans. In addition, it offers small business administration guaranteed, and residential construction and mortgage loans; online cash management services, including account reconciliation, credit card depository, automated clearing house origination, wire transfers, and night depository services; merchant credit card services; remote deposit capture services; and online mortgage application services. Further, the company provides business checking accounts; standby letters of credit, bank checks or money orders, and safe deposit boxes; ATM services; debit cards; and telephone, Internet, and mobile banking services; home improvement loans and overdraft; customer repurchase agreement sweeps; and asset management, fiduciary, and trust services. It offers retail banking services to individuals; and commercial banking services to small and medium sized corporations, partnerships, and sole proprietorships, as well as nonprofit organizations, local municipalities, and school districts. The company operates 20 banking offices, 2 loan centers, and various ATMs. Union Bankshares, Inc. was founded in 1891 and is headquartered in Morrisville, Vermont."
UNB,2019-12-31,NA,12478000,NA,10648000,20851000,39803000,0,12347000,NA,1830000,39803000,27456000,0,131000,NA,10648000,10648000,6605000,income_statement,Banks—Regional,"Union Bankshares, Inc.","Union Bankshares, Inc. operates as the bank holding company for Union Bank that provides retail, commercial, and municipal banking services in northern Vermont and New Hampshire. It offers retail depository services, such as personal checking, savings, money market, IRA/SEP/KEOGH, and health savings accounts, as well as certificates of deposit. The company also provides commercial real estate loans; consumer loans; and municipal loans; commercial loans for plant and equipment, working capital, real estate renovation, and other business purposes to business owners and investors; and residential real estate loans. In addition, it offers small business administration guaranteed, and residential construction and mortgage loans; online cash management services, including account reconciliation, credit card depository, automated clearing house origination, wire transfers, and night depository services; merchant credit card services; remote deposit capture services; and online mortgage application services. Further, the company provides business checking accounts; standby letters of credit, bank checks or money orders, and safe deposit boxes; ATM services; debit cards; and telephone, Internet, and mobile banking services; home improvement loans and overdraft; customer repurchase agreement sweeps; and asset management, fiduciary, and trust services. It offers retail banking services to individuals; and commercial banking services to small and medium sized corporations, partnerships, and sole proprietorships, as well as nonprofit organizations, local municipalities, and school districts. The company operates 20 banking offices, 2 loan centers, and various ATMs. Union Bankshares, Inc. was founded in 1891 and is headquartered in Morrisville, Vermont."
UNB,2020-12-31,NA,15224000,NA,12805000,22659000,45406000,0,15224000,NA,2419000,45406000,30182000,0,0,NA,12805000,12805000,7523000,income_statement,Banks—Regional,"Union Bankshares, Inc.","Union Bankshares, Inc. operates as the bank holding company for Union Bank that provides retail, commercial, and municipal banking services in northern Vermont and New Hampshire. It offers retail depository services, such as personal checking, savings, money market, IRA/SEP/KEOGH, and health savings accounts, as well as certificates of deposit. The company also provides commercial real estate loans; consumer loans; and municipal loans; commercial loans for plant and equipment, working capital, real estate renovation, and other business purposes to business owners and investors; and residential real estate loans. In addition, it offers small business administration guaranteed, and residential construction and mortgage loans; online cash management services, including account reconciliation, credit card depository, automated clearing house origination, wire transfers, and night depository services; merchant credit card services; remote deposit capture services; and online mortgage application services. Further, the company provides business checking accounts; standby letters of credit, bank checks or money orders, and safe deposit boxes; ATM services; debit cards; and telephone, Internet, and mobile banking services; home improvement loans and overdraft; customer repurchase agreement sweeps; and asset management, fiduciary, and trust services. It offers retail banking services to individuals; and commercial banking services to small and medium sized corporations, partnerships, and sole proprietorships, as well as nonprofit organizations, local municipalities, and school districts. The company operates 20 banking offices, 2 loan centers, and various ATMs. Union Bankshares, Inc. was founded in 1891 and is headquartered in Morrisville, Vermont."
UNH,2017-12-31,NA,14023000000,4246000000,10558000000,29557000000,47011000000,15209000000,15209000000,-1186000000,3200000000,201159000000,185950000000,154148000000,-1186000000,NA,10823000000,10558000000,NA,income_statement,NA,NA,NA
UNH,2018-12-31,NA,15944000000,4531000000,11986000000,34074000000,53846000000,17344000000,17344000000,-1400000000,3562000000,226247000000,208903000000,172401000000,-1400000000,NA,12382000000,11986000000,NA,income_statement,NA,NA,NA
UNH,2019-12-31,NA,17981000000,4546000000,13839000000,35193000000,57598000000,19685000000,19685000000,-1704000000,3742000000,242155000000,222470000000,184557000000,-1704000000,NA,14239000000,13839000000,NA,income_statement,NA,NA,NA
UNH,2020-12-31,NA,20742000000,2211000000,15403000000,41704000000,67000000000,22405000000,22405000000,-1663000000,4973000000,257141000000,234736000000,190141000000,-1663000000,NA,15769000000,15403000000,NA,income_statement,NA,NA,NA
UNIT,2016-12-31,NA,305000,101407000,-212000,35402000,721571000,310199000,310199000,-275394000,517000,770408000,460209000,48837000,-309894000,NA,-212000,-5497000,NA,income_statement,REIT—Specialty,Uniti Group Inc.,"Uniti, an internally managed real estate investment trust, is engaged in the acquisition and construction of mission critical communications infrastructure, and is a leading provider of wireless infrastructure solutions for the communications industry. As of September 30, 2020, Uniti owns 6.7 million fiber strand miles and other communications real estate throughout the United States."
UNIT,2017-12-31,NA,-47677000,101407000,-9439000,72045000,808051000,301801000,301801000,-305994000,-38849000,916032000,614231000,107981000,-349478000,NA,-8828000,-16552000,NA,income_statement,REIT—Specialty,Uniti Group Inc.,"Uniti, an internally managed real estate investment trust, is engaged in the acquisition and construction of mission critical communications infrastructure, and is a leading provider of wireless infrastructure solutions for the communications industry. As of September 30, 2020, Uniti owns 6.7 million fiber strand miles and other communications real estate throughout the United States."
UNIT,2018-12-31,NA,11124000,92375000,16187000,85198000,871959000,335011000,335011000,-319591000,-5421000,1017634000,682623000,145675000,-323887000,NA,16545000,7989000,NA,income_statement,REIT—Specialty,Uniti Group Inc.,"Uniti, an internally managed real estate investment trust, is engaged in the acquisition and construction of mission critical communications infrastructure, and is a leading provider of wireless infrastructure solutions for the communications industry. As of September 30, 2020, Uniti owns 6.7 million fiber strand miles and other communications real estate throughout the United States."
UNIT,2019-12-31,NA,15571000,83704000,10582000,102900000,853879000,345225000,345225000,-390112000,4663000,1057611000,712386000,203732000,-329654000,NA,10908000,8384000,NA,income_statement,REIT—Specialty,Uniti Group Inc.,"Uniti, an internally managed real estate investment trust, is engaged in the acquisition and construction of mission critical communications infrastructure, and is a leading provider of wireless infrastructure solutions for the communications industry. As of September 30, 2020, Uniti owns 6.7 million fiber strand miles and other communications real estate throughout the United States."
UNM,2017-12-31,NA,1404000000,NA,994200000,852300000,3271200000,1563900000,1563900000,-159900000,409800000,11286800000,9722900000,8015600000,-159900000,NA,994200000,994200000,855000000,income_statement,NA,NA,NA
UNM,2018-12-31,NA,627800000,NA,523400000,885900000,2572200000,795100000,795100000,-167300000,104400000,11598500000,10803400000,9026300000,-167300000,NA,523400000,523400000,891200000,income_statement,NA,NA,NA
UNM,2019-12-31,NA,1382100000,NA,1100300000,898300000,3428700000,1586800000,1586800000,-177400000,281800000,11998900000,10412100000,8570200000,-204700000,NA,1100300000,1100300000,943600000,income_statement,NA,NA,NA
UNM,2020-12-31,NA,964000000,NA,793000000,NA,3102000000,1152200000,1152200000,-188200000,171000000,13162100000,12009900000,10060100000,-188200000,NA,793000000,793000000,1949800000,income_statement,NA,NA,NA
UNP,2017-12-31,NA,7632000000,NA,10712000000,-24000000,11200000000,8147000000,8147000000,-719000000,-3080000000,21240000000,13093000000,10040000000,-515000000,NA,10712000000,10712000000,948000000,income_statement,NA,NA,NA
UNP,2018-12-31,NA,7741000000,NA,5966000000,-13000000,11743000000,8530000000,8530000000,-870000000,1775000000,22832000000,14302000000,11089000000,-789000000,NA,5966000000,5966000000,1022000000,income_statement,NA,NA,NA
UNP,2019-12-31,NA,7747000000,NA,5919000000,NA,11867000000,8591000000,8591000000,-1050000000,1828000000,21708000000,13117000000,9841000000,-844000000,NA,5919000000,5919000000,1060000000,income_statement,NA,NA,NA
UNP,2020-12-31,NA,6980000000,NA,5349000000,NA,11433000000,7878000000,7878000000,-1141000000,1631000000,19533000000,11655000000,8100000000,-898000000,NA,5349000000,5349000000,1345000000,income_statement,NA,NA,NA
UNTY,2017-12-31,NA,22433000,NA,12893000,26966000,52477000,0,23442000,NA,9540000,52477000,29035000,0,-1009000,NA,12893000,12893000,2069000,income_statement,Banks—Regional,"Unity Bancorp, Inc.","Unity Bancorp, Inc. operates as the holding company for Unity Bank that provides commercial and retail banking products and services to individuals, small and medium sized businesses, and professional communities. It offers personal and business checking accounts, time deposits, money market accounts, and regular savings accounts. The company also provides commercial, small business administration, consumer, mortgage, home equity, and personal loans. As of December 31, 2019, it offered its financial services through the Internet and nineteen branch offices located in Bergen, Hunterdon, Middlesex, Somerset, Union, and Warren counties in New Jersey, as well as Northampton County, Pennsylvania. The company was founded in 1991 and is based in Clinton, New Jersey."
UNTY,2018-12-31,NA,27307000,NA,21919000,31010000,60437000,0,27437000,NA,5388000,60437000,33000000,0,-130000,NA,21919000,21919000,1990000,income_statement,Banks—Regional,"Unity Bancorp, Inc.","Unity Bancorp, Inc. operates as the holding company for Unity Bank that provides commercial and retail banking products and services to individuals, small and medium sized businesses, and professional communities. It offers personal and business checking accounts, time deposits, money market accounts, and regular savings accounts. The company also provides commercial, small business administration, consumer, mortgage, home equity, and personal loans. As of December 31, 2019, it offered its financial services through the Internet and nineteen branch offices located in Bergen, Hunterdon, Middlesex, Somerset, Union, and Warren counties in New Jersey, as well as Northampton County, Pennsylvania. The company was founded in 1991 and is based in Clinton, New Jersey."
UNTY,2019-12-31,NA,30315000,NA,23653000,32226000,64266000,0,29891000,NA,6662000,64266000,34375000,0,424000,NA,23653000,23653000,2149000,income_statement,Banks—Regional,"Unity Bancorp, Inc.","Unity Bancorp, Inc. operates as the holding company for Unity Bank that provides commercial and retail banking products and services to individuals, small and medium sized businesses, and professional communities. It offers personal and business checking accounts, time deposits, money market accounts, and regular savings accounts. The company also provides commercial, small business administration, consumer, mortgage, home equity, and personal loans. As of December 31, 2019, it offered its financial services through the Internet and nineteen branch offices located in Bergen, Hunterdon, Middlesex, Somerset, Union, and Warren counties in New Jersey, as well as Northampton County, Pennsylvania. The company was founded in 1991 and is based in Clinton, New Jersey."
UNTY,2020-12-31,NA,31119000,NA,23644000,34252000,70381000,0,32008000,NA,7475000,70381000,38373000,0,-889000,NA,23644000,23644000,4121000,income_statement,Banks—Regional,"Unity Bancorp, Inc.","Unity Bancorp, Inc. operates as the holding company for Unity Bank that provides commercial and retail banking products and services to individuals, small and medium sized businesses, and professional communities. It offers personal and business checking accounts, time deposits, money market accounts, and regular savings accounts. The company also provides commercial, small business administration, consumer, mortgage, home equity, and personal loans. As of December 31, 2019, it offered its financial services through the Internet and nineteen branch offices located in Bergen, Hunterdon, Middlesex, Somerset, Union, and Warren counties in New Jersey, as well as Northampton County, Pennsylvania. The company was founded in 1991 and is based in Clinton, New Jersey."
UONE,2016-12-31,NA,10296000,12410000,-423000,198541000,322219000,89431000,89431000,-81636000,9580000,456219000,366788000,134000000,-79135000,NA,716000,-423000,NA,income_statement,Broadcasting,"Urban One, Inc.","Urban One, Inc., together with its subsidiaries, operates as an urban-oriented multi-media company in the United States. The company operates through four segments: Radio Broadcasting, Cable Television, Reach Media, and Digital. The Radio Broadcasting segment includes radio broadcasting operations that primarily target African-American and urban listeners. As of December 31, 2019, it owned and/or operated 60 broadcast stations under the Radio One tradename located in 15 urban markets. The Cable Television segment operates TV One, an African-American targeted cable television network. The Reach Media segment operates syndicated programming, including the Rickey Smiley Morning Show, the Russ Parr Morning Show, and the DL Hughley Show. This segment also operates BlackAmericaWeb.com, an African-American targeted news and entertainment website, as well as other event related activities. The Digital segment owns Interactive One, a digital platform serving the African-American community through social content, news, information, and entertainment websites, including Cassius and Bossip, HipHopWired, and MadameNoire digital platforms and brands. The company was formerly known as Radio One, Inc. and changed its name to Urban One, Inc. in May 2017. Urban One, Inc. was founded in 1980 and is headquartered in Silver Spring, Maryland."
UONE,2017-12-31,NA,-10701000,10780000,111887000,193967000,309624000,81641000,81641000,-79420000,-123163000,440041000,358400000,130417000,-92342000,NA,112462000,111887000,NA,income_statement,Broadcasting,"Urban One, Inc.","Urban One, Inc., together with its subsidiaries, operates as an urban-oriented multi-media company in the United States. The company operates through four segments: Radio Broadcasting, Cable Television, Reach Media, and Digital. The Radio Broadcasting segment includes radio broadcasting operations that primarily target African-American and urban listeners. As of December 31, 2019, it owned and/or operated 60 broadcast stations under the Radio One tradename located in 15 urban markets. The Cable Television segment operates TV One, an African-American targeted cable television network. The Reach Media segment operates syndicated programming, including the Rickey Smiley Morning Show, the Russ Parr Morning Show, and the DL Hughley Show. This segment also operates BlackAmericaWeb.com, an African-American targeted news and entertainment website, as well as other event related activities. The Digital segment owns Interactive One, a digital platform serving the African-American community through social content, news, information, and entertainment websites, including Cassius and Bossip, HipHopWired, and MadameNoire digital platforms and brands. The company was formerly known as Radio One, Inc. and changed its name to Urban One, Inc. in May 2017. Urban One, Inc. was founded in 1980 and is headquartered in Silver Spring, Maryland."
UONE,2018-12-31,NA,3406000,10232000,137442000,183250000,313734000,97295000,97295000,-76667000,-135199000,439098000,341803000,125364000,-93889000,NA,138605000,137442000,NA,income_statement,Broadcasting,"Urban One, Inc.","Urban One, Inc., together with its subsidiaries, operates as an urban-oriented multi-media company in the United States. The company operates through four segments: Radio Broadcasting, Cable Television, Reach Media, and Digital. The Radio Broadcasting segment includes radio broadcasting operations that primarily target African-American and urban listeners. As of December 31, 2019, it owned and/or operated 60 broadcast stations under the Radio One tradename located in 15 urban markets. The Cable Television segment operates TV One, an African-American targeted cable television network. The Reach Media segment operates syndicated programming, including the Rickey Smiley Morning Show, the Russ Parr Morning Show, and the DL Hughley Show. This segment also operates BlackAmericaWeb.com, an African-American targeted news and entertainment website, as well as other event related activities. The Digital segment owns Interactive One, a digital platform serving the African-American community through social content, news, information, and entertainment websites, including Cassius and Bossip, HipHopWired, and MadameNoire digital platforms and brands. The company was formerly known as Radio One, Inc. and changed its name to Urban One, Inc. in May 2017. Urban One, Inc. was founded in 1980 and is headquartered in Silver Spring, Maryland."
UONE,2019-12-31,NA,12921000,10564000,925000,193147000,308125000,97993000,97993000,-81400000,10864000,436929000,338936000,128804000,-85072000,NA,2057000,925000,NA,income_statement,Broadcasting,"Urban One, Inc.","Urban One, Inc., together with its subsidiaries, operates as an urban-oriented multi-media company in the United States. The company operates through four segments: Radio Broadcasting, Cable Television, Reach Media, and Digital. The Radio Broadcasting segment includes radio broadcasting operations that primarily target African-American and urban listeners. As of December 31, 2019, it owned and/or operated 60 broadcast stations under the Radio One tradename located in 15 urban markets. The Cable Television segment operates TV One, an African-American targeted cable television network. The Reach Media segment operates syndicated programming, including the Rickey Smiley Morning Show, the Russ Parr Morning Show, and the DL Hughley Show. This segment also operates BlackAmericaWeb.com, an African-American targeted news and entertainment website, as well as other event related activities. The Digital segment owns Interactive One, a digital platform serving the African-American community through social content, news, information, and entertainment websites, including Cassius and Bossip, HipHopWired, and MadameNoire digital platforms and brands. The company was formerly known as Radio One, Inc. and changed its name to Urban One, Inc. in May 2017. Urban One, Inc. was founded in 1980 and is headquartered in Silver Spring, Maryland."
UONEK,2016-12-31,NA,10296000,12410000,-423000,198541000,322219000,89431000,89431000,-81636000,9580000,456219000,366788000,134000000,-79135000,NA,716000,-423000,NA,income_statement,Broadcasting,"Urban One, Inc.","Urban One, Inc., together with its subsidiaries, operates as an urban-oriented multi-media company in the United States. The company operates through four segments: Radio Broadcasting, Cable Television, Reach Media, and Digital. The Radio Broadcasting segment includes radio broadcasting operations that primarily target African-American and urban listeners. As of December 31, 2019, it owned and/or operated 60 broadcast stations under the Radio One tradename located in 15 urban markets. The Cable Television segment operates TV One, an African-American targeted cable television network. The Reach Media segment operates syndicated programming, including the Rickey Smiley Morning Show, the Russ Parr Morning Show, and the DL Hughley Show. This segment also operates BlackAmericaWeb.com, an African-American targeted news and entertainment website, as well as other event related activities. The Digital segment owns Interactive One, a digital platform serving the African-American community through social content, news, information, and entertainment websites, including Cassius and Bossip, HipHopWired, and MadameNoire digital platforms and brands. The company was formerly known as Radio One, Inc. and changed its name to Urban One, Inc. in May 2017. Urban One, Inc. was founded in 1980 and is headquartered in Silver Spring, Maryland."
UONEK,2017-12-31,NA,-10701000,10780000,111887000,193967000,309624000,81641000,81641000,-79420000,-123163000,440041000,358400000,130417000,-92342000,NA,112462000,111887000,NA,income_statement,Broadcasting,"Urban One, Inc.","Urban One, Inc., together with its subsidiaries, operates as an urban-oriented multi-media company in the United States. The company operates through four segments: Radio Broadcasting, Cable Television, Reach Media, and Digital. The Radio Broadcasting segment includes radio broadcasting operations that primarily target African-American and urban listeners. As of December 31, 2019, it owned and/or operated 60 broadcast stations under the Radio One tradename located in 15 urban markets. The Cable Television segment operates TV One, an African-American targeted cable television network. The Reach Media segment operates syndicated programming, including the Rickey Smiley Morning Show, the Russ Parr Morning Show, and the DL Hughley Show. This segment also operates BlackAmericaWeb.com, an African-American targeted news and entertainment website, as well as other event related activities. The Digital segment owns Interactive One, a digital platform serving the African-American community through social content, news, information, and entertainment websites, including Cassius and Bossip, HipHopWired, and MadameNoire digital platforms and brands. The company was formerly known as Radio One, Inc. and changed its name to Urban One, Inc. in May 2017. Urban One, Inc. was founded in 1980 and is headquartered in Silver Spring, Maryland."
UONEK,2018-12-31,NA,3406000,10232000,137442000,183250000,313734000,97295000,97295000,-76667000,-135199000,439098000,341803000,125364000,-93889000,NA,138605000,137442000,NA,income_statement,Broadcasting,"Urban One, Inc.","Urban One, Inc., together with its subsidiaries, operates as an urban-oriented multi-media company in the United States. The company operates through four segments: Radio Broadcasting, Cable Television, Reach Media, and Digital. The Radio Broadcasting segment includes radio broadcasting operations that primarily target African-American and urban listeners. As of December 31, 2019, it owned and/or operated 60 broadcast stations under the Radio One tradename located in 15 urban markets. The Cable Television segment operates TV One, an African-American targeted cable television network. The Reach Media segment operates syndicated programming, including the Rickey Smiley Morning Show, the Russ Parr Morning Show, and the DL Hughley Show. This segment also operates BlackAmericaWeb.com, an African-American targeted news and entertainment website, as well as other event related activities. The Digital segment owns Interactive One, a digital platform serving the African-American community through social content, news, information, and entertainment websites, including Cassius and Bossip, HipHopWired, and MadameNoire digital platforms and brands. The company was formerly known as Radio One, Inc. and changed its name to Urban One, Inc. in May 2017. Urban One, Inc. was founded in 1980 and is headquartered in Silver Spring, Maryland."
UONEK,2019-12-31,NA,12921000,10564000,925000,193147000,308125000,97993000,97993000,-81400000,10864000,436929000,338936000,128804000,-85072000,NA,2057000,925000,NA,income_statement,Broadcasting,"Urban One, Inc.","Urban One, Inc., together with its subsidiaries, operates as an urban-oriented multi-media company in the United States. The company operates through four segments: Radio Broadcasting, Cable Television, Reach Media, and Digital. The Radio Broadcasting segment includes radio broadcasting operations that primarily target African-American and urban listeners. As of December 31, 2019, it owned and/or operated 60 broadcast stations under the Radio One tradename located in 15 urban markets. The Cable Television segment operates TV One, an African-American targeted cable television network. The Reach Media segment operates syndicated programming, including the Rickey Smiley Morning Show, the Russ Parr Morning Show, and the DL Hughley Show. This segment also operates BlackAmericaWeb.com, an African-American targeted news and entertainment website, as well as other event related activities. The Digital segment owns Interactive One, a digital platform serving the African-American community through social content, news, information, and entertainment websites, including Cassius and Bossip, HipHopWired, and MadameNoire digital platforms and brands. The company was formerly known as Radio One, Inc. and changed its name to Urban One, Inc. in May 2017. Urban One, Inc. was founded in 1980 and is headquartered in Silver Spring, Maryland."
UPLD,2016-12-31,14406000,-11983000,NA,-13513000,30446000,47202000,-2941000,-2941000,-2781000,1530000,74767000,77708000,27565000,-9042000,NA,-13513000,-13513000,NA,income_statement,Software—Application,"Upland Software, Inc.","Upland Software, Inc. provides cloud-based enterprise work management software in the United States, the United Kingdom, Canada, and internationally. The company offers a family of software applications under the Upland brand in the areas of information technology, digital marketing, ecommerce, customer service and support, project management, business operations, human resources and legal departments, and sales and marketing. Its software applications address enterprise work challenges in various categories comprising customer experience management that enables organizations to manage customer lifecycle, which include awareness, acquisition, and advocacy across multiple channels consisting of email, short and multimedia messaging services, web, social, and mobile apps; and enterprise sales enablement solutions to optimize sales activities, digital content production, automate key proposal and reference processes, and track key metrics. The company also provides professional services automation solution for proposal automation, customer reference management, voice of the customer, and insights-driven business intelligence; project and financial management solution that provide a centralized framework for demand management, resource optimization, project delivery, and financial oversight; enterprise knowledge management solution suite that enables knowledge sharing across different departments within an organization; secure document services; and document lifecycle automation solution, which enables enterprises to manage and automate document intensive business processes with data security. It sells its products through direct and indirect sales organization to financial services, retail, manufacturing, legal, consumer goods, media, and other industries. The company was formerly known as Silverback Enterprise Group, Inc. and changed its name to Upland Software, Inc. in November 2013. Upland Software, Inc. was founded in 2010 and is headquartered in Austin, Texas."
UPLD,2017-12-31,15253000,-17429000,NA,-18725000,38598000,64305000,3956000,3956000,-6582000,1296000,97952000,93996000,33647000,-21385000,NA,-18725000,-18725000,NA,income_statement,Software—Application,"Upland Software, Inc.","Upland Software, Inc. provides cloud-based enterprise work management software in the United States, the United Kingdom, Canada, and internationally. The company offers a family of software applications under the Upland brand in the areas of information technology, digital marketing, ecommerce, customer service and support, project management, business operations, human resources and legal departments, and sales and marketing. Its software applications address enterprise work challenges in various categories comprising customer experience management that enables organizations to manage customer lifecycle, which include awareness, acquisition, and advocacy across multiple channels consisting of email, short and multimedia messaging services, web, social, and mobile apps; and enterprise sales enablement solutions to optimize sales activities, digital content production, automate key proposal and reference processes, and track key metrics. The company also provides professional services automation solution for proposal automation, customer reference management, voice of the customer, and insights-driven business intelligence; project and financial management solution that provide a centralized framework for demand management, resource optimization, project delivery, and financial oversight; enterprise knowledge management solution suite that enables knowledge sharing across different departments within an organization; secure document services; and document lifecycle automation solution, which enables enterprises to manage and automate document intensive business processes with data security. It sells its products through direct and indirect sales organization to financial services, retail, manufacturing, legal, consumer goods, media, and other industries. The company was formerly known as Silverback Enterprise Group, Inc. and changed its name to Upland Software, Inc. in November 2013. Upland Software, Inc. was founded in 2010 and is headquartered in Austin, Texas."
UPLD,2018-12-31,20914000,-20648000,NA,-10839000,52976000,101296000,13134000,13134000,-13273000,-9809000,149885000,136751000,48589000,-33782000,NA,-10839000,-10839000,NA,income_statement,Software—Application,"Upland Software, Inc.","Upland Software, Inc. provides cloud-based enterprise work management software in the United States, the United Kingdom, Canada, and internationally. The company offers a family of software applications under the Upland brand in the areas of information technology, digital marketing, ecommerce, customer service and support, project management, business operations, human resources and legal departments, and sales and marketing. Its software applications address enterprise work challenges in various categories comprising customer experience management that enables organizations to manage customer lifecycle, which include awareness, acquisition, and advocacy across multiple channels consisting of email, short and multimedia messaging services, web, social, and mobile apps; and enterprise sales enablement solutions to optimize sales activities, digital content production, automate key proposal and reference processes, and track key metrics. The company also provides professional services automation solution for proposal automation, customer reference management, voice of the customer, and insights-driven business intelligence; project and financial management solution that provide a centralized framework for demand management, resource optimization, project delivery, and financial oversight; enterprise knowledge management solution suite that enables knowledge sharing across different departments within an organization; secure document services; and document lifecycle automation solution, which enables enterprises to manage and automate document intensive business processes with data security. It sells its products through direct and indirect sales organization to financial services, retail, manufacturing, legal, consumer goods, media, and other industries. The company was formerly known as Silverback Enterprise Group, Inc. and changed its name to Upland Software, Inc. in November 2013. Upland Software, Inc. was founded in 2010 and is headquartered in Austin, Texas."
UPLD,2019-12-31,29037000,-52176000,NA,-45371000,83247000,153520000,15351000,15351000,-22313000,-6805000,222637000,207286000,69117000,-67527000,NA,-45371000,-45371000,NA,income_statement,Software—Application,"Upland Software, Inc.","Upland Software, Inc. provides cloud-based enterprise work management software in the United States, the United Kingdom, Canada, and internationally. The company offers a family of software applications under the Upland brand in the areas of information technology, digital marketing, ecommerce, customer service and support, project management, business operations, human resources and legal departments, and sales and marketing. Its software applications address enterprise work challenges in various categories comprising customer experience management that enables organizations to manage customer lifecycle, which include awareness, acquisition, and advocacy across multiple channels consisting of email, short and multimedia messaging services, web, social, and mobile apps; and enterprise sales enablement solutions to optimize sales activities, digital content production, automate key proposal and reference processes, and track key metrics. The company also provides professional services automation solution for proposal automation, customer reference management, voice of the customer, and insights-driven business intelligence; project and financial management solution that provide a centralized framework for demand management, resource optimization, project delivery, and financial oversight; enterprise knowledge management solution suite that enables knowledge sharing across different departments within an organization; secure document services; and document lifecycle automation solution, which enables enterprises to manage and automate document intensive business processes with data security. It sells its products through direct and indirect sales organization to financial services, retail, manufacturing, legal, consumer goods, media, and other industries. The company was formerly known as Silverback Enterprise Group, Inc. and changed its name to Upland Software, Inc. in November 2013. Upland Software, Inc. was founded in 2010 and is headquartered in Austin, Texas."
UPS,2017-12-31,NA,7137000000,30000000,4905000000,1362000000,13866000000,6529000000,6529000000,-453000000,2232000000,66585000000,60056000000,52719000000,608000000,NA,4905000000,4905000000,5055000000,income_statement,NA,NA,NA
UPS,2018-12-31,NA,6019000000,16000000,4791000000,1362000000,13130000000,5556000000,5556000000,-605000000,1228000000,71861000000,66305000000,58731000000,463000000,NA,4791000000,4791000000,5379000000,income_statement,NA,NA,NA
UPS,2019-12-31,NA,5652000000,16000000,4440000000,1539000000,13637000000,5536000000,5536000000,-653000000,1212000000,74094000000,68558000000,60457000000,116000000,NA,4440000000,4440000000,5744000000,income_statement,NA,NA,NA
UPS,2020-12-31,NA,1974000000,12000000,1427000000,1539000000,32769000000,2986000000,2986000000,-701000000,547000000,84628000000,81642000000,51859000000,-1012000000,NA,1427000000,1427000000,28244000000,income_statement,NA,NA,NA
UPST,2017-12-31,5324000,-8855000,12001000,-7717000,49269000,56477000,1884000,1884000,-9420000,6000,66709000,64825000,10232000,-10739000,NA,-8861000,-7717000,NA,income_statement,Credit Services,"Upstart Holdings, Inc.","Upstart Holdings, Inc. operates a cloud- based artificial intelligence (AI) lending platform. The company's platform aggregates consumer demand for loans and connects it to its network of the company's AI- enabled bank partners. Its platform connects consumers, banks, and institutional investors through a shared AI lending platform. The company was founded in 2012 and is headquartered in San Mateo, California."
UPST,2018-12-31,8415000,-11218000,12001000,-12319000,83453000,110380000,18512000,18512000,-26483000,0,125796000,107284000,15416000,-29730000,NA,-11218000,-12319000,NA,income_statement,Credit Services,"Upstart Holdings, Inc.","Upstart Holdings, Inc. operates a cloud- based artificial intelligence (AI) lending platform. The company's platform aggregates consumer demand for loans and connects it to its network of the company's AI- enabled bank partners. Its platform connects consumers, banks, and institutional investors through a shared AI lending platform. The company was founded in 2012 and is headquartered in San Mateo, California."
UPST,2019-12-31,18777000,-4946000,1026000,-466000,125040000,165727000,21910000,21910000,-26485000,74000,190674000,168764000,24947000,-26856000,NA,-5020000,-466000,NA,income_statement,Credit Services,"Upstart Holdings, Inc.","Upstart Holdings, Inc. operates a cloud- based artificial intelligence (AI) lending platform. The company's platform aggregates consumer demand for loans and connects it to its network of the company's AI- enabled bank partners. Its platform connects consumers, banks, and institutional investors through a shared AI lending platform. The company was founded in 2012 and is headquartered in San Mateo, California."
UPWK,2016-12-31,37902000,-16234000,NA,-16233000,71783000,101867000,-13368000,-13368000,-858000,-1000,164445000,177813000,62578000,-2866000,NA,-16233000,-16233000,5550000,income_statement,Staffing & Employment Services,Upwork Inc.,"Upwork Inc. operates an online talent marketplace that enables businesses (clients) to find and work with various independent professionals and agencies (freelancers) in the United States, India, the Philippines, and internationally. The company's platform provides access to talent with approximately 8,000 skills across approximately 70 categories, including content marketing, customer service, data science and analytics, graphic design, mobile development, sales, and web development. Its platform also enables clients to streamline workflows, such as talent sourcing, outreach, and contracting. The company's platform offers access to various functionalities for remote engagements with freelancers comprising communication and collaboration, time tracking, invoicing, and payment. Its marketplace offerings include Upwork Basic, Upwork Plus, Upwork Business, Upwork Enterprise, and Upwork Payroll, as well as managed and internet escrow agency services. The company was formerly known as Elance-oDesk, Inc. and changed its name to Upwork Inc. in May 2015. Upwork Inc. was incorporated in 2013 and is headquartered in Santa Clara, California."
UPWK,2017-12-31,45604000,-4145000,NA,-4123000,90378000,137109000,-3123000,-3123000,-960000,-22000,202552000,205675000,65443000,-1022000,NA,-4123000,-10629000,4250000,income_statement,Staffing & Employment Services,Upwork Inc.,"Upwork Inc. operates an online talent marketplace that enables businesses (clients) to find and work with various independent professionals and agencies (freelancers) in the United States, India, the Philippines, and internationally. The company's platform provides access to talent with approximately 8,000 skills across approximately 70 categories, including content marketing, customer service, data science and analytics, graphic design, mobile development, sales, and web development. Its platform also enables clients to streamline workflows, such as talent sourcing, outreach, and contracting. The company's platform offers access to various functionalities for remote engagements with freelancers comprising communication and collaboration, time tracking, invoicing, and payment. Its marketplace offerings include Upwork Basic, Upwork Plus, Upwork Business, Upwork Enterprise, and Upwork Payroll, as well as managed and internet escrow agency services. The company was formerly known as Elance-oDesk, Inc. and changed its name to Upwork Inc. in May 2015. Upwork Inc. was incorporated in 2013 and is headquartered in Santa Clara, California."
UPWK,2018-12-31,55488000,-19892000,NA,-19907000,122299000,171896000,-11712000,-11712000,-2038000,15000,253354000,265066000,81458000,-8180000,NA,-19907000,-19907000,5821000,income_statement,Staffing & Employment Services,Upwork Inc.,"Upwork Inc. operates an online talent marketplace that enables businesses (clients) to find and work with various independent professionals and agencies (freelancers) in the United States, India, the Philippines, and internationally. The company's platform provides access to talent with approximately 8,000 skills across approximately 70 categories, including content marketing, customer service, data science and analytics, graphic design, mobile development, sales, and web development. Its platform also enables clients to streamline workflows, such as talent sourcing, outreach, and contracting. The company's platform offers access to various functionalities for remote engagements with freelancers comprising communication and collaboration, time tracking, invoicing, and payment. Its marketplace offerings include Upwork Basic, Upwork Plus, Upwork Business, Upwork Enterprise, and Upwork Payroll, as well as managed and internet escrow agency services. The company was formerly known as Elance-oDesk, Inc. and changed its name to Upwork Inc. in May 2015. Upwork Inc. was incorporated in 2013 and is headquartered in Santa Clara, California."
UPWK,2019-12-31,64027000,-16631000,NA,-16659000,163218000,212418000,-18732000,-18732000,-1306000,28000,300562000,319294000,88144000,2101000,NA,-16659000,-16659000,3905000,income_statement,Staffing & Employment Services,Upwork Inc.,"Upwork Inc. operates an online talent marketplace that enables businesses (clients) to find and work with various independent professionals and agencies (freelancers) in the United States, India, the Philippines, and internationally. The company's platform provides access to talent with approximately 8,000 skills across approximately 70 categories, including content marketing, customer service, data science and analytics, graphic design, mobile development, sales, and web development. Its platform also enables clients to streamline workflows, such as talent sourcing, outreach, and contracting. The company's platform offers access to various functionalities for remote engagements with freelancers comprising communication and collaboration, time tracking, invoicing, and payment. Its marketplace offerings include Upwork Basic, Upwork Plus, Upwork Business, Upwork Enterprise, and Upwork Payroll, as well as managed and internet escrow agency services. The company was formerly known as Elance-oDesk, Inc. and changed its name to Upwork Inc. in May 2015. Upwork Inc. was incorporated in 2013 and is headquartered in Santa Clara, California."
URBN,2017-01-31,NA,338099000,NA,218120000,906086000,1248954000,342868000,342868000,NA,119979000,3545794000,3202926000,2296840000,-4769000,NA,218120000,218120000,NA,income_statement,Apparel Retail,"Urban Outfitters, Inc.","Urban Outfitters, Inc. engages in the retail and wholesale of general consumer products. The company operates through three segments: Retail, wholesale, and Subscription. It operates Urban Outfitters stores, which offer women's and men's fashion apparel, activewear, intimates, footwear, accessories, home goods, electronics, and beauty products for young adults aged 18 to 28; and Anthropologie stores that provide women's casual apparel, accessories, intimates, shoes, and home furnishings, as well as gifts, decorative items, and beauty and wellness products for women aged 28 to 45. The company also operates Bhldn stores, which offer heirloom quality wedding gowns, bridesmaid frocks, party dresses, assorted jewelry, headpieces, footwear, lingerie, and decorations; and Terrain stores that provide lifestyle home products, garden and outdoor living products, antiques, live plants, flowers, wellness products, and accessories. In addition, it operates Free People retail stores, which offer casual women's apparel, intimates, activewear, shoes, accessories, home products, gifts, and beauty and wellness products for young women aged 25 to 30; restaurants; and women's apparel subscription rental service under the Nuuly brand name. The company serves its customers directly through retail stores, Websites, mobile applications, catalogs and customer contact centers, franchised or third-party operated stores, and digital businesses. As of January 31, 2020, it operated 248 Urban Outfitters, 231 Anthropologie Group, and 144 Free People stores in the United States, Canada, and Europe; and 11 restaurants. The company is also involved in the wholesale of young women's contemporary casual apparel, intimates, activewear, and shoes under the Free People brand; and home goods under the Anthropologie brand to approximately 2,300 department and specialty stores worldwide. The company was founded in 1970 and is based in Philadelphia, Pennsylvania."
URBN,2018-01-31,NA,261366000,NA,108263000,915615000,1186917000,271302000,271302000,NA,153103000,3616014000,3344712000,2429097000,-9936000,NA,108263000,108263000,NA,income_statement,Apparel Retail,"Urban Outfitters, Inc.","Urban Outfitters, Inc. engages in the retail and wholesale of general consumer products. The company operates through three segments: Retail, wholesale, and Subscription. It operates Urban Outfitters stores, which offer women's and men's fashion apparel, activewear, intimates, footwear, accessories, home goods, electronics, and beauty products for young adults aged 18 to 28; and Anthropologie stores that provide women's casual apparel, accessories, intimates, shoes, and home furnishings, as well as gifts, decorative items, and beauty and wellness products for women aged 28 to 45. The company also operates Bhldn stores, which offer heirloom quality wedding gowns, bridesmaid frocks, party dresses, assorted jewelry, headpieces, footwear, lingerie, and decorations; and Terrain stores that provide lifestyle home products, garden and outdoor living products, antiques, live plants, flowers, wellness products, and accessories. In addition, it operates Free People retail stores, which offer casual women's apparel, intimates, activewear, shoes, accessories, home products, gifts, and beauty and wellness products for young women aged 25 to 30; restaurants; and women's apparel subscription rental service under the Nuuly brand name. The company serves its customers directly through retail stores, Websites, mobile applications, catalogs and customer contact centers, franchised or third-party operated stores, and digital businesses. As of January 31, 2020, it operated 248 Urban Outfitters, 231 Anthropologie Group, and 144 Free People stores in the United States, Canada, and Europe; and 11 restaurants. The company is also involved in the wholesale of young women's contemporary casual apparel, intimates, activewear, and shoes under the Free People brand; and home goods under the Anthropologie brand to approximately 2,300 department and specialty stores worldwide. The company was founded in 1970 and is based in Philadelphia, Pennsylvania."
URBN,2019-01-31,NA,385553000,NA,298003000,965399000,1350256000,384857000,384857000,NA,87550000,3950623000,3565766000,2600367000,696000,NA,298003000,298003000,NA,income_statement,Apparel Retail,"Urban Outfitters, Inc.","Urban Outfitters, Inc. engages in the retail and wholesale of general consumer products. The company operates through three segments: Retail, wholesale, and Subscription. It operates Urban Outfitters stores, which offer women's and men's fashion apparel, activewear, intimates, footwear, accessories, home goods, electronics, and beauty products for young adults aged 18 to 28; and Anthropologie stores that provide women's casual apparel, accessories, intimates, shoes, and home furnishings, as well as gifts, decorative items, and beauty and wellness products for women aged 28 to 45. The company also operates Bhldn stores, which offer heirloom quality wedding gowns, bridesmaid frocks, party dresses, assorted jewelry, headpieces, footwear, lingerie, and decorations; and Terrain stores that provide lifestyle home products, garden and outdoor living products, antiques, live plants, flowers, wellness products, and accessories. In addition, it operates Free People retail stores, which offer casual women's apparel, intimates, activewear, shoes, accessories, home products, gifts, and beauty and wellness products for young women aged 25 to 30; restaurants; and women's apparel subscription rental service under the Nuuly brand name. The company serves its customers directly through retail stores, Websites, mobile applications, catalogs and customer contact centers, franchised or third-party operated stores, and digital businesses. As of January 31, 2020, it operated 248 Urban Outfitters, 231 Anthropologie Group, and 144 Free People stores in the United States, Canada, and Europe; and 11 restaurants. The company is also involved in the wholesale of young women's contemporary casual apparel, intimates, activewear, and shoes under the Free People brand; and home goods under the Anthropologie brand to approximately 2,300 department and specialty stores worldwide. The company was founded in 1970 and is based in Philadelphia, Pennsylvania."
URBN,2020-01-31,NA,239720000,NA,168096000,993990000,1254437000,260447000,260447000,NA,71624000,3983789000,3723342000,2729352000,-20727000,NA,168096000,168096000,NA,income_statement,Apparel Retail,"Urban Outfitters, Inc.","Urban Outfitters, Inc. engages in the retail and wholesale of general consumer products. The company operates through three segments: Retail, wholesale, and Subscription. It operates Urban Outfitters stores, which offer women's and men's fashion apparel, activewear, intimates, footwear, accessories, home goods, electronics, and beauty products for young adults aged 18 to 28; and Anthropologie stores that provide women's casual apparel, accessories, intimates, shoes, and home furnishings, as well as gifts, decorative items, and beauty and wellness products for women aged 28 to 45. The company also operates Bhldn stores, which offer heirloom quality wedding gowns, bridesmaid frocks, party dresses, assorted jewelry, headpieces, footwear, lingerie, and decorations; and Terrain stores that provide lifestyle home products, garden and outdoor living products, antiques, live plants, flowers, wellness products, and accessories. In addition, it operates Free People retail stores, which offer casual women's apparel, intimates, activewear, shoes, accessories, home products, gifts, and beauty and wellness products for young women aged 25 to 30; restaurants; and women's apparel subscription rental service under the Nuuly brand name. The company serves its customers directly through retail stores, Websites, mobile applications, catalogs and customer contact centers, franchised or third-party operated stores, and digital businesses. As of January 31, 2020, it operated 248 Urban Outfitters, 231 Anthropologie Group, and 144 Free People stores in the United States, Canada, and Europe; and 11 restaurants. The company is also involved in the wholesale of young women's contemporary casual apparel, intimates, activewear, and shoes under the Free People brand; and home goods under the Anthropologie brand to approximately 2,300 department and specialty stores worldwide. The company was founded in 1970 and is based in Philadelphia, Pennsylvania."
URGN,2016-12-31,10287000,-1941000,NA,-1941000,6417000,17502000,798000,798000,NA,0,17530000,16732000,28000,-2739000,NA,-1941000,-4408000,NA,income_statement,Biotechnology,UroGen Pharma Ltd.,"UroGen Pharma Ltd., a clinical stage biopharmaceutical company, focuses on developing solutions for specialty cancers and urologic diseases. The company's lead product candidates are UGN-101 and UGN-102, which are designed to ablate tumors by non-surgical means and to treat several forms of non-muscle invasive urothelial cancer that include low-grade upper tract urothelial carcinoma and low-grade non-muscle invasive bladder cancer. It is also developing UGN-201, a proprietary immunotherapy product candidate for the treatment of high-grade non-muscle invasive bladder cancer. The company has a license agreement with Allergan Pharmaceuticals International Limited for developing and commercializing pharmaceutical products that contain RTGel and clostridial toxins; Agenus Inc. to develop, make, use, sell, import, and commercialize products of Agenus for the treatment of cancers of the urinary tract via intravesical delivery; and strategic research collaboration with MD Anderson to advance investigational treatment for high-grade bladder cancer. UroGen Pharma Ltd. was founded in 2004 and is based in Princeton, New Jersey."
URGN,2017-12-31,18697000,-19981000,NA,-20000000,8811000,7558000,-19950000,-19950000,NA,19000,8158000,28108000,600000,-31000,NA,-20000000,-20825000,NA,income_statement,Biotechnology,UroGen Pharma Ltd.,"UroGen Pharma Ltd., a clinical stage biopharmaceutical company, focuses on developing solutions for specialty cancers and urologic diseases. The company's lead product candidates are UGN-101 and UGN-102, which are designed to ablate tumors by non-surgical means and to treat several forms of non-muscle invasive urothelial cancer that include low-grade upper tract urothelial carcinoma and low-grade non-muscle invasive bladder cancer. It is also developing UGN-201, a proprietary immunotherapy product candidate for the treatment of high-grade non-muscle invasive bladder cancer. The company has a license agreement with Allergan Pharmaceuticals International Limited for developing and commercializing pharmaceutical products that contain RTGel and clostridial toxins; Agenus Inc. to develop, make, use, sell, import, and commercialize products of Agenus for the treatment of cancers of the urinary tract via intravesical delivery; and strategic research collaboration with MD Anderson to advance investigational treatment for high-grade bladder cancer. UroGen Pharma Ltd. was founded in 2004 and is based in Princeton, New Jersey."
URGN,2018-12-31,34534000,-75532000,NA,-75657000,32071000,-675000,-67280000,-67280000,NA,125000,1128000,68408000,1803000,-8252000,NA,-75657000,-75657000,NA,income_statement,Biotechnology,UroGen Pharma Ltd.,"UroGen Pharma Ltd., a clinical stage biopharmaceutical company, focuses on developing solutions for specialty cancers and urologic diseases. The company's lead product candidates are UGN-101 and UGN-102, which are designed to ablate tumors by non-surgical means and to treat several forms of non-muscle invasive urothelial cancer that include low-grade upper tract urothelial carcinoma and low-grade non-muscle invasive bladder cancer. It is also developing UGN-201, a proprietary immunotherapy product candidate for the treatment of high-grade non-muscle invasive bladder cancer. The company has a license agreement with Allergan Pharmaceuticals International Limited for developing and commercializing pharmaceutical products that contain RTGel and clostridial toxins; Agenus Inc. to develop, make, use, sell, import, and commercialize products of Agenus for the treatment of cancers of the urinary tract via intravesical delivery; and strategic research collaboration with MD Anderson to advance investigational treatment for high-grade bladder cancer. UroGen Pharma Ltd. was founded in 2004 and is based in Princeton, New Jersey."
URGN,2019-12-31,49297000,-105146000,NA,-105146000,60199000,18000,-109478000,-109478000,NA,0,18000,109496000,0,4332000,NA,-105146000,-105146000,NA,income_statement,Biotechnology,UroGen Pharma Ltd.,"UroGen Pharma Ltd., a clinical stage biopharmaceutical company, focuses on developing solutions for specialty cancers and urologic diseases. The company's lead product candidates are UGN-101 and UGN-102, which are designed to ablate tumors by non-surgical means and to treat several forms of non-muscle invasive urothelial cancer that include low-grade upper tract urothelial carcinoma and low-grade non-muscle invasive bladder cancer. It is also developing UGN-201, a proprietary immunotherapy product candidate for the treatment of high-grade non-muscle invasive bladder cancer. The company has a license agreement with Allergan Pharmaceuticals International Limited for developing and commercializing pharmaceutical products that contain RTGel and clostridial toxins; Agenus Inc. to develop, make, use, sell, import, and commercialize products of Agenus for the treatment of cancers of the urinary tract via intravesical delivery; and strategic research collaboration with MD Anderson to advance investigational treatment for high-grade bladder cancer. UroGen Pharma Ltd. was founded in 2004 and is based in Princeton, New Jersey."
URI,2017-12-31,NA,1048000000,NA,1346000000,903000000,2851000000,1689000000,1689000000,-410000000,-298000000,6641000000,4952000000,3790000000,-641000000,NA,1346000000,1346000000,NA,income_statement,NA,NA,NA
URI,2018-12-31,NA,1476000000,NA,1096000000,1038000000,3430000000,2084000000,2084000000,-481000000,380000000,8047000000,5963000000,4617000000,-608000000,NA,1096000000,1096000000,NA,income_statement,NA,NA,NA
URI,2019-12-31,NA,1514000000,NA,1174000000,1092000000,3745000000,2246000000,2246000000,-587000000,340000000,9351000000,7105000000,5606000000,-732000000,NA,1174000000,1174000000,NA,income_statement,NA,NA,NA
URI,2020-12-31,NA,1139000000,NA,890000000,979000000,3232000000,1896000000,1896000000,-486000000,249000000,8530000000,6634000000,5298000000,-757000000,NA,890000000,890000000,NA,income_statement,NA,NA,NA
UROV,2017-03-31,26047370,-26970082,NA,-26970082,1016166,0,-27063536,-27063536,-259000,0,0,27063536,0,93454,NA,-26970082,-26970082,NA,income_statement,Biotechnology,Urovant Sciences Ltd.,"Urovant Sciences Ltd., a clinical-stage biopharmaceutical company, focuses on developing and commercializing therapies for urologic conditions in the United States. The company's lead product candidate is vibegron, an oral small molecule beta-3 agonist for the treatment of overactive bladder (OAB), OAB in men with benign prostatic hyperplasia, and abdominal pain due to irritable bowel syndrome. It is also developing URO-902, a gene therapy for patients with OAB who have failed oral pharmacological therapy. The company was formerly known as Thalavant Sciences Ltd. and changed its name to Urovant Sciences Ltd. in January 2017. Urovant Sciences Ltd. was founded in 2016 and is based in London, the United Kingdom. Urovant Sciences Ltd. operates as a subsidiary of Sumitovant Biopharma Ltd."
UROV,2018-03-31,32359000,-37037000,NA,-37074000,4640000,0,-36999000,-36999000,-259000,37000,0,36999000,0,-38000,NA,-37074000,-37074000,NA,income_statement,Biotechnology,Urovant Sciences Ltd.,"Urovant Sciences Ltd., a clinical-stage biopharmaceutical company, focuses on developing and commercializing therapies for urologic conditions in the United States. The company's lead product candidate is vibegron, an oral small molecule beta-3 agonist for the treatment of overactive bladder (OAB), OAB in men with benign prostatic hyperplasia, and abdominal pain due to irritable bowel syndrome. It is also developing URO-902, a gene therapy for patients with OAB who have failed oral pharmacological therapy. The company was formerly known as Thalavant Sciences Ltd. and changed its name to Urovant Sciences Ltd. in January 2017. Urovant Sciences Ltd. was founded in 2016 and is based in London, the United Kingdom. Urovant Sciences Ltd. operates as a subsidiary of Sumitovant Biopharma Ltd."
UROV,2019-03-31,92198000,-111299000,NA,-111346000,18585000,0,-110783000,-110783000,-259000,47000,0,110783000,0,-516000,NA,-111346000,-111346000,NA,income_statement,Biotechnology,Urovant Sciences Ltd.,"Urovant Sciences Ltd., a clinical-stage biopharmaceutical company, focuses on developing and commercializing therapies for urologic conditions in the United States. The company's lead product candidate is vibegron, an oral small molecule beta-3 agonist for the treatment of overactive bladder (OAB), OAB in men with benign prostatic hyperplasia, and abdominal pain due to irritable bowel syndrome. It is also developing URO-902, a gene therapy for patients with OAB who have failed oral pharmacological therapy. The company was formerly known as Thalavant Sciences Ltd. and changed its name to Urovant Sciences Ltd. in January 2017. Urovant Sciences Ltd. was founded in 2016 and is based in London, the United Kingdom. Urovant Sciences Ltd. operates as a subsidiary of Sumitovant Biopharma Ltd."
UROV,2020-03-31,92437000,-146680000,NA,-146745000,46299000,0,-138736000,-138736000,-3581000,65000,0,138736000,0,-7944000,NA,-146745000,-146745000,NA,income_statement,Biotechnology,Urovant Sciences Ltd.,"Urovant Sciences Ltd., a clinical-stage biopharmaceutical company, focuses on developing and commercializing therapies for urologic conditions in the United States. The company's lead product candidate is vibegron, an oral small molecule beta-3 agonist for the treatment of overactive bladder (OAB), OAB in men with benign prostatic hyperplasia, and abdominal pain due to irritable bowel syndrome. It is also developing URO-902, a gene therapy for patients with OAB who have failed oral pharmacological therapy. The company was formerly known as Thalavant Sciences Ltd. and changed its name to Urovant Sciences Ltd. in January 2017. Urovant Sciences Ltd. was founded in 2016 and is based in London, the United Kingdom. Urovant Sciences Ltd. operates as a subsidiary of Sumitovant Biopharma Ltd."
USAK,2017-12-31,NA,-6263000,NA,7497000,25628000,71414000,-1911000,-1911000,-3808000,-13760000,446533000,448444000,375119000,-4352000,NA,7497000,7497000,19234000,income_statement,Trucking,"USA Truck, Inc.","USA Truck, Inc. operates as a truckload carrier in the United States, Mexico, and Canada. The company operates through two segments, Trucking and USAT Logistics. The Trucking segment offers truckload motor carrier services as a medium-haul common and contract carrier; and dedicated freight services. The USAT Logistics segment provides freight brokerage, logistics, and rail intermodal services. As of December 31, 2019, the company operated a fleet of 1,990 tractors, which included 421 independent contractor tractors; and 6,212 trailers. USA Truck, Inc. was founded in 1983 and is headquartered in Van Buren, Arkansas."
USAK,2018-12-31,NA,16578000,NA,12204000,23240000,90318000,18219000,18219000,-3649000,4374000,534060000,515841000,443742000,-1641000,NA,12204000,12204000,20535000,income_statement,Trucking,"USA Truck, Inc.","USA Truck, Inc. operates as a truckload carrier in the United States, Mexico, and Canada. The company operates through two segments, Trucking and USAT Logistics. The Trucking segment offers truckload motor carrier services as a medium-haul common and contract carrier; and dedicated freight services. The USAT Logistics segment provides freight brokerage, logistics, and rail intermodal services. As of December 31, 2019, the company operated a fleet of 1,990 tractors, which included 421 independent contractor tractors; and 6,212 trailers. USA Truck, Inc. was founded in 1983 and is headquartered in Van Buren, Arkansas."
USAK,2019-12-31,NA,-4854000,NA,-4698000,27176000,89498000,3047000,3047000,-6597000,-156000,522631000,519584000,433133000,-7901000,NA,-4698000,-4698000,22082000,income_statement,Trucking,"USA Truck, Inc.","USA Truck, Inc. operates as a truckload carrier in the United States, Mexico, and Canada. The company operates through two segments, Trucking and USAT Logistics. The Trucking segment offers truckload motor carrier services as a medium-haul common and contract carrier; and dedicated freight services. The USAT Logistics segment provides freight brokerage, logistics, and rail intermodal services. As of December 31, 2019, the company operated a fleet of 1,990 tractors, which included 421 independent contractor tractors; and 6,212 trailers. USA Truck, Inc. was founded in 1983 and is headquartered in Van Buren, Arkansas."
USAK,2020-12-31,NA,6955000,NA,4746000,19855000,96210000,14108000,14108000,-5605000,2209000,551138000,537030000,454928000,-7153000,NA,4746000,4746000,20888000,income_statement,Trucking,"USA Truck, Inc.","USA Truck, Inc. operates as a truckload carrier in the United States, Mexico, and Canada. The company operates through two segments, Trucking and USAT Logistics. The Trucking segment offers truckload motor carrier services as a medium-haul common and contract carrier; and dedicated freight services. The USAT Logistics segment provides freight brokerage, logistics, and rail intermodal services. As of December 31, 2019, the company operated a fleet of 1,990 tractors, which included 421 independent contractor tractors; and 6,212 trailers. USA Truck, Inc. was founded in 1983 and is headquartered in Van Buren, Arkansas."
USAP,2017-12-31,NA,9000,NA,7610000,18497000,23034000,4237000,4237000,-4277000,-7601000,202643000,198406000,179609000,-4228000,NA,7610000,7610000,NA,income_statement,Steel,Universal Stainless & Alloy Pro,"Universal Stainless & Alloy Products, Inc., together with its subsidiaries, manufactures and markets semi-finished and finished specialty steel products in the United States and internationally. Its products include stainless steel, nickel alloys, tool steel, and various other alloyed steels. The company offers semi-finished and finished long products in the form of ingots, blooms, billets, and bars; flat rolled products, such as slabs and plates; and customized shapes primarily for original equipment manufacturers (OEMs), which are cold rolled from purchased coiled strip, flat bar, or extruded bar. Its semi-finished long products are primarily used to produce rods; and finished bar products that are principally used by OEMs and by service center customers for distribution to various end users. The company also offers conversion services on materials supplied by its customers. Its products are used in aerospace, power generation, oil and gas, heavy equipment, general, and automotive industries, as well as in the manufacturing of equipment for food handling, health and medical, chemical processing, and pollution control; and manufacturing of metals, plastics, paper and aluminum extrusions, pharmaceuticals, electronics, and optics. The company sells its products to service centers, forgers, rerollers, and OEMs. Universal Stainless & Alloy Products, Inc. was founded in 1994 and is headquartered in Bridgeville, Pennsylvania."
USAP,2018-12-31,NA,12597000,NA,10662000,21246000,37816000,16070000,16070000,-4302000,1935000,255927000,239857000,218111000,-3473000,NA,10662000,10662000,NA,income_statement,Steel,Universal Stainless & Alloy Pro,"Universal Stainless & Alloy Products, Inc., together with its subsidiaries, manufactures and markets semi-finished and finished specialty steel products in the United States and internationally. Its products include stainless steel, nickel alloys, tool steel, and various other alloyed steels. The company offers semi-finished and finished long products in the form of ingots, blooms, billets, and bars; flat rolled products, such as slabs and plates; and customized shapes primarily for original equipment manufacturers (OEMs), which are cold rolled from purchased coiled strip, flat bar, or extruded bar. Its semi-finished long products are primarily used to produce rods; and finished bar products that are principally used by OEMs and by service center customers for distribution to various end users. The company also offers conversion services on materials supplied by its customers. Its products are used in aerospace, power generation, oil and gas, heavy equipment, general, and automotive industries, as well as in the manufacturing of equipment for food handling, health and medical, chemical processing, and pollution control; and manufacturing of metals, plastics, paper and aluminum extrusions, pharmaceuticals, electronics, and optics. The company sells its products to service centers, forgers, rerollers, and OEMs. Universal Stainless & Alloy Products, Inc. was founded in 1994 and is headquartered in Bridgeville, Pennsylvania."
USAP,2019-12-31,NA,3773000,NA,4275000,19747000,27638000,7291000,7291000,-3992000,-502000,243007000,235716000,215369000,-3518000,NA,4275000,4275000,NA,income_statement,Steel,Universal Stainless & Alloy Pro,"Universal Stainless & Alloy Products, Inc., together with its subsidiaries, manufactures and markets semi-finished and finished specialty steel products in the United States and internationally. Its products include stainless steel, nickel alloys, tool steel, and various other alloyed steels. The company offers semi-finished and finished long products in the form of ingots, blooms, billets, and bars; flat rolled products, such as slabs and plates; and customized shapes primarily for original equipment manufacturers (OEMs), which are cold rolled from purchased coiled strip, flat bar, or extruded bar. Its semi-finished long products are primarily used to produce rods; and finished bar products that are principally used by OEMs and by service center customers for distribution to various end users. The company also offers conversion services on materials supplied by its customers. Its products are used in aerospace, power generation, oil and gas, heavy equipment, general, and automotive industries, as well as in the manufacturing of equipment for food handling, health and medical, chemical processing, and pollution control; and manufacturing of metals, plastics, paper and aluminum extrusions, pharmaceuticals, electronics, and optics. The company sells its products to service centers, forgers, rerollers, and OEMs. Universal Stainless & Alloy Products, Inc. was founded in 1994 and is headquartered in Bridgeville, Pennsylvania."
USAP,2020-12-31,NA,-24294000,NA,-19047000,19252000,10544000,-9208000,-9208000,-3009000,-5247000,179731000,188939000,169187000,-15086000,NA,-19047000,-19047000,NA,income_statement,Steel,Universal Stainless & Alloy Pro,"Universal Stainless & Alloy Products, Inc., together with its subsidiaries, manufactures and markets semi-finished and finished specialty steel products in the United States and internationally. Its products include stainless steel, nickel alloys, tool steel, and various other alloyed steels. The company offers semi-finished and finished long products in the form of ingots, blooms, billets, and bars; flat rolled products, such as slabs and plates; and customized shapes primarily for original equipment manufacturers (OEMs), which are cold rolled from purchased coiled strip, flat bar, or extruded bar. Its semi-finished long products are primarily used to produce rods; and finished bar products that are principally used by OEMs and by service center customers for distribution to various end users. The company also offers conversion services on materials supplied by its customers. Its products are used in aerospace, power generation, oil and gas, heavy equipment, general, and automotive industries, as well as in the manufacturing of equipment for food handling, health and medical, chemical processing, and pollution control; and manufacturing of metals, plastics, paper and aluminum extrusions, pharmaceuticals, electronics, and optics. The company sells its products to service centers, forgers, rerollers, and OEMs. Universal Stainless & Alloy Products, Inc. was founded in 1994 and is headquartered in Bridgeville, Pennsylvania."
USAT,2017-06-30,NA,-7370000,NA,-7465000,28177000,25061000,-4134000,-4134000,-2228000,95000,101436000,105570000,76375000,-3236000,NA,-7465000,-8133000,NA,income_statement,Software—Infrastructure,"USA Technologies, Inc.","USA Technologies, Inc. provides wireless networking, cashless transactions, asset monitoring, and other value-added services in the United States and internationally. It designs and markets systems and solutions that facilitate electronic payment options, as well as telemetry and Internet of Things (IoT) services. The company's ePort Connect solution offers various POS options, card processing, wireless connectivity, customer/consumer, online sales reporting, seed vending management, loyalty program, two-tier pricing, and special promotion services, as well as planning, project management, deployment, seed implementation, installation support, marketing, and performance evaluation services. The company's products include ePort, a device that is used in self-service, unattended markets, such as vending, amusement and arcade, and various other kiosk applications, as well as facilitates cashless payments by capturing payment information and transmitting it to its network for authorization with the payment system. It primarily serves small ticket, and beverage and food vending industries, as well as unattended point of sale markets, including amusement, commercial laundry, amusement, air/vac, car wash, kiosk, and other. USA Technologies, Inc. was founded in 1992 and is headquartered in Malvern, Pennsylvania."
USAT,2018-06-30,NA,-11385000,NA,-11284000,34647000,35676000,-2175000,-2175000,-3105000,-101000,132508000,134683000,96832000,-9210000,NA,-11284000,-11952000,NA,income_statement,Software—Infrastructure,"USA Technologies, Inc.","USA Technologies, Inc. provides wireless networking, cashless transactions, asset monitoring, and other value-added services in the United States and internationally. It designs and markets systems and solutions that facilitate electronic payment options, as well as telemetry and Internet of Things (IoT) services. The company's ePort Connect solution offers various POS options, card processing, wireless connectivity, customer/consumer, online sales reporting, seed vending management, loyalty program, two-tier pricing, and special promotion services, as well as planning, project management, deployment, seed implementation, installation support, marketing, and performance evaluation services. The company's products include ePort, a device that is used in self-service, unattended markets, such as vending, amusement and arcade, and various other kiosk applications, as well as facilitates cashless payments by capturing payment information and transmitting it to its network for authorization with the payment system. It primarily serves small ticket, and beverage and food vending industries, as well as unattended point of sale markets, including amusement, commercial laundry, amusement, air/vac, car wash, kiosk, and other. USA Technologies, Inc. was founded in 1992 and is headquartered in Malvern, Pennsylvania."
USAT,2019-06-30,NA,-29620000,NA,-29882000,62600000,40185000,-26845000,-26845000,-2992000,262000,144466000,171311000,104281000,-2775000,NA,-29882000,-30550000,NA,income_statement,Software—Infrastructure,"USA Technologies, Inc.","USA Technologies, Inc. provides wireless networking, cashless transactions, asset monitoring, and other value-added services in the United States and internationally. It designs and markets systems and solutions that facilitate electronic payment options, as well as telemetry and Internet of Things (IoT) services. The company's ePort Connect solution offers various POS options, card processing, wireless connectivity, customer/consumer, online sales reporting, seed vending management, loyalty program, two-tier pricing, and special promotion services, as well as planning, project management, deployment, seed implementation, installation support, marketing, and performance evaluation services. The company's products include ePort, a device that is used in self-service, unattended markets, such as vending, amusement and arcade, and various other kiosk applications, as well as facilitates cashless payments by capturing payment information and transmitting it to its network for authorization with the payment system. It primarily serves small ticket, and beverage and food vending industries, as well as unattended point of sale markets, including amusement, commercial laundry, amusement, air/vac, car wash, kiosk, and other. USA Technologies, Inc. was founded in 1992 and is headquartered in Malvern, Pennsylvania."
USAT,2020-06-30,NA,-40594000,NA,-40595000,81558000,46273000,-39592000,-39592000,-2597000,1000,163153000,202745000,116880000,-1002000,NA,-40595000,-41263000,NA,income_statement,Software—Infrastructure,"USA Technologies, Inc.","USA Technologies, Inc. provides wireless networking, cashless transactions, asset monitoring, and other value-added services in the United States and internationally. It designs and markets systems and solutions that facilitate electronic payment options, as well as telemetry and Internet of Things (IoT) services. The company's ePort Connect solution offers various POS options, card processing, wireless connectivity, customer/consumer, online sales reporting, seed vending management, loyalty program, two-tier pricing, and special promotion services, as well as planning, project management, deployment, seed implementation, installation support, marketing, and performance evaluation services. The company's products include ePort, a device that is used in self-service, unattended markets, such as vending, amusement and arcade, and various other kiosk applications, as well as facilitates cashless payments by capturing payment information and transmitting it to its network for authorization with the payment system. It primarily serves small ticket, and beverage and food vending industries, as well as unattended point of sale markets, including amusement, commercial laundry, amusement, air/vac, car wash, kiosk, and other. USA Technologies, Inc. was founded in 1992 and is headquartered in Malvern, Pennsylvania."
USAU,2017-04-30,NA,-4148461,NA,-4148461,2777223,0,-4145267,-4145267,-4242,0,0,4145267,0,-3194,-5831155,-4148461,-4148461,NA,income_statement,Gold,U.S. Gold Corp.,"U.S. Gold Corp. operates as a gold and precious metals exploration and development company in the United States. It explores for gold, copper, silver, and zinc minerals. The company's properties include the Copper King Project located in the Silver Crown Mining District, southeast Wyoming; Keystone Project consisting of 650 unpatented lode mining claims on the Cortez Trend in Nevada; the Maggie Creek Project located in Eureka County, Nevada; and the Gold Bar North Project comprising of 49 unpatented lode mining claims located in Eureka County, Nevada. The company is based in Elko, Nevada."
USAU,2018-04-30,NA,-8262685,NA,-13658495,5786280,0,-8262569,-8262569,-116,-435345,0,8262569,0,-116,-5831155,-7827340,-15235097,NA,income_statement,Gold,U.S. Gold Corp.,"U.S. Gold Corp. operates as a gold and precious metals exploration and development company in the United States. It explores for gold, copper, silver, and zinc minerals. The company's properties include the Copper King Project located in the Silver Crown Mining District, southeast Wyoming; Keystone Project consisting of 650 unpatented lode mining claims on the Cortez Trend in Nevada; the Maggie Creek Project located in Eureka County, Nevada; and the Gold Bar North Project comprising of 49 unpatented lode mining claims located in Eureka County, Nevada. The company is based in Elko, Nevada."
USAU,2019-04-30,NA,-7611205,NA,-8046550,5026788,0,-7611205,-7611205,NA,435345,0,7611205,0,0,NA,-8046550,-8046550,NA,income_statement,Gold,U.S. Gold Corp.,"U.S. Gold Corp. operates as a gold and precious metals exploration and development company in the United States. It explores for gold, copper, silver, and zinc minerals. The company's properties include the Copper King Project located in the Silver Crown Mining District, southeast Wyoming; Keystone Project consisting of 650 unpatented lode mining claims on the Cortez Trend in Nevada; the Maggie Creek Project located in Eureka County, Nevada; and the Gold Bar North Project comprising of 49 unpatented lode mining claims located in Eureka County, Nevada. The company is based in Elko, Nevada."
USAU,2020-04-30,NA,-5687495,NA,-5249350,4409123,0,-5687495,-5687495,NA,-438145,0,5687495,0,0,NA,-5249350,-7335562,NA,income_statement,Gold,U.S. Gold Corp.,"U.S. Gold Corp. operates as a gold and precious metals exploration and development company in the United States. It explores for gold, copper, silver, and zinc minerals. The company's properties include the Copper King Project located in the Silver Crown Mining District, southeast Wyoming; Keystone Project consisting of 650 unpatented lode mining claims on the Cortez Trend in Nevada; the Maggie Creek Project located in Eureka County, Nevada; and the Gold Bar North Project comprising of 49 unpatented lode mining claims located in Eureka County, Nevada. The company is based in Elko, Nevada."
USB,2017-12-31,NA,7517000000,626000000,6218000000,10086000000,19883000000,0,7692000000,NA,1264000000,19883000000,12191000000,0,-175000000,NA,6253000000,5913000000,2105000000,income_statement,NA,NA,NA
USB,2018-12-31,NA,8678000000,628000000,7096000000,10594000000,20813000000,0,8839000000,NA,1554000000,20813000000,11974000000,0,-161000000,NA,7124000000,6784000000,1380000000,income_statement,NA,NA,NA
USB,2019-12-31,NA,8594000000,630000000,6914000000,10999000000,21140000000,0,8762000000,NA,1648000000,21140000000,12378000000,0,-168000000,NA,6946000000,6583000000,1379000000,income_statement,NA,NA,NA
USB,2020-12-31,NA,6051000000,630000000,4959000000,11360000000,19420000000,0,6227000000,NA,1066000000,19420000000,13193000000,0,-176000000,NA,4985000000,4621000000,1833000000,income_statement,NA,NA,NA
USCR,2016-12-31,NA,30800000,21700000,8900000,100000000,245900000,91000000,91000000,-27700000,21200000,1168200000,1077200000,922300000,-60200000,-700000,9600000,8900000,NA,income_statement,Building Materials,"U S Concrete, Inc.","U.S. Concrete, Inc., through its subsidiaries, produces and sells ready-mixed concrete, aggregates, and concrete-related products and services to the construction industry in the United States, the U.S. Virgin Islands, and Canada. It operates through two segments, Ready-Mixed Concrete and Aggregate Products. The Ready-Mixed Concrete segment engages in the formulation, production, and delivery of ready-mixed concrete to customers' job sites; and the provision of various services that include the formulation of mixtures for specific design uses, on-site and lab-based product quality control, and customized delivery programs. The Aggregate Products segment offers crushed stone, sand, and gravel for use in commercial, industrial, and public works projects. The company's other products include building materials stores, hauling operations, aggregates distribution terminals, a recycled aggregates operation and concrete blocks, as well as products, including ARIDUS Rapid Drying Concrete technology and the Where's My Concrete family of Web and mobile applications. It primarily serves concrete general contractors, governmental agencies, and developers, architects, engineers, and home builders. The company was founded in 1997 and is based in Euless, Texas."
USCR,2017-12-31,NA,38600000,21700000,25500000,119200000,279400000,92400000,92400000,-42100000,12400000,1336000000,1243600000,1056600000,-53800000,-600000,26200000,25500000,NA,income_statement,Building Materials,"U S Concrete, Inc.","U.S. Concrete, Inc., through its subsidiaries, produces and sells ready-mixed concrete, aggregates, and concrete-related products and services to the construction industry in the United States, the U.S. Virgin Islands, and Canada. It operates through two segments, Ready-Mixed Concrete and Aggregate Products. The Ready-Mixed Concrete segment engages in the formulation, production, and delivery of ready-mixed concrete to customers' job sites; and the provision of various services that include the formulation of mixtures for specific design uses, on-site and lab-based product quality control, and customized delivery programs. The Aggregate Products segment offers crushed stone, sand, and gravel for use in commercial, industrial, and public works projects. The company's other products include building materials stores, hauling operations, aggregates distribution terminals, a recycled aggregates operation and concrete blocks, as well as products, including ARIDUS Rapid Drying Concrete technology and the Where's My Concrete family of Web and mobile applications. It primarily serves concrete general contractors, governmental agencies, and developers, architects, engineers, and home builders. The company was founded in 1997 and is based in Euless, Texas."
USCR,2018-12-31,NA,48100000,24800000,30000000,125800000,294200000,76600000,76600000,-46400000,16800000,1506400000,1429800000,1212200000,-28500000,NA,31300000,30000000,NA,income_statement,Building Materials,"U S Concrete, Inc.","U.S. Concrete, Inc., through its subsidiaries, produces and sells ready-mixed concrete, aggregates, and concrete-related products and services to the construction industry in the United States, the U.S. Virgin Islands, and Canada. It operates through two segments, Ready-Mixed Concrete and Aggregate Products. The Ready-Mixed Concrete segment engages in the formulation, production, and delivery of ready-mixed concrete to customers' job sites; and the provision of various services that include the formulation of mixtures for specific design uses, on-site and lab-based product quality control, and customized delivery programs. The Aggregate Products segment offers crushed stone, sand, and gravel for use in commercial, industrial, and public works projects. The company's other products include building materials stores, hauling operations, aggregates distribution terminals, a recycled aggregates operation and concrete blocks, as well as products, including ARIDUS Rapid Drying Concrete technology and the Where's My Concrete family of Web and mobile applications. It primarily serves concrete general contractors, governmental agencies, and developers, architects, engineers, and home builders. The company was founded in 1997 and is based in Euless, Texas."
USCR,2019-12-31,NA,28600000,26200000,14900000,130000000,291100000,67900000,67900000,-46100000,12300000,1478700000,1410800000,1187600000,-39300000,NA,16300000,14900000,NA,income_statement,Building Materials,"U S Concrete, Inc.","U.S. Concrete, Inc., through its subsidiaries, produces and sells ready-mixed concrete, aggregates, and concrete-related products and services to the construction industry in the United States, the U.S. Virgin Islands, and Canada. It operates through two segments, Ready-Mixed Concrete and Aggregate Products. The Ready-Mixed Concrete segment engages in the formulation, production, and delivery of ready-mixed concrete to customers' job sites; and the provision of various services that include the formulation of mixtures for specific design uses, on-site and lab-based product quality control, and customized delivery programs. The Aggregate Products segment offers crushed stone, sand, and gravel for use in commercial, industrial, and public works projects. The company's other products include building materials stores, hauling operations, aggregates distribution terminals, a recycled aggregates operation and concrete blocks, as well as products, including ARIDUS Rapid Drying Concrete technology and the Where's My Concrete family of Web and mobile applications. It primarily serves concrete general contractors, governmental agencies, and developers, architects, engineers, and home builders. The company was founded in 1997 and is based in Euless, Texas."
USEG,2016-12-31,NA,-11672000,NA,-14120000,2847000,3018000,-2552000,-2552000,-442000,0,5746000,8298000,2728000,-9120000,-2448000,-11672000,-14120000,194000,income_statement,Oil & Gas E&P,U.S. Energy Corp.,"U.S. Energy Corp., an independent energy company, focuses on the acquisition, exploration, and development of oil and natural gas properties in the United States. It holds interests in various oil and gas properties primarily in North Dakota and South Texas. The company was founded in 1966 and is based in Houston, Texas."
USEG,2017-12-31,NA,-1361000,NA,-1361000,3379000,3143000,-1015000,-1015000,-513000,0,6046000,7061000,2903000,-346000,NA,-1361000,-1656000,26000,income_statement,Oil & Gas E&P,U.S. Energy Corp.,"U.S. Energy Corp., an independent energy company, focuses on the acquisition, exploration, and development of oil and natural gas properties in the United States. It holds interests in various oil and gas properties primarily in North Dakota and South Texas. The company was founded in 1966 and is based in Houston, Texas."
USEG,2018-12-31,NA,-1040000,NA,-1040000,3594797,3249000,-1234797,-1234797,-106000,0,5147000,6381797,1898000,194797,NA,-1040000,-1369000,122000,income_statement,Oil & Gas E&P,U.S. Energy Corp.,"U.S. Energy Corp., an independent energy company, focuses on the acquisition, exploration, and development of oil and natural gas properties in the United States. It holds interests in various oil and gas properties primarily in North Dakota and South Texas. The company was founded in 1966 and is based in Houston, Texas."
USEG,2019-12-31,NA,-550000,NA,-550000,3065000,4296000,510000,510000,-20000,0,6144000,5634000,1848000,-1060000,NA,-550000,-922000,NA,income_statement,Oil & Gas E&P,U.S. Energy Corp.,"U.S. Energy Corp., an independent energy company, focuses on the acquisition, exploration, and development of oil and natural gas properties in the United States. It holds interests in various oil and gas properties primarily in North Dakota and South Texas. The company was founded in 1966 and is based in Houston, Texas."
USIO,2016-12-31,NA,-1163974,NA,-1196642,4241977,3783004,-1360573,-1360573,NA,32668,12076358,13436931,8293354,196599,NA,-1196642,-1196642,NA,income_statement,Information Technology Services,"Usio, Inc.","Usio, Inc., together with its subsidiaries, provides integrated electronic payment processing services to merchants and businesses in the United States. The company offers various types of automated clearing house (ACH) processing; and credit, prepaid card, and debit card-based processing services. Its ACH processing services include Represented Check, a consumer non-sufficient funds check that is represented for payment electronically rather than through the paper check collection system; and Accounts Receivable Check Conversion, a consumer paper check payment that is converted into an e-check. The company also offers merchant account services for the processing of card-based transactions through the VISA, MasterCard, American Express, Discover, and JCB networks, including online terminal services accessed through a website or retail services accessed through a physical terminal. In addition, it provides a proprietary web-based customer service application that allows companies to process one-time and recurring payments through e-checks or credit cards; and an interactive voice response telephone system to companies, which accept payments directly from consumers over the telephone using e-checks or credit cards. Further, the company offers prepaid and incentive card issuance services; and operates a prepaid core-processing platform. It markets and sells ACH products and services primarily through resellers; and markets and sells prepaid card program directly to corporations and to consumers through the internet. The company was formerly known as Payment Data Systems, Inc. and changed its name to Usio, Inc. in June 2019. Usio, Inc. was founded in 1998 and is headquartered in San Antonio, Texas."
USIO,2017-12-31,NA,-2734469,NA,-3008785,5347110,3768226,-2837016,-2837016,NA,274316,14571158,17408174,10802932,102547,NA,-3008785,-3008785,NA,income_statement,Information Technology Services,"Usio, Inc.","Usio, Inc., together with its subsidiaries, provides integrated electronic payment processing services to merchants and businesses in the United States. The company offers various types of automated clearing house (ACH) processing; and credit, prepaid card, and debit card-based processing services. Its ACH processing services include Represented Check, a consumer non-sufficient funds check that is represented for payment electronically rather than through the paper check collection system; and Accounts Receivable Check Conversion, a consumer paper check payment that is converted into an e-check. The company also offers merchant account services for the processing of card-based transactions through the VISA, MasterCard, American Express, Discover, and JCB networks, including online terminal services accessed through a website or retail services accessed through a physical terminal. In addition, it provides a proprietary web-based customer service application that allows companies to process one-time and recurring payments through e-checks or credit cards; and an interactive voice response telephone system to companies, which accept payments directly from consumers over the telephone using e-checks or credit cards. Further, the company offers prepaid and incentive card issuance services; and operates a prepaid core-processing platform. It markets and sells ACH products and services primarily through resellers; and markets and sells prepaid card program directly to corporations and to consumers through the internet. The company was formerly known as Payment Data Systems, Inc. and changed its name to Usio, Inc. in June 2019. Usio, Inc. was founded in 1998 and is headquartered in San Antonio, Texas."
USIO,2018-12-31,NA,-3698035,NA,-3775815,7468384,5569513,-3774509,-3774509,NA,77780,25024124,28798633,19454611,76474,NA,-3775815,-3775815,NA,income_statement,Information Technology Services,"Usio, Inc.","Usio, Inc., together with its subsidiaries, provides integrated electronic payment processing services to merchants and businesses in the United States. The company offers various types of automated clearing house (ACH) processing; and credit, prepaid card, and debit card-based processing services. Its ACH processing services include Represented Check, a consumer non-sufficient funds check that is represented for payment electronically rather than through the paper check collection system; and Accounts Receivable Check Conversion, a consumer paper check payment that is converted into an e-check. The company also offers merchant account services for the processing of card-based transactions through the VISA, MasterCard, American Express, Discover, and JCB networks, including online terminal services accessed through a website or retail services accessed through a physical terminal. In addition, it provides a proprietary web-based customer service application that allows companies to process one-time and recurring payments through e-checks or credit cards; and an interactive voice response telephone system to companies, which accept payments directly from consumers over the telephone using e-checks or credit cards. Further, the company offers prepaid and incentive card issuance services; and operates a prepaid core-processing platform. It markets and sells ACH products and services primarily through resellers; and markets and sells prepaid card program directly to corporations and to consumers through the internet. The company was formerly known as Payment Data Systems, Inc. and changed its name to Usio, Inc. in June 2019. Usio, Inc. was founded in 1998 and is headquartered in San Antonio, Texas."
USIO,2019-12-31,NA,-5013859,NA,-5115747,8989686,5949210,-5062996,-5062996,NA,101888,28200535,33263531,22251325,49137,NA,-5115747,-5115747,NA,income_statement,Information Technology Services,"Usio, Inc.","Usio, Inc., together with its subsidiaries, provides integrated electronic payment processing services to merchants and businesses in the United States. The company offers various types of automated clearing house (ACH) processing; and credit, prepaid card, and debit card-based processing services. Its ACH processing services include Represented Check, a consumer non-sufficient funds check that is represented for payment electronically rather than through the paper check collection system; and Accounts Receivable Check Conversion, a consumer paper check payment that is converted into an e-check. The company also offers merchant account services for the processing of card-based transactions through the VISA, MasterCard, American Express, Discover, and JCB networks, including online terminal services accessed through a website or retail services accessed through a physical terminal. In addition, it provides a proprietary web-based customer service application that allows companies to process one-time and recurring payments through e-checks or credit cards; and an interactive voice response telephone system to companies, which accept payments directly from consumers over the telephone using e-checks or credit cards. Further, the company offers prepaid and incentive card issuance services; and operates a prepaid core-processing platform. It markets and sells ACH products and services primarily through resellers; and markets and sells prepaid card program directly to corporations and to consumers through the internet. The company was formerly known as Payment Data Systems, Inc. and changed its name to Usio, Inc. in June 2019. Usio, Inc. was founded in 1998 and is headquartered in San Antonio, Texas."
USLM,2017-12-31,NA,24943000,NA,27148000,10153000,50720000,24227000,24227000,-241000,-2205000,144844000,120617000,94124000,716000,NA,27148000,27148000,10153000,income_statement,Building Materials,"United States Lime & Minerals,","United States Lime & Minerals, Inc. manufactures and supplies lime and limestone products in the United States. The company extracts limestone from open-pit quarries and an underground mine, and processes it as pulverized limestone, quicklime, hydrated lime, and lime slurry. It supplies its products primarily to the construction customers, including highway, road, and building contractors; industrial customers, such as paper and glass manufacturers; environmental customers comprising municipal sanitation and water treatment facilities, and flue gas treatment processes; steel producers; oil and gas services companies; roof shingle manufacturers; and poultry and cattle feed producers. The company also has various royalty interests and non-operating working interests with respect to oil and gas rights in natural gas wells located in Johnson County, Texas in the Barnett Shale Formation. United States Lime & Minerals, Inc. was founded in 1948 and is headquartered in Dallas, Texas."
USLM,2018-12-31,NA,21568000,NA,19685000,10484000,47877000,20002000,20002000,-243000,1883000,144435000,124433000,96558000,1566000,NA,19685000,19685000,NA,income_statement,Building Materials,"United States Lime & Minerals,","United States Lime & Minerals, Inc. manufactures and supplies lime and limestone products in the United States. The company extracts limestone from open-pit quarries and an underground mine, and processes it as pulverized limestone, quicklime, hydrated lime, and lime slurry. It supplies its products primarily to the construction customers, including highway, road, and building contractors; industrial customers, such as paper and glass manufacturers; environmental customers comprising municipal sanitation and water treatment facilities, and flue gas treatment processes; steel producers; oil and gas services companies; roof shingle manufacturers; and poultry and cattle feed producers. The company also has various royalty interests and non-operating working interests with respect to oil and gas rights in natural gas wells located in Johnson County, Texas in the Barnett Shale Formation. United States Lime & Minerals, Inc. was founded in 1948 and is headquartered in Dallas, Texas."
USLM,2019-12-31,NA,30900000,NA,26056000,11500000,59070000,29246000,29246000,-244000,4844000,158277000,129031000,99207000,1654000,NA,26056000,26056000,NA,income_statement,Building Materials,"United States Lime & Minerals,","United States Lime & Minerals, Inc. manufactures and supplies lime and limestone products in the United States. The company extracts limestone from open-pit quarries and an underground mine, and processes it as pulverized limestone, quicklime, hydrated lime, and lime slurry. It supplies its products primarily to the construction customers, including highway, road, and building contractors; industrial customers, such as paper and glass manufacturers; environmental customers comprising municipal sanitation and water treatment facilities, and flue gas treatment processes; steel producers; oil and gas services companies; roof shingle manufacturers; and poultry and cattle feed producers. The company also has various royalty interests and non-operating working interests with respect to oil and gas rights in natural gas wells located in Johnson County, Texas in the Barnett Shale Formation. United States Lime & Minerals, Inc. was founded in 1948 and is headquartered in Dallas, Texas."
USLM,2020-12-31,NA,34072000,NA,28223000,12168000,47587000,33869000,33869000,-248000,5849000,160704000,126835000,113117000,203000,NA,28223000,28223000,NA,income_statement,Building Materials,"United States Lime & Minerals,","United States Lime & Minerals, Inc. manufactures and supplies lime and limestone products in the United States. The company extracts limestone from open-pit quarries and an underground mine, and processes it as pulverized limestone, quicklime, hydrated lime, and lime slurry. It supplies its products primarily to the construction customers, including highway, road, and building contractors; industrial customers, such as paper and glass manufacturers; environmental customers comprising municipal sanitation and water treatment facilities, and flue gas treatment processes; steel producers; oil and gas services companies; roof shingle manufacturers; and poultry and cattle feed producers. The company also has various royalty interests and non-operating working interests with respect to oil and gas rights in natural gas wells located in Johnson County, Texas in the Barnett Shale Formation. United States Lime & Minerals, Inc. was founded in 1948 and is headquartered in Dallas, Texas."
USWS,2016-12-31,NA,-95404000,52798000,-95404000,8564000,33247000,-41401000,-41401000,-45376000,0,294755000,336156000,261508000,-54003000,NA,-95404000,-92305000,NA,income_statement,Oil & Gas Midstream,"U.S. Well Services, Inc.","U.S. Well Services, Inc. operates as an oilfield service company in the United States. It provides hydraulic fracturing services to the oil and natural gas exploration and production companies. The company is headquartered in Houston, Texas."
USWS,2017-12-31,NA,-99276000,52798000,-99276000,20008000,78302000,-39056000,-39056000,-27028000,0,499354000,538410000,421052000,-60220000,NA,-99276000,-99276000,NA,income_statement,Oil & Gas Midstream,"U.S. Well Services, Inc.","U.S. Well Services, Inc. operates as an oilfield service company in the United States. It provides hydraulic fracturing services to the oil and natural gas exploration and production companies. The company is headquartered in Houston, Texas."
USWS,2018-12-31,NA,-70462000,52798000,-65896000,36412000,117731000,-27121000,-27121000,-32636000,352000,648847000,675968000,531116000,-43341000,NA,-70814000,-63754000,NA,income_statement,Oil & Gas Midstream,"U.S. Well Services, Inc.","U.S. Well Services, Inc. operates as an oilfield service company in the United States. It provides hydraulic fracturing services to the oil and natural gas exploration and production companies. The company is headquartered in Houston, Texas."
USWS,2019-12-31,NA,-116159000,10633000,-93913000,33986000,132930000,-55205000,-55205000,-30099000,-77000,514757000,569962000,381827000,-60954000,NA,-116082000,-106254000,NA,income_statement,Oil & Gas Midstream,"U.S. Well Services, Inc.","U.S. Well Services, Inc. operates as an oilfield service company in the United States. It provides hydraulic fracturing services to the oil and natural gas exploration and production companies. The company is headquartered in Houston, Texas."
UTHR,2016-12-31,147600000,1060200000,NA,713700000,319300000,1526100000,1059200000,1059200000,-3900000,346500000,1598800000,539600000,72700000,1000000,NA,713700000,713700000,NA,income_statement,Biotechnology,United Therapeutics Corporation,"United Therapeutics Corporation, a biotechnology company, develops and commercializes products to address the unmet medical needs of patients with chronic and life-threatening diseases primarily in the United States and internationally. The company's commercial therapies include Remodulin, an infused formulation of the prostacyclin analogue treprostinil for subcutaneous and intravenous administration to diminish symptoms associated with exercise in pulmonary arterial hypertension (PAH) patients; Tyvaso, an inhaled formulation of treprostinil to enhace the exercise ability in PAH patients; Orenitram, a tablet dosage form of treprostinil to enhance the exercise capacity in PAH patients; Adcirca, an oral PDE-5 inhibitor to enhance the exercise ability in PAH patients; and Unituxin, a monoclonal antibody for treating neuroblastoma. It also engages in developing OreniPro, RemoPro, Treprostinil Technosphere, Trevyent, Ralinepag, and Aurora-GT to treat PAH; LNG01 to treat IPF; Unexisome to treat BPD; and the research and development of various organ transplantation-related technologies, including regenerative medicine, xenotransplantation, biomechanical lungs, and ex-vivo lung perfusion, as well as the development of medicine for other diseases. The company has licensing and collaboration agreements with Medtronic, Inc. to develop and commercialize the implantable system for Remodulin; Caremark, L.L.C. to provide refills of implanted pumps at its infusion centers; DEKA Research & Development Corp. to develop a semi-disposable system for the subcutaneous delivery of Remodulin; MannKind Corporation to develop and license treprostinil inhalation powder, and Dreamboat and Cricket devices; Arena Pharmaceuticals, Inc. to develop ralinepag for the treatment of PAH; and Samumed LLC to develop LNG01. The company was founded in 1996 and is headquartered in Silver Spring, Maryland."
UTHR,2017-12-31,264600000,769500000,NA,417900000,332600000,1619600000,1022400000,1022400000,-9000000,351600000,1725300000,702900000,105700000,-252900000,NA,417900000,417900000,NA,income_statement,Biotechnology,United Therapeutics Corporation,"United Therapeutics Corporation, a biotechnology company, develops and commercializes products to address the unmet medical needs of patients with chronic and life-threatening diseases primarily in the United States and internationally. The company's commercial therapies include Remodulin, an infused formulation of the prostacyclin analogue treprostinil for subcutaneous and intravenous administration to diminish symptoms associated with exercise in pulmonary arterial hypertension (PAH) patients; Tyvaso, an inhaled formulation of treprostinil to enhace the exercise ability in PAH patients; Orenitram, a tablet dosage form of treprostinil to enhance the exercise capacity in PAH patients; Adcirca, an oral PDE-5 inhibitor to enhance the exercise ability in PAH patients; and Unituxin, a monoclonal antibody for treating neuroblastoma. It also engages in developing OreniPro, RemoPro, Treprostinil Technosphere, Trevyent, Ralinepag, and Aurora-GT to treat PAH; LNG01 to treat IPF; Unexisome to treat BPD; and the research and development of various organ transplantation-related technologies, including regenerative medicine, xenotransplantation, biomechanical lungs, and ex-vivo lung perfusion, as well as the development of medicine for other diseases. The company has licensing and collaboration agreements with Medtronic, Inc. to develop and commercialize the implantable system for Remodulin; Caremark, L.L.C. to provide refills of implanted pumps at its infusion centers; DEKA Research & Development Corp. to develop a semi-disposable system for the subcutaneous delivery of Remodulin; MannKind Corporation to develop and license treprostinil inhalation powder, and Dreamboat and Cricket devices; Arena Pharmaceuticals, Inc. to develop ralinepag for the treatment of PAH; and Samumed LLC to develop LNG01. The company was founded in 1996 and is headquartered in Silver Spring, Maryland."
UTHR,2018-12-31,357900000,758900000,NA,589200000,268700000,1429100000,802500000,802500000,-13900000,169700000,1627800000,825300000,198700000,-43600000,NA,589200000,589200000,NA,income_statement,Biotechnology,United Therapeutics Corporation,"United Therapeutics Corporation, a biotechnology company, develops and commercializes products to address the unmet medical needs of patients with chronic and life-threatening diseases primarily in the United States and internationally. The company's commercial therapies include Remodulin, an infused formulation of the prostacyclin analogue treprostinil for subcutaneous and intravenous administration to diminish symptoms associated with exercise in pulmonary arterial hypertension (PAH) patients; Tyvaso, an inhaled formulation of treprostinil to enhace the exercise ability in PAH patients; Orenitram, a tablet dosage form of treprostinil to enhance the exercise capacity in PAH patients; Adcirca, an oral PDE-5 inhibitor to enhance the exercise ability in PAH patients; and Unituxin, a monoclonal antibody for treating neuroblastoma. It also engages in developing OreniPro, RemoPro, Treprostinil Technosphere, Trevyent, Ralinepag, and Aurora-GT to treat PAH; LNG01 to treat IPF; Unexisome to treat BPD; and the research and development of various organ transplantation-related technologies, including regenerative medicine, xenotransplantation, biomechanical lungs, and ex-vivo lung perfusion, as well as the development of medicine for other diseases. The company has licensing and collaboration agreements with Medtronic, Inc. to develop and commercialize the implantable system for Remodulin; Caremark, L.L.C. to provide refills of implanted pumps at its infusion centers; DEKA Research & Development Corp. to develop a semi-disposable system for the subcutaneous delivery of Remodulin; MannKind Corporation to develop and license treprostinil inhalation powder, and Dreamboat and Cricket devices; Arena Pharmaceuticals, Inc. to develop ralinepag for the treatment of PAH; and Samumed LLC to develop LNG01. The company was founded in 1996 and is headquartered in Silver Spring, Maryland."
UTHR,2019-12-31,1173800000,-165000000,NA,-104500000,335000000,1331200000,-177600000,-177600000,-44200000,-60500000,1448800000,1626400000,117600000,12600000,NA,-104500000,-104500000,NA,income_statement,Biotechnology,United Therapeutics Corporation,"United Therapeutics Corporation, a biotechnology company, develops and commercializes products to address the unmet medical needs of patients with chronic and life-threatening diseases primarily in the United States and internationally. The company's commercial therapies include Remodulin, an infused formulation of the prostacyclin analogue treprostinil for subcutaneous and intravenous administration to diminish symptoms associated with exercise in pulmonary arterial hypertension (PAH) patients; Tyvaso, an inhaled formulation of treprostinil to enhace the exercise ability in PAH patients; Orenitram, a tablet dosage form of treprostinil to enhance the exercise capacity in PAH patients; Adcirca, an oral PDE-5 inhibitor to enhance the exercise ability in PAH patients; and Unituxin, a monoclonal antibody for treating neuroblastoma. It also engages in developing OreniPro, RemoPro, Treprostinil Technosphere, Trevyent, Ralinepag, and Aurora-GT to treat PAH; LNG01 to treat IPF; Unexisome to treat BPD; and the research and development of various organ transplantation-related technologies, including regenerative medicine, xenotransplantation, biomechanical lungs, and ex-vivo lung perfusion, as well as the development of medicine for other diseases. The company has licensing and collaboration agreements with Medtronic, Inc. to develop and commercialize the implantable system for Remodulin; Caremark, L.L.C. to provide refills of implanted pumps at its infusion centers; DEKA Research & Development Corp. to develop a semi-disposable system for the subcutaneous delivery of Remodulin; MannKind Corporation to develop and license treprostinil inhalation powder, and Dreamboat and Cricket devices; Arena Pharmaceuticals, Inc. to develop ralinepag for the treatment of PAH; and Samumed LLC to develop LNG01. The company was founded in 1996 and is headquartered in Silver Spring, Maryland."
UTMD,2017-12-31,447000,19082000,NA,8505000,6908000,26395000,19040000,19040000,NA,10577000,41414000,22374000,15019000,42000,NA,8505000,8505000,7609000,income_statement,Medical Instruments & Supplies,"Utah Medical Products, Inc.","Utah Medical Products, Inc. manufactures and distributes medical devices for the healthcare industry in the United States, Europe, and internationally. The company offers fetal monitoring accessories, vacuum-assisted delivery systems, and other labor and delivery tools; DISPOSA-HOOD, an infant respiratory hood; and DELTRAN PLUS, a blood pressure monitoring system. It also provides umbilical vessel catheters; DIALY-NATE, a disposable peritoneal dialysis set; PALA-NATE, a silicone oral protection device; URI-CATH, a urinary drainage system; NUTRI-CATH, a feeding device; MYELO-NATE, a lumbar sampling kit; HEMO-NATE, a disposable filter; and catheterization procedure tray of instruments and supplies. In addition, the company offers LETZ system to excise cervical intraepithelial neoplasia; FINESSE+ generators; loop, ball, and needle electrodes; FILTRESSE evacuators; other specialty electrodes and supplies, and gynecologic tools; Femcare trocars, cannulae, laparoscopic instruments, and accessories; and EPITOME, an electrosurgical scalpel. Further, it provides Filshie Clip system, a female surgical contraception; PATHFINDER PLUS, an endoscopic irrigation device; suprapubic catheterization; LIBERTY system to treat and control urinary incontinence in women; ENDOCURETTE, a curette for uterine endometrial tissue sampling; TVUS/HSG-Cath to assess abnormal or dysfunctional uterine bleeding and other suspected abnormalities of the uterus; and LUMIN to manipulate the uterus in laparoscopic procedures. Additionally, the company offers DELTRAN, a disposable pressure transducer; and pressure monitoring accessories, components, and other molded parts. It serves neonatal intensive care units, labor and delivery departments, women's health centers in hospitals, outpatient clinics, and physician's offices through direct customer service and sales force, independent consultants and manufacturer representatives. The company was founded in 1978 and is headquartered in Midvale, Utah."
UTMD,2018-12-31,454000,19459000,NA,18555000,7163000,26306000,18689000,18689000,NA,904000,41998000,23309000,15692000,770000,NA,18555000,18555000,7609000,income_statement,Medical Instruments & Supplies,"Utah Medical Products, Inc.","Utah Medical Products, Inc. manufactures and distributes medical devices for the healthcare industry in the United States, Europe, and internationally. The company offers fetal monitoring accessories, vacuum-assisted delivery systems, and other labor and delivery tools; DISPOSA-HOOD, an infant respiratory hood; and DELTRAN PLUS, a blood pressure monitoring system. It also provides umbilical vessel catheters; DIALY-NATE, a disposable peritoneal dialysis set; PALA-NATE, a silicone oral protection device; URI-CATH, a urinary drainage system; NUTRI-CATH, a feeding device; MYELO-NATE, a lumbar sampling kit; HEMO-NATE, a disposable filter; and catheterization procedure tray of instruments and supplies. In addition, the company offers LETZ system to excise cervical intraepithelial neoplasia; FINESSE+ generators; loop, ball, and needle electrodes; FILTRESSE evacuators; other specialty electrodes and supplies, and gynecologic tools; Femcare trocars, cannulae, laparoscopic instruments, and accessories; and EPITOME, an electrosurgical scalpel. Further, it provides Filshie Clip system, a female surgical contraception; PATHFINDER PLUS, an endoscopic irrigation device; suprapubic catheterization; LIBERTY system to treat and control urinary incontinence in women; ENDOCURETTE, a curette for uterine endometrial tissue sampling; TVUS/HSG-Cath to assess abnormal or dysfunctional uterine bleeding and other suspected abnormalities of the uterus; and LUMIN to manipulate the uterus in laparoscopic procedures. Additionally, the company offers DELTRAN, a disposable pressure transducer; and pressure monitoring accessories, components, and other molded parts. It serves neonatal intensive care units, labor and delivery departments, women's health centers in hospitals, outpatient clinics, and physician's offices through direct customer service and sales force, independent consultants and manufacturer representatives. The company was founded in 1978 and is headquartered in Midvale, Utah."
UTMD,2019-12-31,483000,17884000,NA,14727000,11335000,29466000,17648000,17648000,NA,3157000,46904000,29256000,17438000,236000,NA,14727000,14727000,NA,income_statement,Medical Instruments & Supplies,"Utah Medical Products, Inc.","Utah Medical Products, Inc. manufactures and distributes medical devices for the healthcare industry in the United States, Europe, and internationally. The company offers fetal monitoring accessories, vacuum-assisted delivery systems, and other labor and delivery tools; DISPOSA-HOOD, an infant respiratory hood; and DELTRAN PLUS, a blood pressure monitoring system. It also provides umbilical vessel catheters; DIALY-NATE, a disposable peritoneal dialysis set; PALA-NATE, a silicone oral protection device; URI-CATH, a urinary drainage system; NUTRI-CATH, a feeding device; MYELO-NATE, a lumbar sampling kit; HEMO-NATE, a disposable filter; and catheterization procedure tray of instruments and supplies. In addition, the company offers LETZ system to excise cervical intraepithelial neoplasia; FINESSE+ generators; loop, ball, and needle electrodes; FILTRESSE evacuators; other specialty electrodes and supplies, and gynecologic tools; Femcare trocars, cannulae, laparoscopic instruments, and accessories; and EPITOME, an electrosurgical scalpel. Further, it provides Filshie Clip system, a female surgical contraception; PATHFINDER PLUS, an endoscopic irrigation device; suprapubic catheterization; LIBERTY system to treat and control urinary incontinence in women; ENDOCURETTE, a curette for uterine endometrial tissue sampling; TVUS/HSG-Cath to assess abnormal or dysfunctional uterine bleeding and other suspected abnormalities of the uterus; and LUMIN to manipulate the uterus in laparoscopic procedures. Additionally, the company offers DELTRAN, a disposable pressure transducer; and pressure monitoring accessories, components, and other molded parts. It serves neonatal intensive care units, labor and delivery departments, women's health centers in hospitals, outpatient clinics, and physician's offices through direct customer service and sales force, independent consultants and manufacturer representatives. The company was founded in 1978 and is headquartered in Midvale, Utah."
UTMD,2020-12-31,486000,13840000,NA,10798000,11354000,25548000,13708000,13708000,NA,3042000,42178000,28470000,16630000,132000,NA,10798000,10798000,NA,income_statement,Medical Instruments & Supplies,"Utah Medical Products, Inc.","Utah Medical Products, Inc. manufactures and distributes medical devices for the healthcare industry in the United States, Europe, and internationally. The company offers fetal monitoring accessories, vacuum-assisted delivery systems, and other labor and delivery tools; DISPOSA-HOOD, an infant respiratory hood; and DELTRAN PLUS, a blood pressure monitoring system. It also provides umbilical vessel catheters; DIALY-NATE, a disposable peritoneal dialysis set; PALA-NATE, a silicone oral protection device; URI-CATH, a urinary drainage system; NUTRI-CATH, a feeding device; MYELO-NATE, a lumbar sampling kit; HEMO-NATE, a disposable filter; and catheterization procedure tray of instruments and supplies. In addition, the company offers LETZ system to excise cervical intraepithelial neoplasia; FINESSE+ generators; loop, ball, and needle electrodes; FILTRESSE evacuators; other specialty electrodes and supplies, and gynecologic tools; Femcare trocars, cannulae, laparoscopic instruments, and accessories; and EPITOME, an electrosurgical scalpel. Further, it provides Filshie Clip system, a female surgical contraception; PATHFINDER PLUS, an endoscopic irrigation device; suprapubic catheterization; LIBERTY system to treat and control urinary incontinence in women; ENDOCURETTE, a curette for uterine endometrial tissue sampling; TVUS/HSG-Cath to assess abnormal or dysfunctional uterine bleeding and other suspected abnormalities of the uterus; and LUMIN to manipulate the uterus in laparoscopic procedures. Additionally, the company offers DELTRAN, a disposable pressure transducer; and pressure monitoring accessories, components, and other molded parts. It serves neonatal intensive care units, labor and delivery departments, women's health centers in hospitals, outpatient clinics, and physician's offices through direct customer service and sales force, independent consultants and manufacturer representatives. The company was founded in 1978 and is headquartered in Midvale, Utah."
UVSP,2017-12-31,NA,61811000,NA,44094000,106471000,191635000,0,62558000,NA,17717000,191635000,129077000,0,-747000,NA,44094000,44094000,22606000,income_statement,Banks—Regional,Univest Financial Corporation,"Univest Financial Corporation operates as the bank holding company for Univest Bank and Trust Co. that provides banking products and services primarily in Pennsylvania. It operates through three segments: Banking, Wealth Management, and Insurance. The Banking segment provides a range of banking services, such as deposit taking, loan origination and servicing, mortgage banking, other general banking services, and equipment lease financing for individuals, businesses, municipalities, and nonprofit organizations. The Wealth Management segment offers trust and investment advisory services, guardian and custodian of employee benefits, and other trust and brokerage services, as well as manages private investment accounts for individuals and institutions. The Insurance segment provides commercial property and casualty insurance, group life and health coverage, employee benefits solutions, personal insurance lines, and human resources consulting services. It serves customers in Bucks, Berks, Chester, Cumberland, Dauphin, Delaware, Lancaster, Lehigh, Montgomery, Northampton, Philadelphia, and York counties in Pennsylvania; and Atlantic and Cape May counties in New Jersey through 39 banking offices. The company was formerly known as Univest Corporation of Pennsylvania and changed its name to Univest Financial Corporation in January 2019. Univest Financial Corporation was founded in 1876 and is headquartered in Souderton, Pennsylvania."
UVSP,2018-12-31,NA,60686000,NA,50543000,111941000,197479000,0,62647000,NA,10143000,197479000,134832000,0,-1961000,NA,50543000,50543000,22891000,income_statement,Banks—Regional,Univest Financial Corporation,"Univest Financial Corporation operates as the bank holding company for Univest Bank and Trust Co. that provides banking products and services primarily in Pennsylvania. It operates through three segments: Banking, Wealth Management, and Insurance. The Banking segment provides a range of banking services, such as deposit taking, loan origination and servicing, mortgage banking, other general banking services, and equipment lease financing for individuals, businesses, municipalities, and nonprofit organizations. The Wealth Management segment offers trust and investment advisory services, guardian and custodian of employee benefits, and other trust and brokerage services, as well as manages private investment accounts for individuals and institutions. The Insurance segment provides commercial property and casualty insurance, group life and health coverage, employee benefits solutions, personal insurance lines, and human resources consulting services. It serves customers in Bucks, Berks, Chester, Cumberland, Dauphin, Delaware, Lancaster, Lehigh, Montgomery, Northampton, Philadelphia, and York counties in Pennsylvania; and Atlantic and Cape May counties in New Jersey through 39 banking offices. The company was formerly known as Univest Corporation of Pennsylvania and changed its name to Univest Financial Corporation in January 2019. Univest Financial Corporation was founded in 1876 and is headquartered in Souderton, Pennsylvania."
UVSP,2019-12-31,NA,80053000,NA,65719000,121287000,226136000,0,81702000,NA,14334000,226136000,144434000,0,-1649000,NA,65719000,65719000,23147000,income_statement,Banks—Regional,Univest Financial Corporation,"Univest Financial Corporation operates as the bank holding company for Univest Bank and Trust Co. that provides banking products and services primarily in Pennsylvania. It operates through three segments: Banking, Wealth Management, and Insurance. The Banking segment provides a range of banking services, such as deposit taking, loan origination and servicing, mortgage banking, other general banking services, and equipment lease financing for individuals, businesses, municipalities, and nonprofit organizations. The Wealth Management segment offers trust and investment advisory services, guardian and custodian of employee benefits, and other trust and brokerage services, as well as manages private investment accounts for individuals and institutions. The Insurance segment provides commercial property and casualty insurance, group life and health coverage, employee benefits solutions, personal insurance lines, and human resources consulting services. It serves customers in Bucks, Berks, Chester, Cumberland, Dauphin, Delaware, Lancaster, Lehigh, Montgomery, Northampton, Philadelphia, and York counties in Pennsylvania; and Atlantic and Cape May counties in New Jersey through 39 banking offices. The company was formerly known as Univest Corporation of Pennsylvania and changed its name to Univest Financial Corporation in January 2019. Univest Financial Corporation was founded in 1876 and is headquartered in Souderton, Pennsylvania."
UVSP,2020-12-31,NA,56897000,NA,46916000,126053000,211895000,0,60927000,NA,9981000,211895000,150968000,0,-4030000,NA,46916000,46916000,24915000,income_statement,Banks—Regional,Univest Financial Corporation,"Univest Financial Corporation operates as the bank holding company for Univest Bank and Trust Co. that provides banking products and services primarily in Pennsylvania. It operates through three segments: Banking, Wealth Management, and Insurance. The Banking segment provides a range of banking services, such as deposit taking, loan origination and servicing, mortgage banking, other general banking services, and equipment lease financing for individuals, businesses, municipalities, and nonprofit organizations. The Wealth Management segment offers trust and investment advisory services, guardian and custodian of employee benefits, and other trust and brokerage services, as well as manages private investment accounts for individuals and institutions. The Insurance segment provides commercial property and casualty insurance, group life and health coverage, employee benefits solutions, personal insurance lines, and human resources consulting services. It serves customers in Bucks, Berks, Chester, Cumberland, Dauphin, Delaware, Lancaster, Lehigh, Montgomery, Northampton, Philadelphia, and York counties in Pennsylvania; and Atlantic and Cape May counties in New Jersey through 39 banking offices. The company was formerly known as Univest Corporation of Pennsylvania and changed its name to Univest Financial Corporation in January 2019. Univest Financial Corporation was founded in 1876 and is headquartered in Souderton, Pennsylvania."
UXIN,2017-12-31,124513000,-1268613000,-10881000,-2722596000,568400000,216398000,-390077000,-390077000,-199000,211000,309133000,699210000,92735000,-878536000,-1478974000,-1268824000,-3773205000,-1925000,income_statement,Internet Content & Information,Uxin Limited,"Uxin Limited, an investment holding company, operates a used car e-commerce platform in China. It provides selection of used cars, evaluation of car condition, various car-related value-added products and services, and supporting services to online used car transactions under the Uxin Used Car brand; and operates Uxin Auction, an application that helps business buyers to source vehicles through online auctions. The company also facilitates used car transaction services, and financing solutions offered by third-party financing partners to buyers for their used car purchases through websites, xin.com and youxinpai.com. Uxin Limited was founded in 2011 and is headquartered in Beijing, China."
UXIN,2018-12-31,124513000,-1350117000,-2490000,-1522514000,2559118000,240238000,-2484019000,-2484019000,-63880000,1644000,659090000,3143109000,418852000,1133902000,-186524000,-1351761000,-2386238000,-1925000,income_statement,Internet Content & Information,Uxin Limited,"Uxin Limited, an investment holding company, operates a used car e-commerce platform in China. It provides selection of used cars, evaluation of car condition, various car-related value-added products and services, and supporting services to online used car transactions under the Uxin Used Car brand; and operates Uxin Auction, an application that helps business buyers to source vehicles through online auctions. The company also facilitates used car transaction services, and financing solutions offered by third-party financing partners to buyers for their used car purchases through websites, xin.com and youxinpai.com. Uxin Limited was founded in 2011 and is headquartered in Beijing, China."
UXIN,2019-12-31,140006000,-1330232000,-4048000,-1988676000,1587037000,898739000,-1097751000,-1097751000,-112587000,-2554000,1588031000,2685782000,689292000,-232481000,-662450000,-1327678000,-1988676000,-1925000,income_statement,Internet Content & Information,Uxin Limited,"Uxin Limited, an investment holding company, operates a used car e-commerce platform in China. It provides selection of used cars, evaluation of car condition, various car-related value-added products and services, and supporting services to online used car transactions under the Uxin Used Car brand; and operates Uxin Auction, an application that helps business buyers to source vehicles through online auctions. The company also facilitates used car transaction services, and financing solutions offered by third-party financing partners to buyers for their used car purchases through websites, xin.com and youxinpai.com. Uxin Limited was founded in 2011 and is headquartered in Beijing, China."
UXIN,2020-03-31,124704000,-8136236000,-154000,-9936716000,1057716000,-27412000,-985660000,-985660000,-116116000,1304000,415444000,1401104000,442856000,-7150576000,-1820708000,-8137540000,-9936716000,-224172000,income_statement,Internet Content & Information,Uxin Limited,"Uxin Limited, an investment holding company, operates a used car e-commerce platform in China. It provides selection of used cars, evaluation of car condition, various car-related value-added products and services, and supporting services to online used car transactions under the Uxin Used Car brand; and operates Uxin Auction, an application that helps business buyers to source vehicles through online auctions. The company also facilitates used car transaction services, and financing solutions offered by third-party financing partners to buyers for their used car purchases through websites, xin.com and youxinpai.com. Uxin Limited was founded in 2011 and is headquartered in Beijing, China."
V,2017-09-30,NA,11694000000,NA,6699000000,4820000000,17738000000,12362000000,12362000000,-563000000,4995000000,18358000000,5996000000,620000000,-668000000,NA,6699000000,6467000000,NA,income_statement,NA,NA,NA
V,2018-09-30,NA,12806000000,NA,10301000000,5706000000,19923000000,13604000000,13604000000,-612000000,2505000000,20609000000,7005000000,686000000,-798000000,NA,10301000000,9942000000,NA,income_statement,NA,NA,NA
V,2019-09-30,NA,14884000000,NA,12080000000,6162000000,22256000000,15438000000,15438000000,-533000000,2804000000,22977000000,7539000000,721000000,-554000000,NA,12080000000,11650000000,NA,income_statement,NA,NA,NA
V,2020-09-30,NA,13790000000,NA,10866000000,6227000000,21119000000,14125000000,14125000000,-516000000,2924000000,21846000000,7721000000,727000000,-335000000,NA,10866000000,10475000000,NA,income_statement,NA,NA,NA
VALU,2017-04-30,NA,15485000,NA,10367000,26175000,25511000,-664000,-664000,NA,5118000,34574000,35238000,9063000,16149000,NA,10367000,10367000,NA,income_statement,Financial Data & Stock Exchanges,"Value Line, Inc.","Value Line, Inc., together with its subsidiaries, produces and sells investment periodicals and related publications primarily in the United States. Its investment periodicals and related publications cover a range of investments, including stocks, mutual funds, exchange traded funds (ETFs), and options. The company offers research services, such as The Value Line Investment Survey, The Value Line Investment Survey - Small and Mid-Cap, The Value Line 600, and The Value Line Fund Advisor Plus, which provide statistical and text coverage of various investment securities, with an emphasis placed on its proprietary research, analysis, and statistical ranks. It also provides niche newsletters comprising Value Line Select, Value Line Select: Dividend Income & Growth, Value Line Select: ETFs, and The Value Line Special Situations Service that offer information on a less comprehensive basis for securities that are of particular interest to subscribers; digital versions of its products through its Website, www.valueline.com, as well as The Value Line Research Center online platform; and investment analysis software, such as The Value Line Investment Analyzer, which includes data sorting and filtering tools. In addition, the company offers current and historical financial databases comprising DataFile, estimates and projections, and mutual funds through the Internet; and copyright products, which include unit investment trusts, variable annuities, managed accounts, and EFTs. Further, it places advertising on behalf of the company's publications; and provides subscription fulfillment and subscriber relation services. The company serves individual and professional investors, as well as institutions, including municipal and university libraries, and investment firms. Value Line, Inc. was founded in 1931 and is headquartered in New York, New York. Value Line, Inc. is a subsidiary of Arnold Bernhard & Co, Inc."
VALU,2018-04-30,NA,11898000,NA,14738000,27439000,30011000,2572000,2572000,NA,-2840000,35868000,33296000,5857000,9326000,NA,14738000,14738000,NA,income_statement,Financial Data & Stock Exchanges,"Value Line, Inc.","Value Line, Inc., together with its subsidiaries, produces and sells investment periodicals and related publications primarily in the United States. Its investment periodicals and related publications cover a range of investments, including stocks, mutual funds, exchange traded funds (ETFs), and options. The company offers research services, such as The Value Line Investment Survey, The Value Line Investment Survey - Small and Mid-Cap, The Value Line 600, and The Value Line Fund Advisor Plus, which provide statistical and text coverage of various investment securities, with an emphasis placed on its proprietary research, analysis, and statistical ranks. It also provides niche newsletters comprising Value Line Select, Value Line Select: Dividend Income & Growth, Value Line Select: ETFs, and The Value Line Special Situations Service that offer information on a less comprehensive basis for securities that are of particular interest to subscribers; digital versions of its products through its Website, www.valueline.com, as well as The Value Line Research Center online platform; and investment analysis software, such as The Value Line Investment Analyzer, which includes data sorting and filtering tools. In addition, the company offers current and historical financial databases comprising DataFile, estimates and projections, and mutual funds through the Internet; and copyright products, which include unit investment trusts, variable annuities, managed accounts, and EFTs. Further, it places advertising on behalf of the company's publications; and provides subscription fulfillment and subscriber relation services. The company serves individual and professional investors, as well as institutions, including municipal and university libraries, and investment firms. Value Line, Inc. was founded in 1931 and is headquartered in New York, New York. Value Line, Inc. is a subsidiary of Arnold Bernhard & Co, Inc."
VALU,2019-04-30,NA,15226000,NA,11150000,25622000,31035000,5413000,5413000,NA,4076000,36257000,30844000,5222000,9813000,NA,11150000,11150000,NA,income_statement,Financial Data & Stock Exchanges,"Value Line, Inc.","Value Line, Inc., together with its subsidiaries, produces and sells investment periodicals and related publications primarily in the United States. Its investment periodicals and related publications cover a range of investments, including stocks, mutual funds, exchange traded funds (ETFs), and options. The company offers research services, such as The Value Line Investment Survey, The Value Line Investment Survey - Small and Mid-Cap, The Value Line 600, and The Value Line Fund Advisor Plus, which provide statistical and text coverage of various investment securities, with an emphasis placed on its proprietary research, analysis, and statistical ranks. It also provides niche newsletters comprising Value Line Select, Value Line Select: Dividend Income & Growth, Value Line Select: ETFs, and The Value Line Special Situations Service that offer information on a less comprehensive basis for securities that are of particular interest to subscribers; digital versions of its products through its Website, www.valueline.com, as well as The Value Line Research Center online platform; and investment analysis software, such as The Value Line Investment Analyzer, which includes data sorting and filtering tools. In addition, the company offers current and historical financial databases comprising DataFile, estimates and projections, and mutual funds through the Internet; and copyright products, which include unit investment trusts, variable annuities, managed accounts, and EFTs. Further, it places advertising on behalf of the company's publications; and provides subscription fulfillment and subscriber relation services. The company serves individual and professional investors, as well as institutions, including municipal and university libraries, and investment firms. Value Line, Inc. was founded in 1931 and is headquartered in New York, New York. Value Line, Inc. is a subsidiary of Arnold Bernhard & Co, Inc."
VALU,2020-04-30,NA,21484000,NA,15663000,26264000,35354000,9090000,9090000,NA,5821000,40299000,31209000,4945000,12394000,NA,15663000,15663000,NA,income_statement,Financial Data & Stock Exchanges,"Value Line, Inc.","Value Line, Inc., together with its subsidiaries, produces and sells investment periodicals and related publications primarily in the United States. Its investment periodicals and related publications cover a range of investments, including stocks, mutual funds, exchange traded funds (ETFs), and options. The company offers research services, such as The Value Line Investment Survey, The Value Line Investment Survey - Small and Mid-Cap, The Value Line 600, and The Value Line Fund Advisor Plus, which provide statistical and text coverage of various investment securities, with an emphasis placed on its proprietary research, analysis, and statistical ranks. It also provides niche newsletters comprising Value Line Select, Value Line Select: Dividend Income & Growth, Value Line Select: ETFs, and The Value Line Special Situations Service that offer information on a less comprehensive basis for securities that are of particular interest to subscribers; digital versions of its products through its Website, www.valueline.com, as well as The Value Line Research Center online platform; and investment analysis software, such as The Value Line Investment Analyzer, which includes data sorting and filtering tools. In addition, the company offers current and historical financial databases comprising DataFile, estimates and projections, and mutual funds through the Internet; and copyright products, which include unit investment trusts, variable annuities, managed accounts, and EFTs. Further, it places advertising on behalf of the company's publications; and provides subscription fulfillment and subscriber relation services. The company serves individual and professional investors, as well as institutions, including municipal and university libraries, and investment firms. Value Line, Inc. was founded in 1931 and is headquartered in New York, New York. Value Line, Inc. is a subsidiary of Arnold Bernhard & Co, Inc."
VAR,2017-09-29,210000000,303100000,4300000,218500000,556200000,1113900000,347700000,347700000,-10700000,77100000,2619300000,2271600000,1505400000,-44600000,-6800000,226000000,218500000,NA,income_statement,NA,NA,NA
VAR,2018-09-28,233900000,452100000,4300000,149900000,545200000,1273600000,494500000,494500000,-6800000,301800000,2919100000,2424600000,1645500000,-42400000,NA,150300000,149900000,NA,income_statement,NA,NA,NA
VAR,2019-09-27,247600000,420800000,9300000,291900000,624600000,1370300000,498100000,498100000,-8800000,128600000,3225100000,2727000000,1854800000,-77300000,NA,292200000,291900000,NA,income_statement,NA,NA,NA
VAR,2020-10-02,280600000,358300000,9300000,269200000,675000000,1377200000,421600000,421600000,-14000000,88900000,3168200000,2746600000,1791000000,-63300000,NA,269400000,269200000,NA,income_statement,NA,NA,NA
VBFC,2017-12-31,NA,1471000,NA,-3096000,17549000,20926000,0,1351000,NA,4567000,20926000,19575000,0,120000,NA,-3096000,-3594000,2026000,income_statement,Banks—Regional,Village Bank and Trust Financia,"Village Bank and Trust Financial Corp. operates as the bank holding company for Village Bank that provides banking and related financial products and services to small and medium sized businesses, professionals, and individuals. It operates through two segments, Traditional Commercial Banking and Mortgage Banking. The company accepts checking, savings, money market, and individual retirement accounts, as well as certificates of deposit and other depository services. It also provides secured and unsecured commercial loans to small-and medium-sized businesses for various purposes, such as funding working capital needs, business expansion, and purchase of equipment and machinery; loans for acquiring, developing, constructing, and owning commercial real estate properties; and secured and unsecured consumer loans for financing automobiles, home improvements, education, and personal investments, as well as originates mortgage loans, real estate construction, and acquisition loans for sale in the secondary market. In addition, the company offers online banking, mobile banking, and remote deposit capture services for business clients. It provides its products and services through 9 banking offices and 1 mortgage loan production office in Central Virginia in the counties of Chesterfield, Hanover, Henrico, Powhatan, and James City. The company was founded in 1999 and is headquartered in Midlothian, Virginia."
VBFC,2018-12-31,NA,3730000,NA,3037000,17283000,23295000,0,4005000,NA,693000,23295000,19290000,0,-275000,NA,3037000,2924000,2007000,income_statement,Banks—Regional,Village Bank and Trust Financia,"Village Bank and Trust Financial Corp. operates as the bank holding company for Village Bank that provides banking and related financial products and services to small and medium sized businesses, professionals, and individuals. It operates through two segments, Traditional Commercial Banking and Mortgage Banking. The company accepts checking, savings, money market, and individual retirement accounts, as well as certificates of deposit and other depository services. It also provides secured and unsecured commercial loans to small-and medium-sized businesses for various purposes, such as funding working capital needs, business expansion, and purchase of equipment and machinery; loans for acquiring, developing, constructing, and owning commercial real estate properties; and secured and unsecured consumer loans for financing automobiles, home improvements, education, and personal investments, as well as originates mortgage loans, real estate construction, and acquisition loans for sale in the secondary market. In addition, the company offers online banking, mobile banking, and remote deposit capture services for business clients. It provides its products and services through 9 banking offices and 1 mortgage loan production office in Central Virginia in the counties of Chesterfield, Hanover, Henrico, Powhatan, and James City. The company was founded in 1999 and is headquartered in Midlothian, Virginia."
VBFC,2019-12-31,NA,5641000,NA,4477000,17961000,25908000,0,5816000,NA,1164000,25908000,20092000,0,-175000,NA,4477000,4477000,2131000,income_statement,Banks—Regional,Village Bank and Trust Financia,"Village Bank and Trust Financial Corp. operates as the bank holding company for Village Bank that provides banking and related financial products and services to small and medium sized businesses, professionals, and individuals. It operates through two segments, Traditional Commercial Banking and Mortgage Banking. The company accepts checking, savings, money market, and individual retirement accounts, as well as certificates of deposit and other depository services. It also provides secured and unsecured commercial loans to small-and medium-sized businesses for various purposes, such as funding working capital needs, business expansion, and purchase of equipment and machinery; loans for acquiring, developing, constructing, and owning commercial real estate properties; and secured and unsecured consumer loans for financing automobiles, home improvements, education, and personal investments, as well as originates mortgage loans, real estate construction, and acquisition loans for sale in the secondary market. In addition, the company offers online banking, mobile banking, and remote deposit capture services for business clients. It provides its products and services through 9 banking offices and 1 mortgage loan production office in Central Virginia in the counties of Chesterfield, Hanover, Henrico, Powhatan, and James City. The company was founded in 1999 and is headquartered in Midlothian, Virginia."
VBFC,2020-12-31,NA,11039000,NA,8554000,NA,31992000,0,11039000,NA,2485000,31992000,20953000,0,0,NA,8554000,8554000,20953000,income_statement,Banks—Regional,Village Bank and Trust Financia,"Village Bank and Trust Financial Corp. operates as the bank holding company for Village Bank that provides banking and related financial products and services to small and medium sized businesses, professionals, and individuals. It operates through two segments, Traditional Commercial Banking and Mortgage Banking. The company accepts checking, savings, money market, and individual retirement accounts, as well as certificates of deposit and other depository services. It also provides secured and unsecured commercial loans to small-and medium-sized businesses for various purposes, such as funding working capital needs, business expansion, and purchase of equipment and machinery; loans for acquiring, developing, constructing, and owning commercial real estate properties; and secured and unsecured consumer loans for financing automobiles, home improvements, education, and personal investments, as well as originates mortgage loans, real estate construction, and acquisition loans for sale in the secondary market. In addition, the company offers online banking, mobile banking, and remote deposit capture services for business clients. It provides its products and services through 9 banking offices and 1 mortgage loan production office in Central Virginia in the counties of Chesterfield, Hanover, Henrico, Powhatan, and James City. The company was founded in 1999 and is headquartered in Midlothian, Virginia."
VBIV,2016-12-31,9966000,-24985000,NA,-23205000,9240000,-3123000,-22329000,-22329000,-392000,-1780000,548000,22877000,3671000,-2656000,NA,-23205000,-23205000,NA,income_statement,Biotechnology,"VBI Vaccines, Inc.","VBI Vaccines Inc., a biopharmaceutical company, develops and sells vaccines for the treatment of infectious diseases and immuno-oncology in Israel, the United States, and internationally. The company offers Sci-B-Vac, a prophylactic hepatitis B vaccine for adults, children, and newborns. It also engages in the development of VBI-2601 (BRII-179), an immunotherapeutic candidate for a functional cure of chronic hepatitis B. The company's enveloped virus-like particle (eVLP) platform technology allows for the development of eVLP vaccines that mimic the target virus to elicit a potent immune response. Its lead eVLP program candidates include VBI-1901, a glioblastoma vaccine immunotherapeutic candidate, which is in Phase I/IIa clinical study; and VBI-1501, a prophylactic cytomegalovirus vaccine candidate that has completed Phase I clinical trial. In addition, the company engages in the development of vaccine platforms and products for licensing to pharmaceutical companies and biotechnology companies. It primarily serves physicians and pharmacists through direct sales. VBI Vaccines Inc. has collaboration and license agreements with Brii Biosciences Limited; and GlaxoSmithKline Biologicals S.A. It also has a collaboration with the National Research Council of Canada to develop pan-coronavirus vaccine candidate targeting COVID-19, severe acute respiratory syndrome, and Middle East respiratory syndrome; and a partnership with Syneos Health, Inc. for the commercialization of VBI's 3-antigen prophylactic hepatitis B vaccine in the United States, Europe, and Canada, which is in pending regulatory approvals. The company was formerly known as SciVac Therapeutics Inc. and changed its name to VBI Vaccines Inc. in May 2016. VBI Vaccines Inc. is headquartered in Cambridge, Massachusetts."
VBIV,2017-12-31,20918000,-39426000,NA,-38995000,12034000,-4328000,-37280000,-37280000,-3031000,-431000,865000,38145000,5193000,-2146000,NA,-38995000,-38995000,NA,income_statement,Biotechnology,"VBI Vaccines, Inc.","VBI Vaccines Inc., a biopharmaceutical company, develops and sells vaccines for the treatment of infectious diseases and immuno-oncology in Israel, the United States, and internationally. The company offers Sci-B-Vac, a prophylactic hepatitis B vaccine for adults, children, and newborns. It also engages in the development of VBI-2601 (BRII-179), an immunotherapeutic candidate for a functional cure of chronic hepatitis B. The company's enveloped virus-like particle (eVLP) platform technology allows for the development of eVLP vaccines that mimic the target virus to elicit a potent immune response. Its lead eVLP program candidates include VBI-1901, a glioblastoma vaccine immunotherapeutic candidate, which is in Phase I/IIa clinical study; and VBI-1501, a prophylactic cytomegalovirus vaccine candidate that has completed Phase I clinical trial. In addition, the company engages in the development of vaccine platforms and products for licensing to pharmaceutical companies and biotechnology companies. It primarily serves physicians and pharmacists through direct sales. VBI Vaccines Inc. has collaboration and license agreements with Brii Biosciences Limited; and GlaxoSmithKline Biologicals S.A. It also has a collaboration with the National Research Council of Canada to develop pan-coronavirus vaccine candidate targeting COVID-19, severe acute respiratory syndrome, and Middle East respiratory syndrome; and a partnership with Syneos Health, Inc. for the commercialization of VBI's 3-antigen prophylactic hepatitis B vaccine in the United States, Europe, and Canada, which is in pending regulatory approvals. The company was formerly known as SciVac Therapeutics Inc. and changed its name to VBI Vaccines Inc. in May 2016. VBI Vaccines Inc. is headquartered in Cambridge, Massachusetts."
VBIV,2018-12-31,38467000,-63600000,NA,-63600000,20509000,-1154000,-60130000,-60130000,-3254000,0,3355000,63485000,4509000,-3470000,NA,-63600000,-63600000,NA,income_statement,Biotechnology,"VBI Vaccines, Inc.","VBI Vaccines Inc., a biopharmaceutical company, develops and sells vaccines for the treatment of infectious diseases and immuno-oncology in Israel, the United States, and internationally. The company offers Sci-B-Vac, a prophylactic hepatitis B vaccine for adults, children, and newborns. It also engages in the development of VBI-2601 (BRII-179), an immunotherapeutic candidate for a functional cure of chronic hepatitis B. The company's enveloped virus-like particle (eVLP) platform technology allows for the development of eVLP vaccines that mimic the target virus to elicit a potent immune response. Its lead eVLP program candidates include VBI-1901, a glioblastoma vaccine immunotherapeutic candidate, which is in Phase I/IIa clinical study; and VBI-1501, a prophylactic cytomegalovirus vaccine candidate that has completed Phase I clinical trial. In addition, the company engages in the development of vaccine platforms and products for licensing to pharmaceutical companies and biotechnology companies. It primarily serves physicians and pharmacists through direct sales. VBI Vaccines Inc. has collaboration and license agreements with Brii Biosciences Limited; and GlaxoSmithKline Biologicals S.A. It also has a collaboration with the National Research Council of Canada to develop pan-coronavirus vaccine candidate targeting COVID-19, severe acute respiratory syndrome, and Middle East respiratory syndrome; and a partnership with Syneos Health, Inc. for the commercialization of VBI's 3-antigen prophylactic hepatitis B vaccine in the United States, Europe, and Canada, which is in pending regulatory approvals. The company was formerly known as SciVac Therapeutics Inc. and changed its name to VBI Vaccines Inc. in May 2016. VBI Vaccines Inc. is headquartered in Cambridge, Massachusetts."
VBIV,2019-12-31,26332000,-54813000,NA,-54813000,14092000,-5683000,-46107000,-46107000,-3031000,0,2221000,48328000,7904000,-8706000,NA,-54813000,-54813000,NA,income_statement,Biotechnology,"VBI Vaccines, Inc.","VBI Vaccines Inc., a biopharmaceutical company, develops and sells vaccines for the treatment of infectious diseases and immuno-oncology in Israel, the United States, and internationally. The company offers Sci-B-Vac, a prophylactic hepatitis B vaccine for adults, children, and newborns. It also engages in the development of VBI-2601 (BRII-179), an immunotherapeutic candidate for a functional cure of chronic hepatitis B. The company's enveloped virus-like particle (eVLP) platform technology allows for the development of eVLP vaccines that mimic the target virus to elicit a potent immune response. Its lead eVLP program candidates include VBI-1901, a glioblastoma vaccine immunotherapeutic candidate, which is in Phase I/IIa clinical study; and VBI-1501, a prophylactic cytomegalovirus vaccine candidate that has completed Phase I clinical trial. In addition, the company engages in the development of vaccine platforms and products for licensing to pharmaceutical companies and biotechnology companies. It primarily serves physicians and pharmacists through direct sales. VBI Vaccines Inc. has collaboration and license agreements with Brii Biosciences Limited; and GlaxoSmithKline Biologicals S.A. It also has a collaboration with the National Research Council of Canada to develop pan-coronavirus vaccine candidate targeting COVID-19, severe acute respiratory syndrome, and Middle East respiratory syndrome; and a partnership with Syneos Health, Inc. for the commercialization of VBI's 3-antigen prophylactic hepatitis B vaccine in the United States, Europe, and Canada, which is in pending regulatory approvals. The company was formerly known as SciVac Therapeutics Inc. and changed its name to VBI Vaccines Inc. in May 2016. VBI Vaccines Inc. is headquartered in Cambridge, Massachusetts."
VBLT,2016-12-31,12447000,-16002000,NA,-16002000,3828000,0,-16275000,-16275000,-124000,0,0,16275000,0,273000,NA,-16002000,-16002000,NA,income_statement,Biotechnology,Vascular Biogenics Ltd.,"Vascular Biogenics Ltd., a clinical-stage biopharmaceutical company, focuses on the discovery, development, and commercialization of treatments for cancer and immune/inflammatory indications. The company's program is based on its proprietary vascular targeting system platform technology, which utilizes genetically targeted therapy to destroy newly formed or angiogenic blood vessels. Its lead product candidate is VB-111, a gene-based biologic that is in Phase 3 clinical trials for the treatment of recurrent glioblastoma, an aggressive form of brain cancer; and in Phase 1/2 clinical trials for recurrent platinum-resistant ovarian cancer, as well as in Phase 2 clinical trials to treat GI tumors and has completed phase 2 clinical trial for the treatment of thyroid cancer. In addition, it is developing VB-511, an anti-angiogenic candidate for oncology; and VB-211 and VB-411, which are pro-angiogenic candidates for the treatment of peripheral vascular diseases. Further, the company is developing VB-201, a Lecinoxoid-based compound used to treat atherosclerosis that has completed phase II clinical, as well as in pre-clinical stage for the treatment of NASH and renal fibrosis. It is also developing VB-601 and 611 for immuno-oncology and anti-inflammatory applications. The company was formerly known as Medicard Ltd. and changed its name to Vascular Biogenics Ltd. in January 2003. Vascular Biogenics Ltd. was founded in 2000 and is headquartered in Modi'in, Israel."
VBLT,2017-12-31,17770000,-10138000,NA,-10138000,6409000,13524000,-10655000,-10655000,-124000,0,13864000,24519000,340000,517000,NA,-10138000,-10138000,NA,income_statement,Biotechnology,Vascular Biogenics Ltd.,"Vascular Biogenics Ltd., a clinical-stage biopharmaceutical company, focuses on the discovery, development, and commercialization of treatments for cancer and immune/inflammatory indications. The company's program is based on its proprietary vascular targeting system platform technology, which utilizes genetically targeted therapy to destroy newly formed or angiogenic blood vessels. Its lead product candidate is VB-111, a gene-based biologic that is in Phase 3 clinical trials for the treatment of recurrent glioblastoma, an aggressive form of brain cancer; and in Phase 1/2 clinical trials for recurrent platinum-resistant ovarian cancer, as well as in Phase 2 clinical trials to treat GI tumors and has completed phase 2 clinical trial for the treatment of thyroid cancer. In addition, it is developing VB-511, an anti-angiogenic candidate for oncology; and VB-211 and VB-411, which are pro-angiogenic candidates for the treatment of peripheral vascular diseases. Further, the company is developing VB-201, a Lecinoxoid-based compound used to treat atherosclerosis that has completed phase II clinical, as well as in pre-clinical stage for the treatment of NASH and renal fibrosis. It is also developing VB-601 and 611 for immuno-oncology and anti-inflammatory applications. The company was formerly known as Medicard Ltd. and changed its name to Vascular Biogenics Ltd. in January 2003. Vascular Biogenics Ltd. was founded in 2000 and is headquartered in Modi'in, Israel."
VBLT,2018-12-31,15940000,-20458000,NA,-20458000,5617000,350000,-21207000,-21207000,-124000,0,585000,21792000,235000,749000,NA,-20458000,-20458000,NA,income_statement,Biotechnology,Vascular Biogenics Ltd.,"Vascular Biogenics Ltd., a clinical-stage biopharmaceutical company, focuses on the discovery, development, and commercialization of treatments for cancer and immune/inflammatory indications. The company's program is based on its proprietary vascular targeting system platform technology, which utilizes genetically targeted therapy to destroy newly formed or angiogenic blood vessels. Its lead product candidate is VB-111, a gene-based biologic that is in Phase 3 clinical trials for the treatment of recurrent glioblastoma, an aggressive form of brain cancer; and in Phase 1/2 clinical trials for recurrent platinum-resistant ovarian cancer, as well as in Phase 2 clinical trials to treat GI tumors and has completed phase 2 clinical trial for the treatment of thyroid cancer. In addition, it is developing VB-511, an anti-angiogenic candidate for oncology; and VB-211 and VB-411, which are pro-angiogenic candidates for the treatment of peripheral vascular diseases. Further, the company is developing VB-201, a Lecinoxoid-based compound used to treat atherosclerosis that has completed phase II clinical, as well as in pre-clinical stage for the treatment of NASH and renal fibrosis. It is also developing VB-601 and 611 for immuno-oncology and anti-inflammatory applications. The company was formerly known as Medicard Ltd. and changed its name to Vascular Biogenics Ltd. in January 2003. Vascular Biogenics Ltd. was founded in 2000 and is headquartered in Modi'in, Israel."
VBLT,2019-12-31,15470000,-19457000,NA,-19457000,4943000,399000,-20014000,-20014000,-124000,0,562000,20576000,163000,557000,NA,-19457000,-19457000,NA,income_statement,Biotechnology,Vascular Biogenics Ltd.,"Vascular Biogenics Ltd., a clinical-stage biopharmaceutical company, focuses on the discovery, development, and commercialization of treatments for cancer and immune/inflammatory indications. The company's program is based on its proprietary vascular targeting system platform technology, which utilizes genetically targeted therapy to destroy newly formed or angiogenic blood vessels. Its lead product candidate is VB-111, a gene-based biologic that is in Phase 3 clinical trials for the treatment of recurrent glioblastoma, an aggressive form of brain cancer; and in Phase 1/2 clinical trials for recurrent platinum-resistant ovarian cancer, as well as in Phase 2 clinical trials to treat GI tumors and has completed phase 2 clinical trial for the treatment of thyroid cancer. In addition, it is developing VB-511, an anti-angiogenic candidate for oncology; and VB-211 and VB-411, which are pro-angiogenic candidates for the treatment of peripheral vascular diseases. Further, the company is developing VB-201, a Lecinoxoid-based compound used to treat atherosclerosis that has completed phase II clinical, as well as in pre-clinical stage for the treatment of NASH and renal fibrosis. It is also developing VB-601 and 611 for immuno-oncology and anti-inflammatory applications. The company was formerly known as Medicard Ltd. and changed its name to Vascular Biogenics Ltd. in January 2003. Vascular Biogenics Ltd. was founded in 2000 and is headquartered in Modi'in, Israel."
VBTX,2017-12-31,NA,28181000,NA,15152000,34834000,70970000,0,31836000,NA,13029000,70970000,39134000,0,-3655000,NA,15152000,15110000,4300000,income_statement,Banks—Regional,"Veritex Holdings, Inc.","Veritex Holdings, Inc. operates as the holding company for Veritex Community Bank that provides various commercial banking products and services to small and medium-sized businesses, and professionals. The company's deposit products include demand, savings, money market and time deposit accounts, as well as commercial deposit and financial institution money market accounts. Its loan portfolio consists of commercial real estate and general commercial loans, mortgage warehouse loans, residential real estate loans, construction and land loans, farmland loans, and consumer loans, as well as purchased receivables financing. The company also provides a range of online banking solutions, such as access to account balances, online transfers, online bill payment and electronic delivery of customer statements, and ATMs, as well as banking through telephone, mail, and personal appointment. In addition, it offers debit cards, night depository services, direct deposits, cashier's checks, and letters of credit; treasury management services, including balance reporting, transfers between accounts, wire transfer initiation, automated clearinghouse origination, and stop payments; and cash management deposit products consisting of lockbox, remote deposit capture, positive pay, reverse positive pay, account reconciliation services, zero balance accounts, and sweep accounts. As of December 31, 2019, the company had 25 branches and one mortgage office located in the Dallas-Fort Worth metroplex, as well as 12 full-service branches in the Houston metropolitan area and one branch in Louisville, Kentucky. Veritex Holdings, Inc. was founded in 2009 and is headquartered in Dallas, Texas."
VBTX,2018-12-31,NA,50237000,NA,39341000,55201000,119496000,0,58924000,NA,10896000,119496000,60572000,0,-8687000,NA,39341000,39341000,5371000,income_statement,Banks—Regional,"Veritex Holdings, Inc.","Veritex Holdings, Inc. operates as the holding company for Veritex Community Bank that provides various commercial banking products and services to small and medium-sized businesses, and professionals. The company's deposit products include demand, savings, money market and time deposit accounts, as well as commercial deposit and financial institution money market accounts. Its loan portfolio consists of commercial real estate and general commercial loans, mortgage warehouse loans, residential real estate loans, construction and land loans, farmland loans, and consumer loans, as well as purchased receivables financing. The company also provides a range of online banking solutions, such as access to account balances, online transfers, online bill payment and electronic delivery of customer statements, and ATMs, as well as banking through telephone, mail, and personal appointment. In addition, it offers debit cards, night depository services, direct deposits, cashier's checks, and letters of credit; treasury management services, including balance reporting, transfers between accounts, wire transfer initiation, automated clearinghouse origination, and stop payments; and cash management deposit products consisting of lockbox, remote deposit capture, positive pay, reverse positive pay, account reconciliation services, zero balance accounts, and sweep accounts. As of December 31, 2019, the company had 25 branches and one mortgage office located in the Dallas-Fort Worth metroplex, as well as 12 full-service branches in the Houston metropolitan area and one branch in Louisville, Kentucky. Veritex Holdings, Inc. was founded in 2009 and is headquartered in Dallas, Texas."
VBTX,2019-12-31,NA,115860000,NA,90739000,114244000,293663000,0,165707000,NA,25121000,293663000,127956000,0,-49847000,NA,90739000,90739000,13712000,income_statement,Banks—Regional,"Veritex Holdings, Inc.","Veritex Holdings, Inc. operates as the holding company for Veritex Community Bank that provides various commercial banking products and services to small and medium-sized businesses, and professionals. The company's deposit products include demand, savings, money market and time deposit accounts, as well as commercial deposit and financial institution money market accounts. Its loan portfolio consists of commercial real estate and general commercial loans, mortgage warehouse loans, residential real estate loans, construction and land loans, farmland loans, and consumer loans, as well as purchased receivables financing. The company also provides a range of online banking solutions, such as access to account balances, online transfers, online bill payment and electronic delivery of customer statements, and ATMs, as well as banking through telephone, mail, and personal appointment. In addition, it offers debit cards, night depository services, direct deposits, cashier's checks, and letters of credit; treasury management services, including balance reporting, transfers between accounts, wire transfer initiation, automated clearinghouse origination, and stop payments; and cash management deposit products consisting of lockbox, remote deposit capture, positive pay, reverse positive pay, account reconciliation services, zero balance accounts, and sweep accounts. As of December 31, 2019, the company had 25 branches and one mortgage office located in the Dallas-Fort Worth metroplex, as well as 12 full-service branches in the Houston metropolitan area and one branch in Louisville, Kentucky. Veritex Holdings, Inc. was founded in 2009 and is headquartered in Dallas, Texas."
VBTX,2020-12-31,NA,88086000,NA,73883000,121721000,247473000,0,111560000,NA,14203000,247473000,135913000,0,-23474000,NA,73883000,73883000,14192000,income_statement,Banks—Regional,"Veritex Holdings, Inc.","Veritex Holdings, Inc. operates as the holding company for Veritex Community Bank that provides various commercial banking products and services to small and medium-sized businesses, and professionals. The company's deposit products include demand, savings, money market and time deposit accounts, as well as commercial deposit and financial institution money market accounts. Its loan portfolio consists of commercial real estate and general commercial loans, mortgage warehouse loans, residential real estate loans, construction and land loans, farmland loans, and consumer loans, as well as purchased receivables financing. The company also provides a range of online banking solutions, such as access to account balances, online transfers, online bill payment and electronic delivery of customer statements, and ATMs, as well as banking through telephone, mail, and personal appointment. In addition, it offers debit cards, night depository services, direct deposits, cashier's checks, and letters of credit; treasury management services, including balance reporting, transfers between accounts, wire transfer initiation, automated clearinghouse origination, and stop payments; and cash management deposit products consisting of lockbox, remote deposit capture, positive pay, reverse positive pay, account reconciliation services, zero balance accounts, and sweep accounts. As of December 31, 2019, the company had 25 branches and one mortgage office located in the Dallas-Fort Worth metroplex, as well as 12 full-service branches in the Houston metropolitan area and one branch in Louisville, Kentucky. Veritex Holdings, Inc. was founded in 2009 and is headquartered in Dallas, Texas."
VC,2017-12-31,NA,223000000,124000000,176000000,211000000,491000000,277000000,277000000,-21000000,48000000,3146000000,2869000000,2655000000,-54000000,17000000,175000000,176000000,NA,income_statement,Auto Parts,Visteon Corporation,"Visteon Corporation engineers, designs, and manufactures cockpit electronics and connected car solutions for vehicle manufacturers worldwide. The company provides instrument clusters, including standard analog gauge clusters to high-resolution, all-digital, fully reconfigurable, 2-D, and 3-D display-based devices; information displays that integrate a range of user interface technologies and graphics management capabilities; and audio and infotainment systems that allows vehicle occupants to connect their mobile devices to the system and safely access phone functions, listen to music, stream media, and enable mobile connectivity applications. It also offers infotainment solutions, including Phoenix display audio and embedded infotainment platform; telematics control unit to enable secure connected car services, software updates, and data; SmartCore, an automotive-grade, integrated domain controller to enhance efficiency, and reduce power consumption and cost; and head-up displays (HUD), such as combiner HUD and windshield HUD that present critical information to the driver. Visteon Corporation was founded in 2000 and is headquartered in Van Buren, Michigan."
VC,2018-12-31,NA,216000000,117000000,164000000,188000000,411000000,221000000,221000000,-14000000,43000000,2984000000,2763000000,2573000000,-5000000,1000000,173000000,164000000,NA,income_statement,Auto Parts,Visteon Corporation,"Visteon Corporation engineers, designs, and manufactures cockpit electronics and connected car solutions for vehicle manufacturers worldwide. The company provides instrument clusters, including standard analog gauge clusters to high-resolution, all-digital, fully reconfigurable, 2-D, and 3-D display-based devices; information displays that integrate a range of user interface technologies and graphics management capabilities; and audio and infotainment systems that allows vehicle occupants to connect their mobile devices to the system and safely access phone functions, listen to music, stream media, and enable mobile connectivity applications. It also offers infotainment solutions, including Phoenix display audio and embedded infotainment platform; telematics control unit to enable secure connected car services, software updates, and data; SmartCore, an automotive-grade, integrated domain controller to enhance efficiency, and reduce power consumption and cost; and head-up displays (HUD), such as combiner HUD and windshield HUD that present critical information to the driver. Visteon Corporation was founded in 2000 and is headquartered in Van Buren, Michigan."
VC,2019-12-31,NA,106000000,115000000,70000000,206000000,326000000,115000000,115000000,-13000000,24000000,2945000000,2830000000,2619000000,-9000000,-1000000,82000000,70000000,NA,income_statement,Auto Parts,Visteon Corporation,"Visteon Corporation engineers, designs, and manufactures cockpit electronics and connected car solutions for vehicle manufacturers worldwide. The company provides instrument clusters, including standard analog gauge clusters to high-resolution, all-digital, fully reconfigurable, 2-D, and 3-D display-based devices; information displays that integrate a range of user interface technologies and graphics management capabilities; and audio and infotainment systems that allows vehicle occupants to connect their mobile devices to the system and safely access phone functions, listen to music, stream media, and enable mobile connectivity applications. It also offers infotainment solutions, including Phoenix display audio and embedded infotainment platform; telematics control unit to enable secure connected car services, software updates, and data; SmartCore, an automotive-grade, integrated domain controller to enhance efficiency, and reduce power consumption and cost; and head-up displays (HUD), such as combiner HUD and windshield HUD that present critical information to the driver. Visteon Corporation was founded in 2000 and is headquartered in Van Buren, Michigan."
VC,2020-12-31,NA,-20000000,123000000,-56000000,193000000,245000000,52000000,52000000,-16000000,28000000,2548000000,2496000000,2303000000,-72000000,NA,-48000000,-56000000,NA,income_statement,Auto Parts,Visteon Corporation,"Visteon Corporation engineers, designs, and manufactures cockpit electronics and connected car solutions for vehicle manufacturers worldwide. The company provides instrument clusters, including standard analog gauge clusters to high-resolution, all-digital, fully reconfigurable, 2-D, and 3-D display-based devices; information displays that integrate a range of user interface technologies and graphics management capabilities; and audio and infotainment systems that allows vehicle occupants to connect their mobile devices to the system and safely access phone functions, listen to music, stream media, and enable mobile connectivity applications. It also offers infotainment solutions, including Phoenix display audio and embedded infotainment platform; telematics control unit to enable secure connected car services, software updates, and data; SmartCore, an automotive-grade, integrated domain controller to enhance efficiency, and reduce power consumption and cost; and head-up displays (HUD), such as combiner HUD and windshield HUD that present critical information to the driver. Visteon Corporation was founded in 2000 and is headquartered in Van Buren, Michigan."
VCEL,2016-12-31,15295000,-19566000,NA,-19566000,27388000,26076000,-16607000,-16607000,-314000,0,54383000,70990000,28307000,-2959000,NA,-19566000,-27145000,NA,income_statement,Biotechnology,Vericel Corporation,"Vericel Corporation, a commercial-stage biopharmaceutical company, researches, develops, manufactures, and distributes cellular therapies for sports medicine and severe burn care markets in the United States. It markets autologous cell therapy products comprising MACI, an autologous cellularized scaffold product for the repair of symptomatic, and single or multiple full-thickness cartilage defects of the knee; and Epicel, a permanent skin replacement humanitarian use device for the treatment of patients with deep-dermal or full-thickness burns. The company also develops ixmyelocel-T, a patient-specific multicellular therapy that has completed Phase IIb clinical trial for the treatment of advanced heart failure due to dilated cardiomyopathy. In addition, its preapproval stage product includes, NexoBrid, a registration-stage biological orphan product for debridement of severe thermal burns. The company was formerly known as Aastrom Biosciences, Inc. Vericel Corporation was founded in 1989 and is headquartered in Cambridge, Massachusetts."
VCEL,2017-12-31,12944000,-17286000,NA,-17286000,35610000,33570000,-14984000,-14984000,-1107000,0,63924000,78908000,30354000,-2302000,NA,-17286000,-17286000,NA,income_statement,Biotechnology,Vericel Corporation,"Vericel Corporation, a commercial-stage biopharmaceutical company, researches, develops, manufactures, and distributes cellular therapies for sports medicine and severe burn care markets in the United States. It markets autologous cell therapy products comprising MACI, an autologous cellularized scaffold product for the repair of symptomatic, and single or multiple full-thickness cartilage defects of the knee; and Epicel, a permanent skin replacement humanitarian use device for the treatment of patients with deep-dermal or full-thickness burns. The company also develops ixmyelocel-T, a patient-specific multicellular therapy that has completed Phase IIb clinical trial for the treatment of advanced heart failure due to dilated cardiomyopathy. In addition, its preapproval stage product includes, NexoBrid, a registration-stage biological orphan product for debridement of severe thermal burns. The company was formerly known as Aastrom Biosciences, Inc. Vericel Corporation was founded in 1989 and is headquartered in Cambridge, Massachusetts."
VCEL,2018-12-31,13599000,-8137000,NA,-8137000,49007000,58697000,-3909000,-3909000,-1732000,0,90857000,94766000,32160000,-4228000,NA,-8137000,-8137000,NA,income_statement,Biotechnology,Vericel Corporation,"Vericel Corporation, a commercial-stage biopharmaceutical company, researches, develops, manufactures, and distributes cellular therapies for sports medicine and severe burn care markets in the United States. It markets autologous cell therapy products comprising MACI, an autologous cellularized scaffold product for the repair of symptomatic, and single or multiple full-thickness cartilage defects of the knee; and Epicel, a permanent skin replacement humanitarian use device for the treatment of patients with deep-dermal or full-thickness burns. The company also develops ixmyelocel-T, a patient-specific multicellular therapy that has completed Phase IIb clinical trial for the treatment of advanced heart failure due to dilated cardiomyopathy. In addition, its preapproval stage product includes, NexoBrid, a registration-stage biological orphan product for debridement of severe thermal burns. The company was formerly known as Aastrom Biosciences, Inc. Vericel Corporation was founded in 1989 and is headquartered in Cambridge, Massachusetts."
VCEL,2019-12-31,30391000,-9665000,NA,-9665000,61139000,80279000,-11251000,-11251000,-8000,0,117850000,129101000,37571000,1586000,NA,-9665000,-9665000,NA,income_statement,Biotechnology,Vericel Corporation,"Vericel Corporation, a commercial-stage biopharmaceutical company, researches, develops, manufactures, and distributes cellular therapies for sports medicine and severe burn care markets in the United States. It markets autologous cell therapy products comprising MACI, an autologous cellularized scaffold product for the repair of symptomatic, and single or multiple full-thickness cartilage defects of the knee; and Epicel, a permanent skin replacement humanitarian use device for the treatment of patients with deep-dermal or full-thickness burns. The company also develops ixmyelocel-T, a patient-specific multicellular therapy that has completed Phase IIb clinical trial for the treatment of advanced heart failure due to dilated cardiomyopathy. In addition, its preapproval stage product includes, NexoBrid, a registration-stage biological orphan product for debridement of severe thermal burns. The company was formerly known as Aastrom Biosciences, Inc. Vericel Corporation was founded in 1989 and is headquartered in Cambridge, Massachusetts."
VCNX,2016-12-31,16028000,-13943000,11963000,-13943000,4432000,201000,-20259000,-20259000,-2990000,0,316000,20575000,115000,6316000,NA,-13943000,-26233000,NA,income_statement,Biotechnology,"Vaccinex, Inc.","Vaccinex, Inc., a clinical-stage biotechnology company, discovers and develops bio therapeutics to treat serious diseases and conditions with unmet medical needs. The company offers its products for the treatment of cancer, neurodegenerative diseases, and autoimmune disorders. Its lead product candidate is pepinemab that is in clinical development stage for the treatment of non-small cell lung cancer (NSCLC), Huntington's disease, osteosarcoma, melanoma, and Alzheimer's disease. The company is also developing VX5, a human antibody to CXCL13 that is in preclinical development for the treatment of MS and potentially for other autoimmune disorders; and VX25, a bi-specific natural killer T (NKT) cell stimulator, for the therapeutic application of NKT cell stimulation for cancer immunotherapy. It has a clinical trial collaboration and supply agreement with Merck KGaA to test pepinemab in combination with avelumab checkpoint inhibitor in NSCLC patients. Vaccinex, Inc. was founded in 2001 and is headquartered in Rochester, New York."
VCNX,2017-12-31,16551000,-18759000,11963000,-18722000,4483000,-70000,-21104000,-21104000,-1358000,0,90000,21194000,160000,2345000,NA,-18759000,-21933000,NA,income_statement,Biotechnology,"Vaccinex, Inc.","Vaccinex, Inc., a clinical-stage biotechnology company, discovers and develops bio therapeutics to treat serious diseases and conditions with unmet medical needs. The company offers its products for the treatment of cancer, neurodegenerative diseases, and autoimmune disorders. Its lead product candidate is pepinemab that is in clinical development stage for the treatment of non-small cell lung cancer (NSCLC), Huntington's disease, osteosarcoma, melanoma, and Alzheimer's disease. The company is also developing VX5, a human antibody to CXCL13 that is in preclinical development for the treatment of MS and potentially for other autoimmune disorders; and VX25, a bi-specific natural killer T (NKT) cell stimulator, for the therapeutic application of NKT cell stimulation for cancer immunotherapy. It has a clinical trial collaboration and supply agreement with Merck KGaA to test pepinemab in combination with avelumab checkpoint inhibitor in NSCLC patients. Vaccinex, Inc. was founded in 2001 and is headquartered in Rochester, New York."
VCNX,2018-12-31,22353000,-29518000,23963000,-29518000,4619000,-309000,-27281000,-27281000,-392000,0,724000,28005000,1033000,-2237000,NA,-29518000,-29518000,NA,income_statement,Biotechnology,"Vaccinex, Inc.","Vaccinex, Inc., a clinical-stage biotechnology company, discovers and develops bio therapeutics to treat serious diseases and conditions with unmet medical needs. The company offers its products for the treatment of cancer, neurodegenerative diseases, and autoimmune disorders. Its lead product candidate is pepinemab that is in clinical development stage for the treatment of non-small cell lung cancer (NSCLC), Huntington's disease, osteosarcoma, melanoma, and Alzheimer's disease. The company is also developing VX5, a human antibody to CXCL13 that is in preclinical development for the treatment of MS and potentially for other autoimmune disorders; and VX25, a bi-specific natural killer T (NKT) cell stimulator, for the therapeutic application of NKT cell stimulation for cancer immunotherapy. It has a clinical trial collaboration and supply agreement with Merck KGaA to test pepinemab in combination with avelumab checkpoint inhibitor in NSCLC patients. Vaccinex, Inc. was founded in 2001 and is headquartered in Rochester, New York."
VCNX,2019-12-31,25670000,-31863000,23963000,-31863000,6669000,324000,-32015000,-32015000,NA,0,523000,32538000,199000,152000,NA,-31863000,-31863000,NA,income_statement,Biotechnology,"Vaccinex, Inc.","Vaccinex, Inc., a clinical-stage biotechnology company, discovers and develops bio therapeutics to treat serious diseases and conditions with unmet medical needs. The company offers its products for the treatment of cancer, neurodegenerative diseases, and autoimmune disorders. Its lead product candidate is pepinemab that is in clinical development stage for the treatment of non-small cell lung cancer (NSCLC), Huntington's disease, osteosarcoma, melanoma, and Alzheimer's disease. The company is also developing VX5, a human antibody to CXCL13 that is in preclinical development for the treatment of MS and potentially for other autoimmune disorders; and VX25, a bi-specific natural killer T (NKT) cell stimulator, for the therapeutic application of NKT cell stimulation for cancer immunotherapy. It has a clinical trial collaboration and supply agreement with Merck KGaA to test pepinemab in combination with avelumab checkpoint inhibitor in NSCLC patients. Vaccinex, Inc. was founded in 2001 and is headquartered in Rochester, New York."
VCTR,2017-12-31,NA,38458000,NA,25826000,33263000,163659000,100486000,100486000,-47408000,12632000,409629000,309143000,245970000,-62028000,NA,25826000,25826000,1887000,income_statement,Asset Management,"Victory Capital Holdings, Inc.","Victory Capital Holdings, Inc., together with its subsidiaries, operates as an independent investment management company in the United States. It offers investment advisory, fund administration, and distribution services through broker-dealers, retirement platforms, and registered investment advisor networks. As of December 31, 2019, its franchises and solutions platform managed a set of 116 investment strategies for a range of institutional and retail clients. Victory Capital Holdings, Inc. was founded in 2013 and is headquartered in San Antonio, Texas."
VCTR,2018-12-31,NA,84911000,NA,63704000,29702000,172852000,119873000,119873000,-20164000,21207000,413412000,293539000,240560000,-34962000,NA,63704000,63704000,1505000,income_statement,Asset Management,"Victory Capital Holdings, Inc.","Victory Capital Holdings, Inc., together with its subsidiaries, operates as an independent investment management company in the United States. It offers investment advisory, fund administration, and distribution services through broker-dealers, retirement platforms, and registered investment advisor networks. As of December 31, 2019, its franchises and solutions platform managed a set of 116 investment strategies for a range of institutional and retail clients. Victory Capital Holdings, Inc. was founded in 2013 and is headquartered in San Antonio, Texas."
VCTR,2019-12-31,NA,120688000,NA,92491000,42319000,287563000,221371000,221371000,-40315000,28197000,612373000,391002000,324810000,-100683000,NA,92491000,92491000,NA,income_statement,Asset Management,"Victory Capital Holdings, Inc.","Victory Capital Holdings, Inc., together with its subsidiaries, operates as an independent investment management company in the United States. It offers investment advisory, fund administration, and distribution services through broker-dealers, retirement platforms, and registered investment advisor networks. As of December 31, 2019, its franchises and solutions platform managed a set of 116 investment strategies for a range of institutional and retail clients. Victory Capital Holdings, Inc. was founded in 2013 and is headquartered in San Antonio, Texas."
VCTR,2020-12-31,NA,278540000,NA,212522000,51218000,402506000,334907000,334907000,NA,66018000,775351000,440444000,372845000,-56367000,NA,212522000,212522000,NA,income_statement,Asset Management,"Victory Capital Holdings, Inc.","Victory Capital Holdings, Inc., together with its subsidiaries, operates as an independent investment management company in the United States. It offers investment advisory, fund administration, and distribution services through broker-dealers, retirement platforms, and registered investment advisor networks. As of December 31, 2019, its franchises and solutions platform managed a set of 116 investment strategies for a range of institutional and retail clients. Victory Capital Holdings, Inc. was founded in 2013 and is headquartered in San Antonio, Texas."
VCYT,2017-12-31,1495000,-31003000,NA,-31003000,55348000,31372000,-26538000,-26538000,-4941000,0,71953000,98491000,40581000,-4465000,NA,-31003000,-31003000,NA,income_statement,Biotechnology,"Veracyte, Inc.","Veracyte, Inc. operates as a genomic diagnostics company in the United States and internationally. The company offers Afirma Genomic Sequencing Classifier and Xpression Atlas, which are used to identify patients with benign thyroid nodules among those with indeterminate cytopathology results in order to rule out unnecessary thyroid surgery; Percepta Genomic Sequencing Classifier for lung cancer; Envisia Genomic Classifier that help physicians to differentiate idiopathic pulmonary fibrosis from other interstitial lung diseases without the need for surgery; and Prosigna Breast Cancer Prognostic Gene Signature Assay test for assessing risk of distant recurrence. It sells its products through product specialists, account managers, and medical science specialists. Veracyte, Inc. has a strategic collaboration with Johnson & Johnson Innovation and the Lung Cancer Initiative at Johnson & Johnson to advance the development and commercialization of novel diagnostic tests to detect lung cancer at its earliest stages; a research collaboration with Loxo Oncology for the development of therapies for patients with genetically defined cancers; and a collaboration with Johnson & Johnson Services, Inc. The company was formerly known as Calderome, Inc. and changed its name to Veracyte, Inc. in March 2008. Veracyte, Inc. was incorporated in 2006 and is headquartered in South San Francisco, California."
VCYT,2018-12-31,1018000,-22999000,NA,-22999000,65276000,45128000,-22233000,-22233000,-1963000,0,92008000,114241000,46880000,-766000,NA,-22999000,-22999000,NA,income_statement,Biotechnology,"Veracyte, Inc.","Veracyte, Inc. operates as a genomic diagnostics company in the United States and internationally. The company offers Afirma Genomic Sequencing Classifier and Xpression Atlas, which are used to identify patients with benign thyroid nodules among those with indeterminate cytopathology results in order to rule out unnecessary thyroid surgery; Percepta Genomic Sequencing Classifier for lung cancer; Envisia Genomic Classifier that help physicians to differentiate idiopathic pulmonary fibrosis from other interstitial lung diseases without the need for surgery; and Prosigna Breast Cancer Prognostic Gene Signature Assay test for assessing risk of distant recurrence. It sells its products through product specialists, account managers, and medical science specialists. Veracyte, Inc. has a strategic collaboration with Johnson & Johnson Innovation and the Lung Cancer Initiative at Johnson & Johnson to advance the development and commercialization of novel diagnostic tests to detect lung cancer at its earliest stages; a research collaboration with Loxo Oncology for the development of therapies for patients with genetically defined cancers; and a collaboration with Johnson & Johnson Services, Inc. The company was formerly known as Calderome, Inc. and changed its name to Veracyte, Inc. in March 2008. Veracyte, Inc. was incorporated in 2006 and is headquartered in South San Francisco, California."
VCYT,2019-12-31,1856000,-12599000,NA,-12599000,81220000,70850000,-13627000,-13627000,-677000,0,120368000,133995000,49518000,1028000,NA,-12599000,-12599000,NA,income_statement,Biotechnology,"Veracyte, Inc.","Veracyte, Inc. operates as a genomic diagnostics company in the United States and internationally. The company offers Afirma Genomic Sequencing Classifier and Xpression Atlas, which are used to identify patients with benign thyroid nodules among those with indeterminate cytopathology results in order to rule out unnecessary thyroid surgery; Percepta Genomic Sequencing Classifier for lung cancer; Envisia Genomic Classifier that help physicians to differentiate idiopathic pulmonary fibrosis from other interstitial lung diseases without the need for surgery; and Prosigna Breast Cancer Prognostic Gene Signature Assay test for assessing risk of distant recurrence. It sells its products through product specialists, account managers, and medical science specialists. Veracyte, Inc. has a strategic collaboration with Johnson & Johnson Innovation and the Lung Cancer Initiative at Johnson & Johnson to advance the development and commercialization of novel diagnostic tests to detect lung cancer at its earliest stages; a research collaboration with Loxo Oncology for the development of therapies for patients with genetically defined cancers; and a collaboration with Johnson & Johnson Services, Inc. The company was formerly known as Calderome, Inc. and changed its name to Veracyte, Inc. in March 2008. Veracyte, Inc. was incorporated in 2006 and is headquartered in South San Francisco, California."
VCYT,2020-12-31,NA,-34909000,NA,-34909000,89118000,58824000,-35389000,-35389000,-229000,0,117483000,152872000,58659000,480000,NA,-34909000,-34909000,NA,income_statement,Biotechnology,"Veracyte, Inc.","Veracyte, Inc. operates as a genomic diagnostics company in the United States and internationally. The company offers Afirma Genomic Sequencing Classifier and Xpression Atlas, which are used to identify patients with benign thyroid nodules among those with indeterminate cytopathology results in order to rule out unnecessary thyroid surgery; Percepta Genomic Sequencing Classifier for lung cancer; Envisia Genomic Classifier that help physicians to differentiate idiopathic pulmonary fibrosis from other interstitial lung diseases without the need for surgery; and Prosigna Breast Cancer Prognostic Gene Signature Assay test for assessing risk of distant recurrence. It sells its products through product specialists, account managers, and medical science specialists. Veracyte, Inc. has a strategic collaboration with Johnson & Johnson Innovation and the Lung Cancer Initiative at Johnson & Johnson to advance the development and commercialization of novel diagnostic tests to detect lung cancer at its earliest stages; a research collaboration with Loxo Oncology for the development of therapies for patients with genetically defined cancers; and a collaboration with Johnson & Johnson Services, Inc. The company was formerly known as Calderome, Inc. and changed its name to Veracyte, Inc. in March 2008. Veracyte, Inc. was incorporated in 2006 and is headquartered in South San Francisco, California."
VECO,2017-12-31,81987000,-88990000,NA,-51396000,100250000,185828000,-31486000,-31486000,-19457000,-37594000,475686000,507172000,289858000,-57504000,NA,-51396000,-51396000,-398000,income_statement,Semiconductor Equipment & Materials,Veeco Instruments Inc.,"Veeco Instruments Inc., together with its subsidiaries, develops, manufactures, sells, and supports semiconductor and thin film process equipment primarily to make electronic devices worldwide. It offers ion beam deposition and etch systems, laser annealing systems, metal organic chemical vapor deposition systems, packaging lithography equipment; single wafer wet etch and clean systems; molecular beam epitaxy systems; and atomic layer deposition and other deposition systems. The company sells its process equipment systems for use in the production of a range of microelectronic components, including radio frequency filters and amplifiers, power electronics, thin film magnetic heads, laser diodes, 3D NAND, DRAM, logic, mini-and micro-LEDs, micro-electro mechanical systems, and other semiconductor devices, as well as research centers and universities. Veeco Instruments Inc. was founded in 1945 and is headquartered in Plainview, New York."
VECO,2018-12-31,97755000,-433834000,NA,-407088000,92060000,193719000,-29142000,-29142000,-21518000,-26746000,542082000,571224000,348363000,-404692000,NA,-407088000,-407088000,695000,income_statement,Semiconductor Equipment & Materials,Veeco Instruments Inc.,"Veeco Instruments Inc., together with its subsidiaries, develops, manufactures, sells, and supports semiconductor and thin film process equipment primarily to make electronic devices worldwide. It offers ion beam deposition and etch systems, laser annealing systems, metal organic chemical vapor deposition systems, packaging lithography equipment; single wafer wet etch and clean systems; molecular beam epitaxy systems; and atomic layer deposition and other deposition systems. The company sells its process equipment systems for use in the production of a range of microelectronic components, including radio frequency filters and amplifiers, power electronics, thin film magnetic heads, laser diodes, 3D NAND, DRAM, logic, mini-and micro-LEDs, micro-electro mechanical systems, and other semiconductor devices, as well as research centers and universities. Veeco Instruments Inc. was founded in 1945 and is headquartered in Plainview, New York."
VECO,2019-12-31,90557000,-77956000,NA,-78733000,79749000,158194000,-29155000,-29155000,-22085000,777000,419349000,448504000,261155000,-48801000,NA,-78733000,-78733000,-42000,income_statement,Semiconductor Equipment & Materials,Veeco Instruments Inc.,"Veeco Instruments Inc., together with its subsidiaries, develops, manufactures, sells, and supports semiconductor and thin film process equipment primarily to make electronic devices worldwide. It offers ion beam deposition and etch systems, laser annealing systems, metal organic chemical vapor deposition systems, packaging lithography equipment; single wafer wet etch and clean systems; molecular beam epitaxy systems; and atomic layer deposition and other deposition systems. The company sells its process equipment systems for use in the production of a range of microelectronic components, including radio frequency filters and amplifiers, power electronics, thin film magnetic heads, laser diodes, 3D NAND, DRAM, logic, mini-and micro-LEDs, micro-electro mechanical systems, and other semiconductor devices, as well as research centers and universities. Veeco Instruments Inc. was founded in 1945 and is headquartered in Plainview, New York."
VECO,2020-12-31,78994000,-8464000,NA,-8391000,76251000,194573000,24216000,24216000,-23188000,-73000,454163000,429947000,259590000,-32680000,NA,-8391000,-8391000,-221000,income_statement,Semiconductor Equipment & Materials,Veeco Instruments Inc.,"Veeco Instruments Inc., together with its subsidiaries, develops, manufactures, sells, and supports semiconductor and thin film process equipment primarily to make electronic devices worldwide. It offers ion beam deposition and etch systems, laser annealing systems, metal organic chemical vapor deposition systems, packaging lithography equipment; single wafer wet etch and clean systems; molecular beam epitaxy systems; and atomic layer deposition and other deposition systems. The company sells its process equipment systems for use in the production of a range of microelectronic components, including radio frequency filters and amplifiers, power electronics, thin film magnetic heads, laser diodes, 3D NAND, DRAM, logic, mini-and micro-LEDs, micro-electro mechanical systems, and other semiconductor devices, as well as research centers and universities. Veeco Instruments Inc. was founded in 1945 and is headquartered in Plainview, New York."
VEON,2017-12-31,NA,328000000,-441000000,-505000000,3529000000,7335000000,1559000000,1559000000,-935000000,472000000,9474000000,7915000000,2139000000,-1231000000,-390000000,-144000000,-505000000,219000000,income_statement,Telecom Services,VEON Ltd.,"VEON Ltd., through its subsidiaries, provides mobile and fixed-line telecommunications services. It offers voice and data telecommunication services through a range of mobile and fixed-line technologies. The company provides value added services, including short messages, multimedia messages, caller number identification, call waiting, data transmission, mobile internet, downloadable content, mobile finance services, machine-to-machine, and other services; national and international roaming services; wireless Internet access and mobile financial services; and mobile bundles and call completion services. It also offers fixed-line telecommunication services, such as voice, data, and Internet services; and PSTN-fixed telephony, Internet, data transmission and network access, domestic and international voice termination, and IPLC and TCP/IP international transit services for corporations, operators, and consumers, as well as sells equipment and accessories. The company provides its services under the Beeline, Kyivstar, Jazz, Djezzy, and banglalink brands in Russia, Pakistan, Algeria, Uzbekistan, Ukraine, Bangladesh, Kazakhstan, Kyrgyzstan, Armenia, and Georgia. It serves approximately 212 million customers. The company was formerly known as VimpelCom Ltd. and changed its name to VEON Ltd. in March 2017. VEON Ltd. was founded in 1992 and is headquartered in Amsterdam, the Netherlands."
VEON,2018-12-31,NA,-248000000,-891000000,582000000,3480000000,6970000000,1439000000,1439000000,-816000000,369000000,9086000000,7647000000,2116000000,-1687000000,979000000,-617000000,582000000,217000000,income_statement,Telecom Services,VEON Ltd.,"VEON Ltd., through its subsidiaries, provides mobile and fixed-line telecommunications services. It offers voice and data telecommunication services through a range of mobile and fixed-line technologies. The company provides value added services, including short messages, multimedia messages, caller number identification, call waiting, data transmission, mobile internet, downloadable content, mobile finance services, machine-to-machine, and other services; national and international roaming services; wireless Internet access and mobile financial services; and mobile bundles and call completion services. It also offers fixed-line telecommunication services, such as voice, data, and Internet services; and PSTN-fixed telephony, Internet, data transmission and network access, domestic and international voice termination, and IPLC and TCP/IP international transit services for corporations, operators, and consumers, as well as sells equipment and accessories. The company provides its services under the Beeline, Kyivstar, Jazz, Djezzy, and banglalink brands in Russia, Pakistan, Algeria, Uzbekistan, Ukraine, Bangladesh, Kazakhstan, Kyrgyzstan, Armenia, and Georgia. It serves approximately 212 million customers. The company was formerly known as VimpelCom Ltd. and changed its name to VEON Ltd. in March 2017. VEON Ltd. was founded in 1992 and is headquartered in Amsterdam, the Netherlands."
VEON,2019-12-31,NA,1181000000,994000000,621000000,2807000000,6792000000,1781000000,1781000000,-892000000,498000000,8825000000,7044000000,2033000000,-600000000,NA,683000000,621000000,158000000,income_statement,Telecom Services,VEON Ltd.,"VEON Ltd., through its subsidiaries, provides mobile and fixed-line telecommunications services. It offers voice and data telecommunication services through a range of mobile and fixed-line technologies. The company provides value added services, including short messages, multimedia messages, caller number identification, call waiting, data transmission, mobile internet, downloadable content, mobile finance services, machine-to-machine, and other services; national and international roaming services; wireless Internet access and mobile financial services; and mobile bundles and call completion services. It also offers fixed-line telecommunication services, such as voice, data, and Internet services; and PSTN-fixed telephony, Internet, data transmission and network access, domestic and international voice termination, and IPLC and TCP/IP international transit services for corporations, operators, and consumers, as well as sells equipment and accessories. The company provides its services under the Beeline, Kyivstar, Jazz, Djezzy, and banglalink brands in Russia, Pakistan, Algeria, Uzbekistan, Ukraine, Bangladesh, Kazakhstan, Kyrgyzstan, Armenia, and Georgia. It serves approximately 212 million customers. The company was formerly known as VimpelCom Ltd. and changed its name to VEON Ltd. in March 2017. VEON Ltd. was founded in 1992 and is headquartered in Amsterdam, the Netherlands."
VEON,2020-12-31,NA,26000000,850000000,-349000000,2641000000,6090000000,1535000000,1535000000,-683000000,342000000,7980000000,6445000000,1890000000,-1509000000,NA,-316000000,-349000000,-5000000,income_statement,Telecom Services,VEON Ltd.,"VEON Ltd., through its subsidiaries, provides mobile and fixed-line telecommunications services. It offers voice and data telecommunication services through a range of mobile and fixed-line technologies. The company provides value added services, including short messages, multimedia messages, caller number identification, call waiting, data transmission, mobile internet, downloadable content, mobile finance services, machine-to-machine, and other services; national and international roaming services; wireless Internet access and mobile financial services; and mobile bundles and call completion services. It also offers fixed-line telecommunication services, such as voice, data, and Internet services; and PSTN-fixed telephony, Internet, data transmission and network access, domestic and international voice termination, and IPLC and TCP/IP international transit services for corporations, operators, and consumers, as well as sells equipment and accessories. The company provides its services under the Beeline, Kyivstar, Jazz, Djezzy, and banglalink brands in Russia, Pakistan, Algeria, Uzbekistan, Ukraine, Bangladesh, Kazakhstan, Kyrgyzstan, Armenia, and Georgia. It serves approximately 212 million customers. The company was formerly known as VimpelCom Ltd. and changed its name to VEON Ltd. in March 2017. VEON Ltd. was founded in 1992 and is headquartered in Amsterdam, the Netherlands."
VERI,2016-12-31,7900000,-26973000,NA,-26979000,22714000,7334000,-23280000,-23280000,-3890000,6000,8911000,32191000,1577000,-3693000,NA,-26979000,-30183000,NA,income_statement,Software—Infrastructure,"Veritone, Inc.","Veritone, Inc. provides artificial intelligence (AI) computing solutions in the United States and the United Kingdom. It develops and operates aiWARE platform, an AI operating system that integrates and orchestrates a range of cognitive engines to reveal multivariate insights from structured and unstructured data, as well as to conduct cognitive workflows based on these insights. The company also provides media advertising agency services, including media planning and strategy, media buying and placement, campaign messaging, clearance verification and attribution, and custom analytics directly to advertisers through outbound sales networking, and client and partner referrals, as well as indirectly through advertising agencies or marketing consultants. It serves media and entertainment, legal and compliance, and government markets. The company was formerly known as Veritone Delaware, Inc. and changed its name to Veritone, Inc. in July 2014. Veritone, Inc. was founded in 2014 and is headquartered in Costa Mesa, California."
VERI,2017-12-31,13970000,-59595000,NA,-59601000,46135000,13343000,-46762000,-46762000,-14368000,6000,14413000,61175000,1070000,-12833000,NA,-59601000,-64071000,NA,income_statement,Software—Infrastructure,"Veritone, Inc.","Veritone, Inc. provides artificial intelligence (AI) computing solutions in the United States and the United Kingdom. It develops and operates aiWARE platform, an AI operating system that integrates and orchestrates a range of cognitive engines to reveal multivariate insights from structured and unstructured data, as well as to conduct cognitive workflows based on these insights. The company also provides media advertising agency services, including media planning and strategy, media buying and placement, campaign messaging, clearance verification and attribution, and custom analytics directly to advertisers through outbound sales networking, and client and partner referrals, as well as indirectly through advertising agencies or marketing consultants. It serves media and entertainment, legal and compliance, and government markets. The company was formerly known as Veritone Delaware, Inc. and changed its name to Veritone, Inc. in July 2014. Veritone, Inc. was founded in 2014 and is headquartered in Costa Mesa, California."
VERI,2018-12-31,20709000,-61082000,NA,-61104000,58363000,20568000,-58504000,-58504000,NA,22000,27047000,85551000,6479000,-2578000,NA,-61104000,-61104000,NA,income_statement,Software—Infrastructure,"Veritone, Inc.","Veritone, Inc. provides artificial intelligence (AI) computing solutions in the United States and the United Kingdom. It develops and operates aiWARE platform, an AI operating system that integrates and orchestrates a range of cognitive engines to reveal multivariate insights from structured and unstructured data, as well as to conduct cognitive workflows based on these insights. The company also provides media advertising agency services, including media planning and strategy, media buying and placement, campaign messaging, clearance verification and attribution, and custom analytics directly to advertisers through outbound sales networking, and client and partner referrals, as well as indirectly through advertising agencies or marketing consultants. It serves media and entertainment, legal and compliance, and government markets. The company was formerly known as Veritone Delaware, Inc. and changed its name to Veritone, Inc. in July 2014. Veritone, Inc. was founded in 2014 and is headquartered in Costa Mesa, California."
VERI,2019-12-31,22201000,-63530000,NA,-62078000,72211000,32359000,-62053000,-62053000,NA,-1452000,49648000,111701000,17289000,-1477000,NA,-62078000,-62078000,NA,income_statement,Software—Infrastructure,"Veritone, Inc.","Veritone, Inc. provides artificial intelligence (AI) computing solutions in the United States and the United Kingdom. It develops and operates aiWARE platform, an AI operating system that integrates and orchestrates a range of cognitive engines to reveal multivariate insights from structured and unstructured data, as well as to conduct cognitive workflows based on these insights. The company also provides media advertising agency services, including media planning and strategy, media buying and placement, campaign messaging, clearance verification and attribution, and custom analytics directly to advertisers through outbound sales networking, and client and partner referrals, as well as indirectly through advertising agencies or marketing consultants. It serves media and entertainment, legal and compliance, and government markets. The company was formerly known as Veritone Delaware, Inc. and changed its name to Veritone, Inc. in July 2014. Veritone, Inc. was founded in 2014 and is headquartered in Costa Mesa, California."
VERO,2016-12-31,4693000,-12098000,2816000,-12600000,41860000,40384000,-6472000,-6472000,-2733000,390000,53142000,59614000,12758000,-5626000,NA,-12488000,-12600000,NA,income_statement,Medical Devices,Venus Concept Inc.,"Venus Concept Inc. operates as a medical aesthetic technology company worldwide. Its product portfolio includes aesthetic device platforms, including Venus Versa, a multi-treatment platform to address the aesthetic procedures without surgery or downtime; Venus Legacy, an advanced device that resolves challenging face and body aesthetic needs; Venus Velocity, a diode laser for hair removal; Venus Fiore, which addresses internal vaginal health restoration, labia skin tightening, and mons pubis reduction; Venus Viva, a customizable skin resurfacing device that allows operator control of ablation and coagulation for resolving the appearance of mild to severe skin damage for various skin types; Venus Freeze Plus, an anti-aging system for non-invasive skin tightening; and Venus Bliss, a solution for the fat reduction category. The company also offers NeoGraft, an automated hair restoration system that facilitates the harvesting of follicles during a FUE process; and ARTAS and ARTAS iX robotic hair restoration systems, which harvest follicular units directly from the scalp and create recipient implant sites using proprietary algorithms. Venus Concept Inc. is headquartered in Toronto, Canada."
VERO,2017-12-31,5678000,7883000,2816000,5726000,47264000,68208000,12801000,12801000,-5503000,479000,89074000,76273000,20866000,-4918000,NA,7404000,2798000,NA,income_statement,Medical Devices,Venus Concept Inc.,"Venus Concept Inc. operates as a medical aesthetic technology company worldwide. Its product portfolio includes aesthetic device platforms, including Venus Versa, a multi-treatment platform to address the aesthetic procedures without surgery or downtime; Venus Legacy, an advanced device that resolves challenging face and body aesthetic needs; Venus Velocity, a diode laser for hair removal; Venus Fiore, which addresses internal vaginal health restoration, labia skin tightening, and mons pubis reduction; Venus Viva, a customizable skin resurfacing device that allows operator control of ablation and coagulation for resolving the appearance of mild to severe skin damage for various skin types; Venus Freeze Plus, an anti-aging system for non-invasive skin tightening; and Venus Bliss, a solution for the fat reduction category. The company also offers NeoGraft, an automated hair restoration system that facilitates the harvesting of follicles during a FUE process; and ARTAS and ARTAS iX robotic hair restoration systems, which harvest follicular units directly from the scalp and create recipient implant sites using proprietary algorithms. Venus Concept Inc. is headquartered in Toronto, Canada."
VERO,2018-12-31,7047000,-11994000,4022000,-14959000,64747000,79355000,-3367000,-3367000,-5361000,2215000,102614000,105981000,23259000,-8627000,NA,-14209000,-14959000,NA,income_statement,Medical Devices,Venus Concept Inc.,"Venus Concept Inc. operates as a medical aesthetic technology company worldwide. Its product portfolio includes aesthetic device platforms, including Venus Versa, a multi-treatment platform to address the aesthetic procedures without surgery or downtime; Venus Legacy, an advanced device that resolves challenging face and body aesthetic needs; Venus Velocity, a diode laser for hair removal; Venus Fiore, which addresses internal vaginal health restoration, labia skin tightening, and mons pubis reduction; Venus Viva, a customizable skin resurfacing device that allows operator control of ablation and coagulation for resolving the appearance of mild to severe skin damage for various skin types; Venus Freeze Plus, an anti-aging system for non-invasive skin tightening; and Venus Bliss, a solution for the fat reduction category. The company also offers NeoGraft, an automated hair restoration system that facilitates the harvesting of follicles during a FUE process; and ARTAS and ARTAS iX robotic hair restoration systems, which harvest follicular units directly from the scalp and create recipient implant sites using proprietary algorithms. Venus Concept Inc. is headquartered in Toronto, Canada."
VERO,2019-12-31,8034000,-40438000,2500000,-40619000,76706000,76653000,-18078000,-18078000,-7846000,1857000,110406000,128484000,33753000,-22360000,NA,-42295000,-40619000,NA,income_statement,Medical Devices,Venus Concept Inc.,"Venus Concept Inc. operates as a medical aesthetic technology company worldwide. Its product portfolio includes aesthetic device platforms, including Venus Versa, a multi-treatment platform to address the aesthetic procedures without surgery or downtime; Venus Legacy, an advanced device that resolves challenging face and body aesthetic needs; Venus Velocity, a diode laser for hair removal; Venus Fiore, which addresses internal vaginal health restoration, labia skin tightening, and mons pubis reduction; Venus Viva, a customizable skin resurfacing device that allows operator control of ablation and coagulation for resolving the appearance of mild to severe skin damage for various skin types; Venus Freeze Plus, an anti-aging system for non-invasive skin tightening; and Venus Bliss, a solution for the fat reduction category. The company also offers NeoGraft, an automated hair restoration system that facilitates the harvesting of follicles during a FUE process; and ARTAS and ARTAS iX robotic hair restoration systems, which harvest follicular units directly from the scalp and create recipient implant sites using proprietary algorithms. Venus Concept Inc. is headquartered in Toronto, Canada."
VERU,2017-09-30,3076390,-8602490,NA,-6612047,11501453,7019512,-7558331,-7558331,-2950501,-1990443,13655592,21213923,6636080,-1044159,NA,-6612047,-8602818,NA,income_statement,Biotechnology,Veru Inc.,"Veru Inc., an oncology biopharmaceutical company, focuses on developing medicines for the management of cancers. Its commercial products comprise FC2 female condom/internal condom for the dual protection against unintended pregnancy and the transmission of sexually transmitted infections for ministries of health, government health agencies, U.N. agencies, nonprofit organizations, and commercial partners. The company's development drug candidates include VERU-111, an oral chemical entity that is being evaluated in open label Phase 1b and Phase 2 clinical trials in men with metastatic castration and androgen receptor targeting agent resistant prostate cancer, as well as being evaluated in a Phase 2 clinical trial for the treatment of SARS-CoV-2 in subjects at high risk for acute respiratory distress syndrome; and for the treatment of taxane resistant metastatic triple negative breast cancer. Its drug candidates also comprise VERU-100, a gonadotropin-releasing hormone antagonist peptide formulation to address the current limitations of commercially available androgen deprivation therapies (ADT) for advanced prostate cancer; and Zuclomiphene Citrate, an oral nonsteroidal estrogen receptor agonist to treat hot flashes, a common side effect caused by ADT in men with advanced prostate cancer. In addition, the company's drug candidates include Enobosarm, an oral selective androgen receptor agonist that targets the androgen receptor positive, estrogen receptor positive, and human epidermal growth factor receptor 2 metastatic breast cancer without the unwanted virilizing side effects. Further, it is advancing a new drug formulation in its specialty pharmaceutical pipeline addressing unmet medical needs in urology, such as Tadalafil and Finasteride Combination. The company was formerly known as The Female Health Company and changed its name to Veru Inc. in July 2017. Veru Inc. is headquartered in Miami, Florida."
VERU,2018-09-30,10850958,-23072287,NA,-23938389,14807472,8772541,-16885889,-16885889,-2950501,866102,15864483,32750372,7091942,-6186398,NA,-23938389,-23938389,NA,income_statement,Biotechnology,Veru Inc.,"Veru Inc., an oncology biopharmaceutical company, focuses on developing medicines for the management of cancers. Its commercial products comprise FC2 female condom/internal condom for the dual protection against unintended pregnancy and the transmission of sexually transmitted infections for ministries of health, government health agencies, U.N. agencies, nonprofit organizations, and commercial partners. The company's development drug candidates include VERU-111, an oral chemical entity that is being evaluated in open label Phase 1b and Phase 2 clinical trials in men with metastatic castration and androgen receptor targeting agent resistant prostate cancer, as well as being evaluated in a Phase 2 clinical trial for the treatment of SARS-CoV-2 in subjects at high risk for acute respiratory distress syndrome; and for the treatment of taxane resistant metastatic triple negative breast cancer. Its drug candidates also comprise VERU-100, a gonadotropin-releasing hormone antagonist peptide formulation to address the current limitations of commercially available androgen deprivation therapies (ADT) for advanced prostate cancer; and Zuclomiphene Citrate, an oral nonsteroidal estrogen receptor agonist to treat hot flashes, a common side effect caused by ADT in men with advanced prostate cancer. In addition, the company's drug candidates include Enobosarm, an oral selective androgen receptor agonist that targets the androgen receptor positive, estrogen receptor positive, and human epidermal growth factor receptor 2 metastatic breast cancer without the unwanted virilizing side effects. Further, it is advancing a new drug formulation in its specialty pharmaceutical pipeline addressing unmet medical needs in urology, such as Tadalafil and Finasteride Combination. The company was formerly known as The Female Health Company and changed its name to Veru Inc. in July 2017. Veru Inc. is headquartered in Miami, Florida."
VERU,2019-09-30,13743826,-12321299,NA,-12017366,14348890,21656822,-6435894,-6435894,-4706056,-303933,31803387,38239281,10146565,-5885405,NA,-12017366,-12017366,NA,income_statement,Biotechnology,Veru Inc.,"Veru Inc., an oncology biopharmaceutical company, focuses on developing medicines for the management of cancers. Its commercial products comprise FC2 female condom/internal condom for the dual protection against unintended pregnancy and the transmission of sexually transmitted infections for ministries of health, government health agencies, U.N. agencies, nonprofit organizations, and commercial partners. The company's development drug candidates include VERU-111, an oral chemical entity that is being evaluated in open label Phase 1b and Phase 2 clinical trials in men with metastatic castration and androgen receptor targeting agent resistant prostate cancer, as well as being evaluated in a Phase 2 clinical trial for the treatment of SARS-CoV-2 in subjects at high risk for acute respiratory distress syndrome; and for the treatment of taxane resistant metastatic triple negative breast cancer. Its drug candidates also comprise VERU-100, a gonadotropin-releasing hormone antagonist peptide formulation to address the current limitations of commercially available androgen deprivation therapies (ADT) for advanced prostate cancer; and Zuclomiphene Citrate, an oral nonsteroidal estrogen receptor agonist to treat hot flashes, a common side effect caused by ADT in men with advanced prostate cancer. In addition, the company's drug candidates include Enobosarm, an oral selective androgen receptor agonist that targets the androgen receptor positive, estrogen receptor positive, and human epidermal growth factor receptor 2 metastatic breast cancer without the unwanted virilizing side effects. Further, it is advancing a new drug formulation in its specialty pharmaceutical pipeline addressing unmet medical needs in urology, such as Tadalafil and Finasteride Combination. The company was formerly known as The Female Health Company and changed its name to Veru Inc. in July 2017. Veru Inc. is headquartered in Miami, Florida."
VERU,2020-09-30,16935222,-20051976,NA,-18973535,14498330,30786858,-646694,-646694,-4621422,-1078441,42592060,43238754,11805202,-19405282,NA,-18973535,-18973535,NA,income_statement,Biotechnology,Veru Inc.,"Veru Inc., an oncology biopharmaceutical company, focuses on developing medicines for the management of cancers. Its commercial products comprise FC2 female condom/internal condom for the dual protection against unintended pregnancy and the transmission of sexually transmitted infections for ministries of health, government health agencies, U.N. agencies, nonprofit organizations, and commercial partners. The company's development drug candidates include VERU-111, an oral chemical entity that is being evaluated in open label Phase 1b and Phase 2 clinical trials in men with metastatic castration and androgen receptor targeting agent resistant prostate cancer, as well as being evaluated in a Phase 2 clinical trial for the treatment of SARS-CoV-2 in subjects at high risk for acute respiratory distress syndrome; and for the treatment of taxane resistant metastatic triple negative breast cancer. Its drug candidates also comprise VERU-100, a gonadotropin-releasing hormone antagonist peptide formulation to address the current limitations of commercially available androgen deprivation therapies (ADT) for advanced prostate cancer; and Zuclomiphene Citrate, an oral nonsteroidal estrogen receptor agonist to treat hot flashes, a common side effect caused by ADT in men with advanced prostate cancer. In addition, the company's drug candidates include Enobosarm, an oral selective androgen receptor agonist that targets the androgen receptor positive, estrogen receptor positive, and human epidermal growth factor receptor 2 metastatic breast cancer without the unwanted virilizing side effects. Further, it is advancing a new drug formulation in its specialty pharmaceutical pipeline addressing unmet medical needs in urology, such as Tadalafil and Finasteride Combination. The company was formerly known as The Female Health Company and changed its name to Veru Inc. in July 2017. Veru Inc. is headquartered in Miami, Florida."
VERX,2018-12-31,23755000,-4427000,NA,-6106000,115845000,176705000,29980000,29980000,-2120000,1679000,272403000,242423000,95698000,-34407000,NA,-6106000,-6106000,-812000,income_statement,Software—Application,"Vertex, Inc.","Vertex, Inc. provides tax technology solutions for corporations in retail, leasing, communication, and manufacturing industries in the United States and internationally. It offers tax determination, compliance and reporting, tax data management, document management, pre-built integration, and industry-specific solutions. The company sells its software products through software license and software as a service subscriptions. It also offers implementation and training services in connection with its software license and cloud subscriptions, transaction tax returns outsourcing, and other tax-related services. The company was founded in 1978 and is headquartered in King of Prussia, Pennsylvania."
VERX,2019-12-31,30557000,30902000,NA,31057000,138637000,211122000,32443000,32443000,-2036000,-155000,321500000,289057000,110378000,-1541000,NA,31057000,31057000,489000,income_statement,Software—Application,"Vertex, Inc.","Vertex, Inc. provides tax technology solutions for corporations in retail, leasing, communication, and manufacturing industries in the United States and internationally. It offers tax determination, compliance and reporting, tax data management, document management, pre-built integration, and industry-specific solutions. The company sells its software products through software license and software as a service subscriptions. It also offers implementation and training services in connection with its software license and cloud subscriptions, transaction tax returns outsourcing, and other tax-related services. The company was founded in 1978 and is headquartered in King of Prussia, Pennsylvania."
VERY,2016-12-31,NA,-22171000,NA,-15338000,58538000,36531000,-22171000,-22171000,NA,-6833000,112999000,135170000,76468000,0,NA,-15338000,-15338000,164000,income_statement,Insurance—Life,"Vericity, Inc.","Vericity, Inc., through its subsidiaries, provides life insurance protection products for the middle American market. The company operates through Agency and Insurance segments. The Agency segment sells life insurance products for unaffiliated insurance companies through its call center distribution platform, as well as through its independent agents and other marketing organizations. This segment is also involved in the insurance lead sale activities through its eCoverage web presence. The Insurance segment provides term life, accidental death, and final expense products. This segment distributes its life insurance products through independent producers, including direct distributors that market to consumers through call centers and regional and national independent producer groups. Vericity, Inc. is headquartered in Chicago, Illinois."
VERY,2017-12-31,NA,-10942000,NA,-8241000,55912000,45133000,-10942000,-10942000,NA,-2701000,115870000,126812000,70737000,0,NA,-8241000,-8241000,163000,income_statement,Insurance—Life,"Vericity, Inc.","Vericity, Inc., through its subsidiaries, provides life insurance protection products for the middle American market. The company operates through Agency and Insurance segments. The Agency segment sells life insurance products for unaffiliated insurance companies through its call center distribution platform, as well as through its independent agents and other marketing organizations. This segment is also involved in the insurance lead sale activities through its eCoverage web presence. The Insurance segment provides term life, accidental death, and final expense products. This segment distributes its life insurance products through independent producers, including direct distributors that market to consumers through call centers and regional and national independent producer groups. Vericity, Inc. is headquartered in Chicago, Illinois."
VERY,2018-12-31,NA,-16197000,NA,-13847000,68353000,52320000,-16197000,-16197000,NA,-2350000,123980000,140177000,71660000,0,NA,-13847000,-13847000,164000,income_statement,Insurance—Life,"Vericity, Inc.","Vericity, Inc., through its subsidiaries, provides life insurance protection products for the middle American market. The company operates through Agency and Insurance segments. The Agency segment sells life insurance products for unaffiliated insurance companies through its call center distribution platform, as well as through its independent agents and other marketing organizations. This segment is also involved in the insurance lead sale activities through its eCoverage web presence. The Insurance segment provides term life, accidental death, and final expense products. This segment distributes its life insurance products through independent producers, including direct distributors that market to consumers through call centers and regional and national independent producer groups. Vericity, Inc. is headquartered in Chicago, Illinois."
VERY,2019-12-31,NA,-20196000,NA,-19324000,76953000,56840000,-20196000,-20196000,NA,-872000,135300000,155496000,78460000,0,NA,-19324000,-19324000,83000,income_statement,Insurance—Life,"Vericity, Inc.","Vericity, Inc., through its subsidiaries, provides life insurance protection products for the middle American market. The company operates through Agency and Insurance segments. The Agency segment sells life insurance products for unaffiliated insurance companies through its call center distribution platform, as well as through its independent agents and other marketing organizations. This segment is also involved in the insurance lead sale activities through its eCoverage web presence. The Insurance segment provides term life, accidental death, and final expense products. This segment distributes its life insurance products through independent producers, including direct distributors that market to consumers through call centers and regional and national independent producer groups. Vericity, Inc. is headquartered in Chicago, Illinois."
VFC,2017-12-30,NA,787879000,NA,614923000,3626301000,4550036000,923735000,923735000,-101974000,519809000,8394684000,7470949000,3844648000,-135856000,346853000,268070000,614923000,NA,income_statement,NA,NA,NA
VFC,2018-03-31,NA,1278414000,NA,658553000,4508093000,5886506000,1378413000,1378413000,-102384000,641506000,11492383000,10113970000,5605877000,-99999000,21645000,636908000,658553000,NA,income_statement,NA,NA,NA
VFC,2019-03-30,NA,1038313000,NA,1259792000,4302258000,5625161000,1322903000,1322903000,-107738000,167887000,10266887000,8943984000,4641726000,-284590000,389366000,870426000,1259792000,NA,income_statement,NA,NA,NA
VFC,2020-03-28,NA,727208000,NA,679449000,4529120000,5817436000,1288316000,1288316000,-92042000,98062000,10488556000,9200240000,4671120000,-561108000,50303000,629146000,679449000,NA,income_statement,NA,NA,NA
VFF,2016-12-31,NA,-3087000,NA,-1983000,13720000,13223000,-497000,-497000,-2514000,-1104000,155502000,155999000,142279000,-2590000,NA,-1983000,-1983000,NA,income_statement,Farm Products,"Village Farms International, In","Village Farms International, Inc., together with its subsidiaries, produces, markets, and distributes greenhouse-grown tomatoes, bell peppers, and cucumbers in North America. It operates through three segments: Produce Business, Energy Business, and Cannabis and Hemp Business. The company also owns and operates a 7.0 megawatt power plant that generates and sells electricity to British Columbia Hydro and Power Authority; and produces and supplies cannabis products. It markets and distributes its products under the Village Farms brand name to retail supermarkets and fresh food distribution companies, as well as products produced under exclusive arrangements with other greenhouse producers. The company was formerly known as Village Farms Canada Inc. and changed its name to Village Farms International, Inc. in December 2009. Village Farms International, Inc. was founded in 1989 and is headquartered in Delta, Canada."
VFF,2017-12-31,NA,-5520000,NA,-4757000,16394000,13973000,-2421000,-2421000,-2695000,-763000,158406000,160827000,144433000,-3099000,NA,-4757000,-4757000,NA,income_statement,Farm Products,"Village Farms International, In","Village Farms International, Inc., together with its subsidiaries, produces, markets, and distributes greenhouse-grown tomatoes, bell peppers, and cucumbers in North America. It operates through three segments: Produce Business, Energy Business, and Cannabis and Hemp Business. The company also owns and operates a 7.0 megawatt power plant that generates and sells electricity to British Columbia Hydro and Power Authority; and produces and supplies cannabis products. It markets and distributes its products under the Village Farms brand name to retail supermarkets and fresh food distribution companies, as well as products produced under exclusive arrangements with other greenhouse producers. The company was formerly known as Village Farms Canada Inc. and changed its name to Village Farms International, Inc. in December 2009. Village Farms International, Inc. was founded in 1989 and is headquartered in Delta, Canada."
VFF,2018-12-31,NA,-9815000,NA,-7515000,15562000,9317000,-6245000,-6245000,-2794000,-2300000,150000000,156245000,140683000,-3570000,NA,-7515000,-7515000,NA,income_statement,Farm Products,"Village Farms International, In","Village Farms International, Inc., together with its subsidiaries, produces, markets, and distributes greenhouse-grown tomatoes, bell peppers, and cucumbers in North America. It operates through three segments: Produce Business, Energy Business, and Cannabis and Hemp Business. The company also owns and operates a 7.0 megawatt power plant that generates and sells electricity to British Columbia Hydro and Power Authority; and produces and supplies cannabis products. It markets and distributes its products under the Village Farms brand name to retail supermarkets and fresh food distribution companies, as well as products produced under exclusive arrangements with other greenhouse producers. The company was formerly known as Village Farms Canada Inc. and changed its name to Village Farms International, Inc. in December 2009. Village Farms International, Inc. was founded in 1989 and is headquartered in Delta, Canada."
VFF,2019-12-31,NA,-3541000,NA,2325000,21476000,-7345000,-28821000,-28821000,-2614000,-5866000,144568000,173389000,151913000,25280000,NA,2325000,2325000,NA,income_statement,Farm Products,"Village Farms International, In","Village Farms International, Inc., together with its subsidiaries, produces, markets, and distributes greenhouse-grown tomatoes, bell peppers, and cucumbers in North America. It operates through three segments: Produce Business, Energy Business, and Cannabis and Hemp Business. The company also owns and operates a 7.0 megawatt power plant that generates and sells electricity to British Columbia Hydro and Power Authority; and produces and supplies cannabis products. It markets and distributes its products under the Village Farms brand name to retail supermarkets and fresh food distribution companies, as well as products produced under exclusive arrangements with other greenhouse producers. The company was formerly known as Village Farms Canada Inc. and changed its name to Village Farms International, Inc. in December 2009. Village Farms International, Inc. was founded in 1989 and is headquartered in Delta, Canada."
VG,2017-12-31,29630000,45793000,NA,-33933000,435788000,597332000,59391000,59391000,-14868000,79726000,1002286000,942895000,404954000,-13598000,NA,-33933000,-33933000,NA,income_statement,Telecom Services,Vonage Holdings Corp.,"Vonage Holdings Corp. provides cloud communications services for businesses and consumers. It operates through two segments, Business and Consumer. The Business segment offers cloud-based applications comprising integrated voice, text, video, data, collaboration, and mobile applications over SIP based VoIP network; API solutions designed to enhance the way businesses communicate with their customers by embedding communications into apps, websites, and business processes; and Vonage Business Cloud and Vonage Enterprise services. The Consumer segment provides home telephone services through various service plans with basic features, including voicemail, call waiting, call forwarding, simulring, visual voicemail, and extensions, as well as area code selection, virtual phone number, and Web-enabled voicemail. It also offers Vonage World and Vonage North America consumer plans. In addition, the company provides Vonage-enabled devices, which allow customers to use the Internet connection for their computer and telephones at the same time; and high-speed broadband Internet service that allows calls over the Internet either from a telephone through a Vonage-enabled device, or through soft phone software, or mobile client applications. Vonage Holdings Corp. sells its products through its sales agents, Websites, and toll free numbers for consumers and businesses in the United States, Canada, the United Kingdom, the European Union, and Asia. Vonage Holdings Corp. was incorporated in 2000 and is headquartered in Holmdel, New Jersey."
VG,2018-12-31,52139000,36525000,NA,35728000,437130000,621787000,61538000,61538000,-15068000,797000,1048782000,987244000,426995000,-25013000,NA,35728000,35728000,NA,income_statement,Telecom Services,Vonage Holdings Corp.,"Vonage Holdings Corp. provides cloud communications services for businesses and consumers. It operates through two segments, Business and Consumer. The Business segment offers cloud-based applications comprising integrated voice, text, video, data, collaboration, and mobile applications over SIP based VoIP network; API solutions designed to enhance the way businesses communicate with their customers by embedding communications into apps, websites, and business processes; and Vonage Business Cloud and Vonage Enterprise services. The Consumer segment provides home telephone services through various service plans with basic features, including voicemail, call waiting, call forwarding, simulring, visual voicemail, and extensions, as well as area code selection, virtual phone number, and Web-enabled voicemail. It also offers Vonage World and Vonage North America consumer plans. In addition, the company provides Vonage-enabled devices, which allow customers to use the Internet connection for their computer and telephones at the same time; and high-speed broadband Internet service that allows calls over the Internet either from a telephone through a Vonage-enabled device, or through soft phone software, or mobile client applications. Vonage Holdings Corp. sells its products through its sales agents, Websites, and toll free numbers for consumers and businesses in the United States, Canada, the United Kingdom, the European Union, and Asia. Vonage Holdings Corp. was incorporated in 2000 and is headquartered in Holmdel, New Jersey."
VG,2019-12-31,69460000,-26108000,NA,-19482000,515530000,678262000,7016000,7016000,-32821000,-6626000,1189346000,1182330000,511084000,-33124000,NA,-19482000,-19482000,NA,income_statement,Telecom Services,Vonage Holdings Corp.,"Vonage Holdings Corp. provides cloud communications services for businesses and consumers. It operates through two segments, Business and Consumer. The Business segment offers cloud-based applications comprising integrated voice, text, video, data, collaboration, and mobile applications over SIP based VoIP network; API solutions designed to enhance the way businesses communicate with their customers by embedding communications into apps, websites, and business processes; and Vonage Business Cloud and Vonage Enterprise services. The Consumer segment provides home telephone services through various service plans with basic features, including voicemail, call waiting, call forwarding, simulring, visual voicemail, and extensions, as well as area code selection, virtual phone number, and Web-enabled voicemail. It also offers Vonage World and Vonage North America consumer plans. In addition, the company provides Vonage-enabled devices, which allow customers to use the Internet connection for their computer and telephones at the same time; and high-speed broadband Internet service that allows calls over the Internet either from a telephone through a Vonage-enabled device, or through soft phone software, or mobile client applications. Vonage Holdings Corp. sells its products through its sales agents, Websites, and toll free numbers for consumers and businesses in the United States, Canada, the United Kingdom, the European Union, and Asia. Vonage Holdings Corp. was incorporated in 2000 and is headquartered in Holmdel, New Jersey."
VG,2020-12-31,81484000,-31995000,NA,-36212000,524159000,694411000,-149000,-149000,-32160000,4217000,1185357000,1185506000,490946000,-31846000,NA,-36212000,-36212000,NA,income_statement,Telecom Services,Vonage Holdings Corp.,"Vonage Holdings Corp. provides cloud communications services for businesses and consumers. It operates through two segments, Business and Consumer. The Business segment offers cloud-based applications comprising integrated voice, text, video, data, collaboration, and mobile applications over SIP based VoIP network; API solutions designed to enhance the way businesses communicate with their customers by embedding communications into apps, websites, and business processes; and Vonage Business Cloud and Vonage Enterprise services. The Consumer segment provides home telephone services through various service plans with basic features, including voicemail, call waiting, call forwarding, simulring, visual voicemail, and extensions, as well as area code selection, virtual phone number, and Web-enabled voicemail. It also offers Vonage World and Vonage North America consumer plans. In addition, the company provides Vonage-enabled devices, which allow customers to use the Internet connection for their computer and telephones at the same time; and high-speed broadband Internet service that allows calls over the Internet either from a telephone through a Vonage-enabled device, or through soft phone software, or mobile client applications. Vonage Holdings Corp. sells its products through its sales agents, Websites, and toll free numbers for consumers and businesses in the United States, Canada, the United Kingdom, the European Union, and Asia. Vonage Holdings Corp. was incorporated in 2000 and is headquartered in Holmdel, New Jersey."
VIAC,2016-12-31,NA,2180000000,293000000,1261000000,2124000000,5210000000,2852000000,2852000000,-411000000,628000000,13166000000,10314000000,7956000000,-672000000,-291000000,1552000000,1261000000,9000000,income_statement,NA,NA,NA
VIAC,2017-12-31,NA,4124000000,293000000,2321000000,5252000000,11052000000,5357000000,5357000000,-1088000000,804000000,26535000000,21178000000,15483000000,-1233000000,-947000000,3320000000,2321000000,NA,income_statement,NA,NA,NA
VIAC,2018-12-31,NA,4077000000,293000000,3455000000,5274000000,11333000000,5626000000,5626000000,-1030000000,617000000,27250000000,21624000000,15917000000,-1549000000,32000000,3460000000,3455000000,NA,income_statement,NA,NA,NA
VIAC,2019-12-31,NA,3292000000,336000000,3308000000,5752000000,10589000000,4414000000,4414000000,-962000000,-9000000,27812000000,23398000000,17223000000,-1122000000,38000000,3301000000,3308000000,NA,income_statement,NA,NA,NA
VIACA,2016-12-31,NA,2180000000,293000000,1261000000,2124000000,5210000000,2852000000,2852000000,-411000000,628000000,13166000000,10314000000,7956000000,-672000000,-291000000,1552000000,1261000000,9000000,income_statement,Entertainment,ViacomCBS Inc.,"ViacomCBS Inc. operates as a media and entertainment company worldwide. The company operates in four segments: TV Entertainment, Cable Networks, Filmed Entertainment, and Publishing. The TV Entertainment segment distributes a schedule of news and public affairs broadcasts, and sports and entertainment programming; produces, acquires, and/or distributes programming, including series, specials, news, and public affairs; operates online content networks for information and entertainment; and streaming subscription services. This segment also operates CBS Sports Network, a 24/7 cable program service that provides college sports and related content, as well as broadcast television stations. The Cable Networks segment creates and acquires programming for distribution and viewing on various media platforms, including subscription cable networks, subscription streaming, basic cable networks, international broadcast networks, and free streaming TV platform, as well as for licensing to third parties. The Filmed Entertainment segment develops, produces, finances, acquires, and distributes films, television programming, and other entertainment content. The Publishing segment publishes and distributes adult and children's consumer books in printed, digital, and audio formats; develops special imprints and publishes titles based on the products of the company, as well as of third parties; and distributes products for other publishers. This segment also delivers content; and promotes its products on its Websites, social media, and general Internet sites, as well as those related to individual titles. The company was formerly known as CBS Corporation and changed its name to ViacomCBS Inc. in December 2019. ViacomCBS Inc. was founded in 1986 and is headquartered in New York, New York."
VIACA,2017-12-31,NA,4124000000,293000000,2321000000,5252000000,11052000000,5357000000,5357000000,-1088000000,804000000,26535000000,21178000000,15483000000,-1233000000,-947000000,3320000000,2321000000,NA,income_statement,Entertainment,ViacomCBS Inc.,"ViacomCBS Inc. operates as a media and entertainment company worldwide. The company operates in four segments: TV Entertainment, Cable Networks, Filmed Entertainment, and Publishing. The TV Entertainment segment distributes a schedule of news and public affairs broadcasts, and sports and entertainment programming; produces, acquires, and/or distributes programming, including series, specials, news, and public affairs; operates online content networks for information and entertainment; and streaming subscription services. This segment also operates CBS Sports Network, a 24/7 cable program service that provides college sports and related content, as well as broadcast television stations. The Cable Networks segment creates and acquires programming for distribution and viewing on various media platforms, including subscription cable networks, subscription streaming, basic cable networks, international broadcast networks, and free streaming TV platform, as well as for licensing to third parties. The Filmed Entertainment segment develops, produces, finances, acquires, and distributes films, television programming, and other entertainment content. The Publishing segment publishes and distributes adult and children's consumer books in printed, digital, and audio formats; develops special imprints and publishes titles based on the products of the company, as well as of third parties; and distributes products for other publishers. This segment also delivers content; and promotes its products on its Websites, social media, and general Internet sites, as well as those related to individual titles. The company was formerly known as CBS Corporation and changed its name to ViacomCBS Inc. in December 2019. ViacomCBS Inc. was founded in 1986 and is headquartered in New York, New York."
VIACA,2018-12-31,NA,4077000000,293000000,3455000000,5274000000,11333000000,5626000000,5626000000,-1030000000,617000000,27250000000,21624000000,15917000000,-1549000000,32000000,3460000000,3455000000,NA,income_statement,Entertainment,ViacomCBS Inc.,"ViacomCBS Inc. operates as a media and entertainment company worldwide. The company operates in four segments: TV Entertainment, Cable Networks, Filmed Entertainment, and Publishing. The TV Entertainment segment distributes a schedule of news and public affairs broadcasts, and sports and entertainment programming; produces, acquires, and/or distributes programming, including series, specials, news, and public affairs; operates online content networks for information and entertainment; and streaming subscription services. This segment also operates CBS Sports Network, a 24/7 cable program service that provides college sports and related content, as well as broadcast television stations. The Cable Networks segment creates and acquires programming for distribution and viewing on various media platforms, including subscription cable networks, subscription streaming, basic cable networks, international broadcast networks, and free streaming TV platform, as well as for licensing to third parties. The Filmed Entertainment segment develops, produces, finances, acquires, and distributes films, television programming, and other entertainment content. The Publishing segment publishes and distributes adult and children's consumer books in printed, digital, and audio formats; develops special imprints and publishes titles based on the products of the company, as well as of third parties; and distributes products for other publishers. This segment also delivers content; and promotes its products on its Websites, social media, and general Internet sites, as well as those related to individual titles. The company was formerly known as CBS Corporation and changed its name to ViacomCBS Inc. in December 2019. ViacomCBS Inc. was founded in 1986 and is headquartered in New York, New York."
VIACA,2019-12-31,NA,3292000000,336000000,3308000000,5752000000,10589000000,4414000000,4414000000,-962000000,-9000000,27812000000,23398000000,17223000000,-1122000000,38000000,3301000000,3308000000,NA,income_statement,Entertainment,ViacomCBS Inc.,"ViacomCBS Inc. operates as a media and entertainment company worldwide. The company operates in four segments: TV Entertainment, Cable Networks, Filmed Entertainment, and Publishing. The TV Entertainment segment distributes a schedule of news and public affairs broadcasts, and sports and entertainment programming; produces, acquires, and/or distributes programming, including series, specials, news, and public affairs; operates online content networks for information and entertainment; and streaming subscription services. This segment also operates CBS Sports Network, a 24/7 cable program service that provides college sports and related content, as well as broadcast television stations. The Cable Networks segment creates and acquires programming for distribution and viewing on various media platforms, including subscription cable networks, subscription streaming, basic cable networks, international broadcast networks, and free streaming TV platform, as well as for licensing to third parties. The Filmed Entertainment segment develops, produces, finances, acquires, and distributes films, television programming, and other entertainment content. The Publishing segment publishes and distributes adult and children's consumer books in printed, digital, and audio formats; develops special imprints and publishes titles based on the products of the company, as well as of third parties; and distributes products for other publishers. This segment also delivers content; and promotes its products on its Websites, social media, and general Internet sites, as well as those related to individual titles. The company was formerly known as CBS Corporation and changed its name to ViacomCBS Inc. in December 2019. ViacomCBS Inc. was founded in 1986 and is headquartered in New York, New York."
VIAV,2017-07-01,136300000,180000000,NA,160200000,300100000,495700000,31000000,31000000,-43200000,21400000,805000000,774000000,309300000,149000000,1600000,158600000,160200000,NA,income_statement,Communication Equipment,Viavi Solutions Inc.,"Viavi Solutions Inc. provides network test, monitoring, and assurance solutions to communications service providers, enterprises, network equipment manufacturers, government, civil, military, and avionics customers worldwide. The company operates through three segments: Network Enablement (NE), Service Enablement (SE), and Optical Security and Performance Products (OSP) segments. The NE segment offers testing solutions that access the network to perform build-out and maintenance tasks. This segment provides solutions that include instruments, software, and services to design, build, activate, certify, troubleshoot, and optimize networks; and instrumentation for communication and safety. It also offers support and professional services, such as repair, calibration, software support, and technical assistance for the products; and system integration projects, including project management, installation, and implementation, as well as product and technology training, and consulting services. The SE segment provides embedded systems and enterprise performance management solutions for communication service providers, enterprises, and cloud operators with visibility into network, service, and application data. Its solutions include instruments, microprobes, and software, which monitor, collect, and analyze network data to reveal the actual customer experience and to identify opportunities for new revenue streams and network optimization. The OSP segment offers optical products for anti-counterfeiting, government, industrial, automotive, and consumer electronic markets, including 3D sensing applications. The company was formerly known as JDS Uniphase Corporation and changed its name to Viavi Solutions Inc. in August 2015. Viavi Solutions Inc. was founded in 1923 and is headquartered in San Jose, California."
VIAV,2018-06-30,133300000,-35700000,NA,-48600000,323900000,528800000,23900000,23900000,-47300000,12900000,875700000,851800000,346900000,-59600000,-2400000,-48600000,-48600000,NA,income_statement,Communication Equipment,Viavi Solutions Inc.,"Viavi Solutions Inc. provides network test, monitoring, and assurance solutions to communications service providers, enterprises, network equipment manufacturers, government, civil, military, and avionics customers worldwide. The company operates through three segments: Network Enablement (NE), Service Enablement (SE), and Optical Security and Performance Products (OSP) segments. The NE segment offers testing solutions that access the network to perform build-out and maintenance tasks. This segment provides solutions that include instruments, software, and services to design, build, activate, certify, troubleshoot, and optimize networks; and instrumentation for communication and safety. It also offers support and professional services, such as repair, calibration, software support, and technical assistance for the products; and system integration projects, including project management, installation, and implementation, as well as product and technology training, and consulting services. The SE segment provides embedded systems and enterprise performance management solutions for communication service providers, enterprises, and cloud operators with visibility into network, service, and application data. Its solutions include instruments, microprobes, and software, which monitor, collect, and analyze network data to reveal the actual customer experience and to identify opportunities for new revenue streams and network optimization. The OSP segment offers optical products for anti-counterfeiting, government, industrial, automotive, and consumer electronic markets, including 3D sensing applications. The company was formerly known as JDS Uniphase Corporation and changed its name to Viavi Solutions Inc. in August 2015. Viavi Solutions Inc. was founded in 1923 and is headquartered in San Jose, California."
VIAV,2019-06-29,187000000,39300000,NA,5400000,349400000,686300000,77400000,77400000,-34300000,31500000,1130300000,1052900000,444000000,-38100000,-2400000,7800000,5400000,NA,income_statement,Communication Equipment,Viavi Solutions Inc.,"Viavi Solutions Inc. provides network test, monitoring, and assurance solutions to communications service providers, enterprises, network equipment manufacturers, government, civil, military, and avionics customers worldwide. The company operates through three segments: Network Enablement (NE), Service Enablement (SE), and Optical Security and Performance Products (OSP) segments. The NE segment offers testing solutions that access the network to perform build-out and maintenance tasks. This segment provides solutions that include instruments, software, and services to design, build, activate, certify, troubleshoot, and optimize networks; and instrumentation for communication and safety. It also offers support and professional services, such as repair, calibration, software support, and technical assistance for the products; and system integration projects, including project management, installation, and implementation, as well as product and technology training, and consulting services. The SE segment provides embedded systems and enterprise performance management solutions for communication service providers, enterprises, and cloud operators with visibility into network, service, and application data. Its solutions include instruments, microprobes, and software, which monitor, collect, and analyze network data to reveal the actual customer experience and to identify opportunities for new revenue streams and network optimization. The OSP segment offers optical products for anti-counterfeiting, government, industrial, automotive, and consumer electronic markets, including 3D sensing applications. The company was formerly known as JDS Uniphase Corporation and changed its name to Viavi Solutions Inc. in August 2015. Viavi Solutions Inc. was founded in 1923 and is headquartered in San Jose, California."
VIAV,2020-06-27,193600000,94000000,NA,28700000,346500000,699900000,92000000,92000000,-33700000,65300000,1136300000,1044300000,436400000,2000000,NA,28700000,28700000,NA,income_statement,Communication Equipment,Viavi Solutions Inc.,"Viavi Solutions Inc. provides network test, monitoring, and assurance solutions to communications service providers, enterprises, network equipment manufacturers, government, civil, military, and avionics customers worldwide. The company operates through three segments: Network Enablement (NE), Service Enablement (SE), and Optical Security and Performance Products (OSP) segments. The NE segment offers testing solutions that access the network to perform build-out and maintenance tasks. This segment provides solutions that include instruments, software, and services to design, build, activate, certify, troubleshoot, and optimize networks; and instrumentation for communication and safety. It also offers support and professional services, such as repair, calibration, software support, and technical assistance for the products; and system integration projects, including project management, installation, and implementation, as well as product and technology training, and consulting services. The SE segment provides embedded systems and enterprise performance management solutions for communication service providers, enterprises, and cloud operators with visibility into network, service, and application data. Its solutions include instruments, microprobes, and software, which monitor, collect, and analyze network data to reveal the actual customer experience and to identify opportunities for new revenue streams and network optimization. The OSP segment offers optical products for anti-counterfeiting, government, industrial, automotive, and consumer electronic markets, including 3D sensing applications. The company was formerly known as JDS Uniphase Corporation and changed its name to Viavi Solutions Inc. in August 2015. Viavi Solutions Inc. was founded in 1923 and is headquartered in San Jose, California."
VICR,2016-12-31,41848000,-6030000,208000,-6247000,55675000,91209000,-6314000,-6314000,NA,231000,200280000,206594000,109071000,284000,NA,-6261000,-6247000,NA,income_statement,Electronic Components,Vicor Corporation,"Vicor Corporation designs, develops, manufactures, and markets modular power components and power systems for converting electrical power in the United States, Europe, the Asia Pacific, and internationally. The company offers a range of brick-format DC-DC converters; complementary components; and input and output voltage, and output power products, as well as electrical and mechanical accessories. It also provides custom power systems solutions. The company serves independent manufacturers of electronic devices, original equipment manufacturers, and their contract manufacturers in the aerospace and aviation, defense electronics, industrial automation and equipment, instrumentation, test equipment, solid state lighting, telecommunications and networking infrastructure, and vehicles and transportation markets. Vicor Corporation was founded in 1981 and is headquartered in Andover, Massachusetts."
VICR,2017-12-31,44924000,-98000,305000,167000,58092000,101656000,-1360000,-1360000,NA,-356000,227830000,229190000,126174000,1262000,NA,258000,167000,NA,income_statement,Electronic Components,Vicor Corporation,"Vicor Corporation designs, develops, manufactures, and markets modular power components and power systems for converting electrical power in the United States, Europe, the Asia Pacific, and internationally. The company offers a range of brick-format DC-DC converters; complementary components; and input and output voltage, and output power products, as well as electrical and mechanical accessories. It also provides custom power systems solutions. The company serves independent manufacturers of electronic devices, original equipment manufacturers, and their contract manufacturers in the aerospace and aviation, defense electronics, industrial automation and equipment, instrumentation, test equipment, solid state lighting, telecommunications and networking infrastructure, and vehicles and transportation markets. Vicor Corporation was founded in 1981 and is headquartered in Andover, Massachusetts."
VICR,2018-12-31,44286000,32933000,434000,31725000,62224000,138971000,32461000,32461000,NA,1087000,291220000,258759000,152249000,472000,NA,31846000,31725000,NA,income_statement,Electronic Components,Vicor Corporation,"Vicor Corporation designs, develops, manufactures, and markets modular power components and power systems for converting electrical power in the United States, Europe, the Asia Pacific, and internationally. The company offers a range of brick-format DC-DC converters; complementary components; and input and output voltage, and output power products, as well as electrical and mechanical accessories. It also provides custom power systems solutions. The company serves independent manufacturers of electronic devices, original equipment manufacturers, and their contract manufacturers in the aerospace and aviation, defense electronics, industrial automation and equipment, instrumentation, test equipment, solid state lighting, telecommunications and networking infrastructure, and vehicles and transportation markets. Vicor Corporation was founded in 1981 and is headquartered in Andover, Massachusetts."
VICR,2019-12-31,46588000,14887000,308000,14098000,62277000,122966000,14101000,14101000,NA,778000,262977000,248876000,140011000,786000,NA,14109000,14098000,NA,income_statement,Electronic Components,Vicor Corporation,"Vicor Corporation designs, develops, manufactures, and markets modular power components and power systems for converting electrical power in the United States, Europe, the Asia Pacific, and internationally. The company offers a range of brick-format DC-DC converters; complementary components; and input and output voltage, and output power products, as well as electrical and mechanical accessories. It also provides custom power systems solutions. The company serves independent manufacturers of electronic devices, original equipment manufacturers, and their contract manufacturers in the aerospace and aviation, defense electronics, industrial automation and equipment, instrumentation, test equipment, solid state lighting, telecommunications and networking infrastructure, and vehicles and transportation markets. Vicor Corporation was founded in 1981 and is headquartered in Andover, Massachusetts."
VIE,2018-12-31,42414000,-190270000,NA,-190270000,6565000,0,-48979000,-48979000,NA,0,0,48979000,0,-141291000,NA,-190270000,-190270000,NA,income_statement,Biotechnology,"Viela Bio, Inc.","Viela Bio, Inc., a clinical-stage biotechnology company, engages in the research and development of treatments for severe inflammation and autoimmune diseases in the United States. The company's lead product candidate is inebilizumab, a humanized monoclonal antibody for neuromyelitis optica spectrum disorder, kidney transplant desensitization, myasthenia gravis, and IgG4-related diseases. It is also developing VIB4920 for kidney transplantation rejection and sjÃ¶gren's syndrome; and VIB7734 for cutaneous lupus erythematosus. Viela Bio, Inc. has a strategic collaboration with Mitsubishi Tanabe Pharma Corporation to develop and commercialize inebilizumab for autoimmune diseases in Japan, Thailand, South Korea, Indonesia, Vietnam, Malaysia, the Philippines, Singapore, and Taiwan. The company was founded in 2017 and is headquartered in Gaithersburg, Maryland."
VIE,2019-12-31,104641000,-86429000,NA,-86429000,35050000,50000000,-89691000,-89691000,NA,0,50000000,139691000,0,3262000,NA,-86429000,-86429000,NA,income_statement,Biotechnology,"Viela Bio, Inc.","Viela Bio, Inc., a clinical-stage biotechnology company, engages in the research and development of treatments for severe inflammation and autoimmune diseases in the United States. The company's lead product candidate is inebilizumab, a humanized monoclonal antibody for neuromyelitis optica spectrum disorder, kidney transplant desensitization, myasthenia gravis, and IgG4-related diseases. It is also developing VIB4920 for kidney transplantation rejection and sjÃ¶gren's syndrome; and VIB7734 for cutaneous lupus erythematosus. Viela Bio, Inc. has a strategic collaboration with Mitsubishi Tanabe Pharma Corporation to develop and commercialize inebilizumab for autoimmune diseases in Japan, Thailand, South Korea, Indonesia, Vietnam, Malaysia, the Philippines, Singapore, and Taiwan. The company was founded in 2017 and is headquartered in Gaithersburg, Maryland."
VINO,2016-12-31,NA,-7799863,26364,-10042141,6261642,-234376,-6560871,-6560871,-207913,0,1526075,8086946,1760451,-1238992,-2242278,-7799863,-10042141,NA,income_statement,NA,NA,NA
VINO,2017-12-31,NA,-7806761,26364,-7912512,7362727,-129598,-7685390,-7685390,-320571,0,1817302,9502692,1946900,-121371,-105751,-7806761,-8257591,NA,income_statement,NA,NA,NA
VINO,2018-12-31,NA,-5678418,26364,-5678418,6740944,1657912,-5254781,-5254781,-611297,0,3099608,8354389,1441696,-423637,NA,-5678418,-6402526,NA,income_statement,NA,NA,NA
VINO,2019-12-31,NA,-6956815,26364,-6663808,6911302,244098,-6863642,-6863642,-360413,0,1284437,8148079,1040339,-93173,NA,-6956815,-7384865,NA,income_statement,NA,NA,NA
VIOT,2016-12-31,29926000,14012000,2992000,16259000,35315000,80030000,14308000,14308000,-296000,-2247000,312574000,298266000,232544000,-296000,NA,16259000,-3453000,481000,income_statement,Consumer Electronics,"Viomi Technology Co., Ltd","Viomi Technology Co., Ltd, through its subsidiaries, develops and sells Internet-of-things-enabled (IoT-enabled) smart home products in the People's Republic of China. The company offers IoT-enabled smart home products, including smart water purification systems; smart kitchen products, such as refrigerators, oven steamers, dishwashers, range hoods, and gas stoves; and other smart products comprising air conditioning systems, washing machines, water heaters, smart water kettles, sweeper robots, smart locks, and other smart devices. It also provides a suite of complementary consumable products; and value-added services. The company sells its products directly to consumers through its official Website, Viomi Store mobile app, and e-commerce channels, including Youpin, JD.com, Tmall, and Suning, as well as offline experience stores. It has a strategic partnership with Xiaomi Corporation. Viomi Technology Co., Ltd was founded in 2014 and is headquartered in Guangzhou, China."
VIOT,2017-12-31,60749000,107958000,2992000,93240000,111114000,275183000,105556000,105556000,NA,14718000,873219000,767663000,598036000,2402000,NA,93240000,8033000,-2236000,income_statement,Consumer Electronics,"Viomi Technology Co., Ltd","Viomi Technology Co., Ltd, through its subsidiaries, develops and sells Internet-of-things-enabled (IoT-enabled) smart home products in the People's Republic of China. The company offers IoT-enabled smart home products, including smart water purification systems; smart kitchen products, such as refrigerators, oven steamers, dishwashers, range hoods, and gas stoves; and other smart products comprising air conditioning systems, washing machines, water heaters, smart water kettles, sweeper robots, smart locks, and other smart devices. It also provides a suite of complementary consumable products; and value-added services. The company sells its products directly to consumers through its official Website, Viomi Store mobile app, and e-commerce channels, including Youpin, JD.com, Tmall, and Suning, as well as offline experience stores. It has a strategic partnership with Xiaomi Corporation. Viomi Technology Co., Ltd was founded in 2014 and is headquartered in Guangzhou, China."
VIOT,2018-12-31,124230000,89411000,2992000,65358000,424918000,717797000,170478000,170478000,NA,24061000,2561229000,2390751000,1843432000,-81067000,NA,65350000,50544000,-1829000,income_statement,Consumer Electronics,"Viomi Technology Co., Ltd","Viomi Technology Co., Ltd, through its subsidiaries, develops and sells Internet-of-things-enabled (IoT-enabled) smart home products in the People's Republic of China. The company offers IoT-enabled smart home products, including smart water purification systems; smart kitchen products, such as refrigerators, oven steamers, dishwashers, range hoods, and gas stoves; and other smart products comprising air conditioning systems, washing machines, water heaters, smart water kettles, sweeper robots, smart locks, and other smart devices. It also provides a suite of complementary consumable products; and value-added services. The company sells its products directly to consumers through its official Website, Viomi Store mobile app, and e-commerce channels, including Youpin, JD.com, Tmall, and Suning, as well as offline experience stores. It has a strategic partnership with Xiaomi Corporation. Viomi Technology Co., Ltd was founded in 2014 and is headquartered in Guangzhou, China."
VIOT,2019-12-31,204942000,339020000,5652000,292170000,602273000,1082404000,311069000,311069000,NA,45190000,4647513000,4336444000,3565109000,27951000,NA,293830000,292170000,-35880000,income_statement,Consumer Electronics,"Viomi Technology Co., Ltd","Viomi Technology Co., Ltd, through its subsidiaries, develops and sells Internet-of-things-enabled (IoT-enabled) smart home products in the People's Republic of China. The company offers IoT-enabled smart home products, including smart water purification systems; smart kitchen products, such as refrigerators, oven steamers, dishwashers, range hoods, and gas stoves; and other smart products comprising air conditioning systems, washing machines, water heaters, smart water kettles, sweeper robots, smart locks, and other smart devices. It also provides a suite of complementary consumable products; and value-added services. The company sells its products directly to consumers through its official Website, Viomi Store mobile app, and e-commerce channels, including Youpin, JD.com, Tmall, and Suning, as well as offline experience stores. It has a strategic partnership with Xiaomi Corporation. Viomi Technology Co., Ltd was founded in 2014 and is headquartered in Guangzhou, China."
VIR,2017-12-31,NA,-80776000,NA,-69852000,21693000,-59804000,-81497000,-81497000,NA,-10924000,2708000,84205000,62512000,721000,NA,-69852000,-69852000,NA,income_statement,Biotechnology,"Vir Biotechnology, Inc.","Vir Biotechnology, Inc., a clinical-stage immunology company, develops therapeutic products to treat and prevent serious infectious diseases. It develops VIR-2218 and VIR-3434 for the treatment of hepatitis B virus; VIR-2482 for the prevention of influenza A virus; VIR-1111 for the prevention of human immunodeficiency virus; and VIR-2020 for the prevention of tuberculosis. The company has grant agreements with Bill & Melinda Gates Foundation and National Institutes of Health; an option and license agreement with Brii Biosciences Limited and Brii Biosciences Offshore Limited; a collaboration and license agreement with Alnylam Pharmaceuticals, Inc.; a collaboration, license, and option agreement with Visterra, Inc.; license agreements with The Rockefeller University and MedImmune, Inc.; a collaboration with WuXi Biologics; and a collaborative research agreement with Generation Bio., as well as GlaxoSmithKline Intellectual Property Development Limited, GlaxoSmithKline Biologicals SA., and Alnylam Pharmaceuticals, Inc. It also has a manufacturing agreement with Samsung Biologics Co.,Ltd. for the manufacture of SARS-COV-2 antibodies for potential COVID-19 treatment; and clinical collaboration with Gilead Sciences, Inc. for chronic hepatitis B virus. Vir Biotechnology, Inc. was founded in 2016 and is headquartered in San Francisco, California."
VIR,2018-12-31,NA,-116364000,NA,-115884000,28231000,-89561000,-117792000,-117792000,NA,-480000,10668000,128460000,100229000,1428000,NA,-115884000,-115884000,NA,income_statement,Biotechnology,"Vir Biotechnology, Inc.","Vir Biotechnology, Inc., a clinical-stage immunology company, develops therapeutic products to treat and prevent serious infectious diseases. It develops VIR-2218 and VIR-3434 for the treatment of hepatitis B virus; VIR-2482 for the prevention of influenza A virus; VIR-1111 for the prevention of human immunodeficiency virus; and VIR-2020 for the prevention of tuberculosis. The company has grant agreements with Bill & Melinda Gates Foundation and National Institutes of Health; an option and license agreement with Brii Biosciences Limited and Brii Biosciences Offshore Limited; a collaboration and license agreement with Alnylam Pharmaceuticals, Inc.; a collaboration, license, and option agreement with Visterra, Inc.; license agreements with The Rockefeller University and MedImmune, Inc.; a collaboration with WuXi Biologics; and a collaborative research agreement with Generation Bio., as well as GlaxoSmithKline Intellectual Property Development Limited, GlaxoSmithKline Biologicals SA., and Alnylam Pharmaceuticals, Inc. It also has a manufacturing agreement with Samsung Biologics Co.,Ltd. for the manufacture of SARS-COV-2 antibodies for potential COVID-19 treatment; and clinical collaboration with Gilead Sciences, Inc. for chronic hepatitis B virus. Vir Biotechnology, Inc. was founded in 2016 and is headquartered in San Francisco, California."
VIR,2019-12-31,NA,-174529000,NA,-174683000,37598000,-134981000,-172579000,-172579000,NA,154000,8091000,180670000,143072000,-1950000,NA,-174683000,-174683000,NA,income_statement,Biotechnology,"Vir Biotechnology, Inc.","Vir Biotechnology, Inc., a clinical-stage immunology company, develops therapeutic products to treat and prevent serious infectious diseases. It develops VIR-2218 and VIR-3434 for the treatment of hepatitis B virus; VIR-2482 for the prevention of influenza A virus; VIR-1111 for the prevention of human immunodeficiency virus; and VIR-2020 for the prevention of tuberculosis. The company has grant agreements with Bill & Melinda Gates Foundation and National Institutes of Health; an option and license agreement with Brii Biosciences Limited and Brii Biosciences Offshore Limited; a collaboration and license agreement with Alnylam Pharmaceuticals, Inc.; a collaboration, license, and option agreement with Visterra, Inc.; license agreements with The Rockefeller University and MedImmune, Inc.; a collaboration with WuXi Biologics; and a collaborative research agreement with Generation Bio., as well as GlaxoSmithKline Intellectual Property Development Limited, GlaxoSmithKline Biologicals SA., and Alnylam Pharmaceuticals, Inc. It also has a manufacturing agreement with Samsung Biologics Co.,Ltd. for the manufacture of SARS-COV-2 antibodies for potential COVID-19 treatment; and clinical collaboration with Gilead Sciences, Inc. for chronic hepatitis B virus. Vir Biotechnology, Inc. was founded in 2016 and is headquartered in San Francisco, California."
VIRC,2017-01-31,NA,4727000,NA,22760000,56601000,62543000,5942000,5942000,-1217000,-18033000,173417000,167475000,110874000,-1215000,NA,22760000,22760000,NA,income_statement,"Furnishings, Fixtures & Appliances",Virco Manufacturing Corporation,"Virco Mfg. Corporation engages in the design, production, and distribution of furniture for the commercial and education markets in the United States. It offers seating products, including 4-leg chairs, cantilever chairs, tablet arm chairs with work surfaces and compact footprints, steel-frame rockers, stools, classroom chairs, stack and folding chairs, hard plastic seating, upholstered stack and ergonomic chairs, and plastic stack chairs. The company also provides folding, activity, office, computer, and mobile tables; and computer furniture, such as keyboard mouse trays, CPU holders, support columns, desks and workstations, specialty tables, instructor media stations and towers, and other products. In addition, it offers chair desks, combo units, and tablet arm and caster units, as well as a returns and credenzas. Additionally, the company provides administrative office furniture, including desks, returns, bookcases, storage cabinets, and other items, as well as wardrobe tower cabinets, file credenzas, and mobile pedestals; laboratory furniture comprising steel-based science tables, table bases, lab stools, and wood-frame science tables; mobile furniture, including mobile tables for cafeterias, mobile cabinets, and mobile chairs for school settings and offices; and handling and storage equipment, as well as manufactures stackable storage trucks. It serves educational institutions, convention centers and arenas, hospitality providers, government facilities, and places of worship through its sales and support teams, and dealer network. Virco Mfg. Corporation was founded in 1950 and is headquartered in Torrance, California."
VIRC,2018-01-31,NA,2414000,NA,-3209000,61528000,65471000,3943000,3943000,-1545000,5623000,189287000,185344000,123816000,-1529000,NA,-3209000,-3209000,NA,income_statement,"Furnishings, Fixtures & Appliances",Virco Manufacturing Corporation,"Virco Mfg. Corporation engages in the design, production, and distribution of furniture for the commercial and education markets in the United States. It offers seating products, including 4-leg chairs, cantilever chairs, tablet arm chairs with work surfaces and compact footprints, steel-frame rockers, stools, classroom chairs, stack and folding chairs, hard plastic seating, upholstered stack and ergonomic chairs, and plastic stack chairs. The company also provides folding, activity, office, computer, and mobile tables; and computer furniture, such as keyboard mouse trays, CPU holders, support columns, desks and workstations, specialty tables, instructor media stations and towers, and other products. In addition, it offers chair desks, combo units, and tablet arm and caster units, as well as a returns and credenzas. Additionally, the company provides administrative office furniture, including desks, returns, bookcases, storage cabinets, and other items, as well as wardrobe tower cabinets, file credenzas, and mobile pedestals; laboratory furniture comprising steel-based science tables, table bases, lab stools, and wood-frame science tables; mobile furniture, including mobile tables for cafeterias, mobile cabinets, and mobile chairs for school settings and offices; and handling and storage equipment, as well as manufactures stackable storage trucks. It serves educational institutions, convention centers and arenas, hospitality providers, government facilities, and places of worship through its sales and support teams, and dealer network. Virco Mfg. Corporation was founded in 1950 and is headquartered in Torrance, California."
VIRC,2019-01-31,NA,-1117000,NA,-1614000,66008000,67081000,1073000,1073000,-2191000,497000,200716000,199643000,133635000,-2190000,NA,-1614000,-1614000,NA,income_statement,"Furnishings, Fixtures & Appliances",Virco Manufacturing Corporation,"Virco Mfg. Corporation engages in the design, production, and distribution of furniture for the commercial and education markets in the United States. It offers seating products, including 4-leg chairs, cantilever chairs, tablet arm chairs with work surfaces and compact footprints, steel-frame rockers, stools, classroom chairs, stack and folding chairs, hard plastic seating, upholstered stack and ergonomic chairs, and plastic stack chairs. The company also provides folding, activity, office, computer, and mobile tables; and computer furniture, such as keyboard mouse trays, CPU holders, support columns, desks and workstations, specialty tables, instructor media stations and towers, and other products. In addition, it offers chair desks, combo units, and tablet arm and caster units, as well as a returns and credenzas. Additionally, the company provides administrative office furniture, including desks, returns, bookcases, storage cabinets, and other items, as well as wardrobe tower cabinets, file credenzas, and mobile pedestals; laboratory furniture comprising steel-based science tables, table bases, lab stools, and wood-frame science tables; mobile furniture, including mobile tables for cafeterias, mobile cabinets, and mobile chairs for school settings and offices; and handling and storage equipment, as well as manufactures stackable storage trucks. It serves educational institutions, convention centers and arenas, hospitality providers, government facilities, and places of worship through its sales and support teams, and dealer network. Virco Mfg. Corporation was founded in 1950 and is headquartered in Torrance, California."
VIRC,2020-01-31,NA,2727000,NA,2382000,66452000,71675000,5223000,5223000,-2462000,345000,191063000,185840000,119388000,-2496000,NA,2382000,2382000,NA,income_statement,"Furnishings, Fixtures & Appliances",Virco Manufacturing Corporation,"Virco Mfg. Corporation engages in the design, production, and distribution of furniture for the commercial and education markets in the United States. It offers seating products, including 4-leg chairs, cantilever chairs, tablet arm chairs with work surfaces and compact footprints, steel-frame rockers, stools, classroom chairs, stack and folding chairs, hard plastic seating, upholstered stack and ergonomic chairs, and plastic stack chairs. The company also provides folding, activity, office, computer, and mobile tables; and computer furniture, such as keyboard mouse trays, CPU holders, support columns, desks and workstations, specialty tables, instructor media stations and towers, and other products. In addition, it offers chair desks, combo units, and tablet arm and caster units, as well as a returns and credenzas. Additionally, the company provides administrative office furniture, including desks, returns, bookcases, storage cabinets, and other items, as well as wardrobe tower cabinets, file credenzas, and mobile pedestals; laboratory furniture comprising steel-based science tables, table bases, lab stools, and wood-frame science tables; mobile furniture, including mobile tables for cafeterias, mobile cabinets, and mobile chairs for school settings and offices; and handling and storage equipment, as well as manufactures stackable storage trucks. It serves educational institutions, convention centers and arenas, hospitality providers, government facilities, and places of worship through its sales and support teams, and dealer network. Virco Mfg. Corporation was founded in 1950 and is headquartered in Torrance, California."
VIRI,2018-12-31,854109,-2113592,NA,-2113592,1107386,0,-1961495,-1961495,-152103,0,0,1961495,0,-152097,NA,-2113592,-2113592,NA,income_statement,Biotechnology,"Virios Therapeutics, Inc.","Virios Therapeutics, LLC, a development-stage biotechnology company, focuses on developing antiviral therapies to treat diseases associated with a viral triggered abnormal immune response. Its lead development candidate is the IMC-1, a fixed dose combination of famciclovir and celecoxib to treat fibromyalgia. The company was formerly known as Innovative Med Concepts, LLC and changed its name to Virios Therapeutics, LLC in July 2020. Virios Therapeutics, LLC was founded in 2012 and is headquartered in Alpharetta, Georgia."
VIRI,2019-12-31,836175,-2473627,NA,-2473627,1342324,0,-2178499,-2178499,-295128,0,0,2178499,0,-295128,NA,-2473627,-2473627,NA,income_statement,Biotechnology,"Virios Therapeutics, Inc.","Virios Therapeutics, LLC, a development-stage biotechnology company, focuses on developing antiviral therapies to treat diseases associated with a viral triggered abnormal immune response. Its lead development candidate is the IMC-1, a fixed dose combination of famciclovir and celecoxib to treat fibromyalgia. The company was formerly known as Innovative Med Concepts, LLC and changed its name to Virios Therapeutics, LLC in July 2020. Virios Therapeutics, LLC was founded in 2012 and is headquartered in Alpharetta, Georgia."
VIRT,2017-12-31,NA,113164000,321009000,2939000,139528000,288095000,0,85021000,NA,94266000,766377000,681356000,478282000,28143000,NA,18898000,1613000,NA,income_statement,Capital Markets,"Virtu Financial, Inc.","Virtu Financial, Inc., financial services company, provides execution services and data, analytics, and connectivity products to clients worldwide. Its product suite includes offerings in execution, liquidity sourcing, analytics and broker-neutral, and multi-dealer platforms in workflow technology. The company's solutions enable clients to trade on various venues across countries and in multiple asset classes, including global equities, ETFs, foreign exchange, futures, fixed income, and other commodities. Its analytics platform provides a range of pre- and post-trade services, data products, and compliance for clients to invest, trade, and manage risk across markets. Virtu Financial, Inc. was founded in 2008 and is headquartered in New York, New York."
VIRT,2018-12-31,NA,696363000,442803000,289441000,207569000,693875000,0,399005000,NA,76171000,1313188000,914183000,619313000,297358000,NA,620192000,284023000,NA,income_statement,Capital Markets,"Virtu Financial, Inc.","Virtu Financial, Inc., financial services company, provides execution services and data, analytics, and connectivity products to clients worldwide. Its product suite includes offerings in execution, liquidity sourcing, analytics and broker-neutral, and multi-dealer platforms in workflow technology. The company's solutions enable clients to trade on various venues across countries and in multiple asset classes, including global equities, ETFs, foreign exchange, futures, fixed income, and other commodities. Its analytics platform provides a range of pre- and post-trade services, data products, and compliance for clients to invest, trade, and manage risk across markets. Virtu Financial, Inc. was founded in 2008 and is headquartered in New York, New York."
VIRT,2019-12-31,NA,-115982000,297562000,-58595000,280945000,495071000,0,77887000,NA,-12277000,1207584000,1129697000,712513000,-193869000,NA,-103705000,-60521000,NA,income_statement,Capital Markets,"Virtu Financial, Inc.","Virtu Financial, Inc., financial services company, provides execution services and data, analytics, and connectivity products to clients worldwide. Its product suite includes offerings in execution, liquidity sourcing, analytics and broker-neutral, and multi-dealer platforms in workflow technology. The company's solutions enable clients to trade on various venues across countries and in multiple asset classes, including global equities, ETFs, foreign exchange, futures, fixed income, and other commodities. Its analytics platform provides a range of pre- and post-trade services, data products, and compliance for clients to invest, trade, and manage risk across markets. Virtu Financial, Inc. was founded in 2008 and is headquartered in New York, New York."
VIRT,2020-12-31,NA,1382837000,NA,649197000,396477000,1846463000,0,1308991000,NA,261924000,2913614000,1604623000,1067151000,73846000,NA,1120913000,649197000,NA,income_statement,Capital Markets,"Virtu Financial, Inc.","Virtu Financial, Inc., financial services company, provides execution services and data, analytics, and connectivity products to clients worldwide. Its product suite includes offerings in execution, liquidity sourcing, analytics and broker-neutral, and multi-dealer platforms in workflow technology. The company's solutions enable clients to trade on various venues across countries and in multiple asset classes, including global equities, ETFs, foreign exchange, futures, fixed income, and other commodities. Its analytics platform provides a range of pre- and post-trade services, data products, and compliance for clients to invest, trade, and manage risk across markets. Virtu Financial, Inc. was founded in 2008 and is headquartered in New York, New York."
VISL,2016-12-31,6106000,-20902000,NA,-20902000,9534000,1024000,-20177000,-20177000,-925000,0,6574000,26751000,5550000,-725000,NA,-20902000,-22710000,NA,income_statement,Communication Equipment,"Vislink Technologies, Inc.","Vislink Technologies, Inc. designs, develops, and delivers wireless communications solutions in North and South America, Europe, Asia, and internationally. It develops, manufactures, and sells microwave communications equipment and video transmission products under the Nucomm, RF Central, and IMT brand names for broadcast, sports and entertainment, and government/surveillance markets. The company also offers satellite communication, cellular, and wireless camera systems and associated amplifier items, as well as microwave radio components under the Vislink brand to broadcasters, network owners and station groups, sports and live broadcasters, hosted service providers, and defense agencies and organizations, as well as metropolitan, regional, and national law enforcement agenciesIts products portfolio consists of HCAM, an on-camera wireless video transmitter; HDX-1100, an aircraft downlink transmitter; ViewBack, a dual channel diversity receiver-decoder; SatWare, an embedded computing and routing system; and AirPro-75, an IP satellite data terminal, as well as various types of receivers. The company was formerly known as xG Technology, Inc. and changed its name to Vislink Technologies, Inc. in February 2019. Vislink Technologies, Inc. was founded in 2002 and is headquartered in Sarasota, Florida."
VISL,2017-12-31,9799000,-10353000,NA,-10353000,27015000,17823000,-23389000,-23389000,-629000,0,47824000,71213000,30001000,13036000,NA,-10353000,-10353000,NA,income_statement,Communication Equipment,"Vislink Technologies, Inc.","Vislink Technologies, Inc. designs, develops, and delivers wireless communications solutions in North and South America, Europe, Asia, and internationally. It develops, manufactures, and sells microwave communications equipment and video transmission products under the Nucomm, RF Central, and IMT brand names for broadcast, sports and entertainment, and government/surveillance markets. The company also offers satellite communication, cellular, and wireless camera systems and associated amplifier items, as well as microwave radio components under the Vislink brand to broadcasters, network owners and station groups, sports and live broadcasters, hosted service providers, and defense agencies and organizations, as well as metropolitan, regional, and national law enforcement agenciesIts products portfolio consists of HCAM, an on-camera wireless video transmitter; HDX-1100, an aircraft downlink transmitter; ViewBack, a dual channel diversity receiver-decoder; SatWare, an embedded computing and routing system; and AirPro-75, an IP satellite data terminal, as well as various types of receivers. The company was formerly known as xG Technology, Inc. and changed its name to Vislink Technologies, Inc. in February 2019. Vislink Technologies, Inc. was founded in 2002 and is headquartered in Sarasota, Florida."
VISL,2018-12-31,7873000,-14873000,NA,-14873000,21817000,18629000,-14014000,-14014000,-2718000,0,38294000,52308000,19665000,-859000,NA,-14873000,-14873000,NA,income_statement,Communication Equipment,"Vislink Technologies, Inc.","Vislink Technologies, Inc. designs, develops, and delivers wireless communications solutions in North and South America, Europe, Asia, and internationally. It develops, manufactures, and sells microwave communications equipment and video transmission products under the Nucomm, RF Central, and IMT brand names for broadcast, sports and entertainment, and government/surveillance markets. The company also offers satellite communication, cellular, and wireless camera systems and associated amplifier items, as well as microwave radio components under the Vislink brand to broadcasters, network owners and station groups, sports and live broadcasters, hosted service providers, and defense agencies and organizations, as well as metropolitan, regional, and national law enforcement agenciesIts products portfolio consists of HCAM, an on-camera wireless video transmitter; HDX-1100, an aircraft downlink transmitter; ViewBack, a dual channel diversity receiver-decoder; SatWare, an embedded computing and routing system; and AirPro-75, an IP satellite data terminal, as well as various types of receivers. The company was formerly known as xG Technology, Inc. and changed its name to Vislink Technologies, Inc. in February 2019. Vislink Technologies, Inc. was founded in 2002 and is headquartered in Sarasota, Florida."
VISL,2019-12-31,3232000,-18047000,NA,-18047000,20099000,8496000,-17200000,-17200000,-1878000,0,28942000,46142000,20446000,-847000,NA,-18047000,-18047000,NA,income_statement,Communication Equipment,"Vislink Technologies, Inc.","Vislink Technologies, Inc. designs, develops, and delivers wireless communications solutions in North and South America, Europe, Asia, and internationally. It develops, manufactures, and sells microwave communications equipment and video transmission products under the Nucomm, RF Central, and IMT brand names for broadcast, sports and entertainment, and government/surveillance markets. The company also offers satellite communication, cellular, and wireless camera systems and associated amplifier items, as well as microwave radio components under the Vislink brand to broadcasters, network owners and station groups, sports and live broadcasters, hosted service providers, and defense agencies and organizations, as well as metropolitan, regional, and national law enforcement agenciesIts products portfolio consists of HCAM, an on-camera wireless video transmitter; HDX-1100, an aircraft downlink transmitter; ViewBack, a dual channel diversity receiver-decoder; SatWare, an embedded computing and routing system; and AirPro-75, an IP satellite data terminal, as well as various types of receivers. The company was formerly known as xG Technology, Inc. and changed its name to Vislink Technologies, Inc. in February 2019. Vislink Technologies, Inc. was founded in 2002 and is headquartered in Sarasota, Florida."
VITL,2017-12-31,NA,-2112000,-673000,-1920000,19867000,18388000,-1479000,-1479000,-524000,33000,74000000,75479000,55612000,-633000,NA,-2145000,-1920000,NA,income_statement,Farm Products,"Vital Farms, Inc.","Vital Farms, Inc., an ethical food company, provides pasture-raised products in the United States. It offers shell eggs, butter, hard-boiled eggs, ghee, liquid whole eggs, and egg bite products. The company was founded in 2007 and is headquartered in Austin, Texas."
VITL,2018-12-30,NA,6352000,-673000,5797000,27960000,34819000,6859000,6859000,-424000,723000,106713000,99854000,71894000,-507000,NA,5629000,5797000,NA,income_statement,Farm Products,"Vital Farms, Inc.","Vital Farms, Inc., an ethical food company, provides pasture-raised products in the United States. It offers shell eggs, butter, hard-boiled eggs, ghee, liquid whole eggs, and egg bite products. The company was founded in 2007 and is headquartered in Austin, Texas."
VITL,2019-12-29,NA,4418000,254000,2385000,39457000,42877000,3420000,3420000,-349000,1106000,140733000,137313000,97856000,998000,NA,3312000,2385000,NA,income_statement,Farm Products,"Vital Farms, Inc.","Vital Farms, Inc., an ethical food company, provides pasture-raised products in the United States. It offers shell eggs, butter, hard-boiled eggs, ghee, liquid whole eggs, and egg bite products. The company was founded in 2007 and is headquartered in Austin, Texas."
VIVE,2016-12-31,8129000,-20111000,NA,-20111000,13104000,2529000,-18704000,-18704000,-1370000,0,7141000,25845000,4612000,-1407000,NA,-20111000,-20111000,NA,income_statement,Medical Devices,"Viveve Medical, Inc.","Viveve Medical, Inc., together with its subsidiaries, designs, develops, manufactures, and markets medical devices for the non-invasive treatment of vaginal introital laxity, sexual function, vaginal rejuvenation, and stress urinary incontinence. The company offers Viveve System comprises of the radiofrequency generator, reusable handpiece, and treatment tip, as well as cryogen canister and other consumable components. It markets its products through sales employees and distributors in the United States, Canada, the Asia Pacific, Europe, the Middle East, Latin America, Canada, and internationally. Viveve Medical, Inc. was founded in 2005 and is headquartered in Englewood, Colorado."
VIVE,2017-12-31,11901000,-36959000,NA,-36959000,29273000,7444000,-33730000,-33730000,-3169000,0,15288000,49018000,7844000,-3229000,NA,-36959000,-36959000,NA,income_statement,Medical Devices,"Viveve Medical, Inc.","Viveve Medical, Inc., together with its subsidiaries, designs, develops, manufactures, and markets medical devices for the non-invasive treatment of vaginal introital laxity, sexual function, vaginal rejuvenation, and stress urinary incontinence. The company offers Viveve System comprises of the radiofrequency generator, reusable handpiece, and treatment tip, as well as cryogen canister and other consumable components. It markets its products through sales employees and distributors in the United States, Canada, the Asia Pacific, Europe, the Middle East, Latin America, Canada, and internationally. Viveve Medical, Inc. was founded in 2005 and is headquartered in Englewood, Colorado."
VIVE,2018-12-31,13258000,-49324000,NA,-49981000,39027000,7320000,-44965000,-44965000,-4372000,0,18517000,63482000,11197000,-4359000,NA,-49324000,-49981000,NA,income_statement,Medical Devices,"Viveve Medical, Inc.","Viveve Medical, Inc., together with its subsidiaries, designs, develops, manufactures, and markets medical devices for the non-invasive treatment of vaginal introital laxity, sexual function, vaginal rejuvenation, and stress urinary incontinence. The company offers Viveve System comprises of the radiofrequency generator, reusable handpiece, and treatment tip, as well as cryogen canister and other consumable components. It markets its products through sales employees and distributors in the United States, Canada, the Asia Pacific, Europe, the Middle East, Latin America, Canada, and internationally. Viveve Medical, Inc. was founded in 2005 and is headquartered in Englewood, Colorado."
VIVE,2019-12-31,8289000,-41899000,NA,-42526000,22664000,1016000,-29937000,-29937000,-4354000,0,6567000,36504000,5551000,-11962000,NA,-41899000,-42906000,NA,income_statement,Medical Devices,"Viveve Medical, Inc.","Viveve Medical, Inc., together with its subsidiaries, designs, develops, manufactures, and markets medical devices for the non-invasive treatment of vaginal introital laxity, sexual function, vaginal rejuvenation, and stress urinary incontinence. The company offers Viveve System comprises of the radiofrequency generator, reusable handpiece, and treatment tip, as well as cryogen canister and other consumable components. It markets its products through sales employees and distributors in the United States, Canada, the Asia Pacific, Europe, the Middle East, Latin America, Canada, and internationally. Viveve Medical, Inc. was founded in 2005 and is headquartered in Englewood, Colorado."
VIVO,2017-09-30,16036000,36429000,NA,21557000,63484000,124292000,44772000,44772000,-1642000,14872000,200771000,155999000,76479000,-8343000,NA,21557000,21557000,NA,income_statement,Diagnostics & Research,Meridian Bioscience Inc.,"Meridian Bioscience, Inc., a life science company, develops, manufactures, distributes, and sells diagnostic test kits primarily for gastrointestinal and respiratory infectious diseases, and elevated blood lead levels worldwide. The company operates through Diagnostics and Life Science segments. The Diagnostics segment offers testing platforms, including real-time PCR amplification under the Revogene brand; isothermal DNA amplification under the Alethia brand; lateral flow immunoassay using fluorescent chemistry under the Curian brand; rapid immunoassay under the ImmunoCard and ImmunoCard STAT! brands; enzyme-linked immunoassays under the PREMIER brand; anodic stripping voltammetry under the LeadCare and PediaStat brands; and urea breath testing for H. pylori under the BreathID brand. This segment also offers gastrointestinal assays, including tests for C. difficile, H. pylori, and certain foodborne pathogens; respiratory illness assays, such as tests Group A strep, mycoplasma pneumonia, influenza, and pertussis; and blood chemistry assays for testing elevated levels of lead in blood. It sells products through direct sales force and independent distributors to acute care hospitals, reference laboratories, outpatient clinics, and physician office laboratories. The Life Science segment offers bulk antigens, antibodies, PCR/qPCR reagents, nucleotides, and bioresearch reagents used by in vitro diagnostic manufacturers, as well as researchers in immunological and molecular tests for human, animal, plant, and environmental applications. The company has a strategic collaboration with DiaSorin Inc. to sell H. pylori tests. Meridian Bioscience, Inc. was incorporated in 1976 and is headquartered in Cincinnati, Ohio."
VIVO,2018-09-30,16613000,30380000,NA,23849000,69785000,131033000,44635000,44635000,-1520000,6531000,213571000,168936000,82538000,-14255000,NA,23849000,23849000,NA,income_statement,Diagnostics & Research,Meridian Bioscience Inc.,"Meridian Bioscience, Inc., a life science company, develops, manufactures, distributes, and sells diagnostic test kits primarily for gastrointestinal and respiratory infectious diseases, and elevated blood lead levels worldwide. The company operates through Diagnostics and Life Science segments. The Diagnostics segment offers testing platforms, including real-time PCR amplification under the Revogene brand; isothermal DNA amplification under the Alethia brand; lateral flow immunoassay using fluorescent chemistry under the Curian brand; rapid immunoassay under the ImmunoCard and ImmunoCard STAT! brands; enzyme-linked immunoassays under the PREMIER brand; anodic stripping voltammetry under the LeadCare and PediaStat brands; and urea breath testing for H. pylori under the BreathID brand. This segment also offers gastrointestinal assays, including tests for C. difficile, H. pylori, and certain foodborne pathogens; respiratory illness assays, such as tests Group A strep, mycoplasma pneumonia, influenza, and pertussis; and blood chemistry assays for testing elevated levels of lead in blood. It sells products through direct sales force and independent distributors to acute care hospitals, reference laboratories, outpatient clinics, and physician office laboratories. The Life Science segment offers bulk antigens, antibodies, PCR/qPCR reagents, nucleotides, and bioresearch reagents used by in vitro diagnostic manufacturers, as well as researchers in immunological and molecular tests for human, animal, plant, and environmental applications. The company has a strategic collaboration with DiaSorin Inc. to sell H. pylori tests. Meridian Bioscience, Inc. was incorporated in 1976 and is headquartered in Cincinnati, Ohio."
VIVO,2019-09-30,17760000,31557000,NA,24382000,62039000,118728000,38929000,38929000,-1945000,7175000,201014000,162085000,82286000,-7372000,NA,24382000,24382000,NA,income_statement,Diagnostics & Research,Meridian Bioscience Inc.,"Meridian Bioscience, Inc., a life science company, develops, manufactures, distributes, and sells diagnostic test kits primarily for gastrointestinal and respiratory infectious diseases, and elevated blood lead levels worldwide. The company operates through Diagnostics and Life Science segments. The Diagnostics segment offers testing platforms, including real-time PCR amplification under the Revogene brand; isothermal DNA amplification under the Alethia brand; lateral flow immunoassay using fluorescent chemistry under the Curian brand; rapid immunoassay under the ImmunoCard and ImmunoCard STAT! brands; enzyme-linked immunoassays under the PREMIER brand; anodic stripping voltammetry under the LeadCare and PediaStat brands; and urea breath testing for H. pylori under the BreathID brand. This segment also offers gastrointestinal assays, including tests for C. difficile, H. pylori, and certain foodborne pathogens; respiratory illness assays, such as tests Group A strep, mycoplasma pneumonia, influenza, and pertussis; and blood chemistry assays for testing elevated levels of lead in blood. It sells products through direct sales force and independent distributors to acute care hospitals, reference laboratories, outpatient clinics, and physician office laboratories. The Life Science segment offers bulk antigens, antibodies, PCR/qPCR reagents, nucleotides, and bioresearch reagents used by in vitro diagnostic manufacturers, as well as researchers in immunological and molecular tests for human, animal, plant, and environmental applications. The company has a strategic collaboration with DiaSorin Inc. to sell H. pylori tests. Meridian Bioscience, Inc. was incorporated in 1976 and is headquartered in Cincinnati, Ohio."
VIVO,2020-09-30,23729000,59293000,NA,46186000,70831000,156248000,61688000,61688000,-2632000,13107000,253667000,191979000,97419000,-2395000,NA,46186000,46186000,NA,income_statement,Diagnostics & Research,Meridian Bioscience Inc.,"Meridian Bioscience, Inc., a life science company, develops, manufactures, distributes, and sells diagnostic test kits primarily for gastrointestinal and respiratory infectious diseases, and elevated blood lead levels worldwide. The company operates through Diagnostics and Life Science segments. The Diagnostics segment offers testing platforms, including real-time PCR amplification under the Revogene brand; isothermal DNA amplification under the Alethia brand; lateral flow immunoassay using fluorescent chemistry under the Curian brand; rapid immunoassay under the ImmunoCard and ImmunoCard STAT! brands; enzyme-linked immunoassays under the PREMIER brand; anodic stripping voltammetry under the LeadCare and PediaStat brands; and urea breath testing for H. pylori under the BreathID brand. This segment also offers gastrointestinal assays, including tests for C. difficile, H. pylori, and certain foodborne pathogens; respiratory illness assays, such as tests Group A strep, mycoplasma pneumonia, influenza, and pertussis; and blood chemistry assays for testing elevated levels of lead in blood. It sells products through direct sales force and independent distributors to acute care hospitals, reference laboratories, outpatient clinics, and physician office laboratories. The Life Science segment offers bulk antigens, antibodies, PCR/qPCR reagents, nucleotides, and bioresearch reagents used by in vitro diagnostic manufacturers, as well as researchers in immunological and molecular tests for human, animal, plant, and environmental applications. The company has a strategic collaboration with DiaSorin Inc. to sell H. pylori tests. Meridian Bioscience, Inc. was incorporated in 1976 and is headquartered in Cincinnati, Ohio."
VJET,2016-12-31,5683000,-11311000,87000,-11287000,9875000,6903000,-8840000,-8840000,-230000,2000,22338000,31178000,15435000,-2471000,NA,-11313000,-11287000,-71000,income_statement,Computer Hardware,voxeljet AG,"voxeljet AG provides three-dimensional (3D) printers and on-demand parts services to industrial and commercial customers in Europe, the Middle East, Africa, the Asia Pacific, and the Americas. It operates in two segments, Systems and Services. The Systems segment develops, manufactures, and sells 3D printers. This segment also offers consumables, including particulate materials and proprietary chemical binding agents, maintenance contracts, and spare parts. The Services segment prints on-demand parts for its customers, as well as creates parts, molds, cores, and models using 3D computer-aided design at its service center; and provides casting services. It serves automotive, aerospace, art and architecture, engineering, and consumer product end markets; foundries and suppliers; and universities and research institutes through its direct sales force and a network of sales agents. The company was formerly known as Voxeljet Technology GmbH and changed its name to voxeljet AG in January 2004. voxeljet AG was founded in 1999 and is headquartered in Friedberg, Germany."
VJET,2017-12-31,5528000,-8474000,71000,-8538000,11603000,9325000,-7405000,-7405000,-190000,80000,23178000,30583000,13853000,-1069000,NA,-8554000,-8538000,-401000,income_statement,Computer Hardware,voxeljet AG,"voxeljet AG provides three-dimensional (3D) printers and on-demand parts services to industrial and commercial customers in Europe, the Middle East, Africa, the Asia Pacific, and the Americas. It operates in two segments, Systems and Services. The Systems segment develops, manufactures, and sells 3D printers. This segment also offers consumables, including particulate materials and proprietary chemical binding agents, maintenance contracts, and spare parts. The Services segment prints on-demand parts for its customers, as well as creates parts, molds, cores, and models using 3D computer-aided design at its service center; and provides casting services. It serves automotive, aerospace, art and architecture, engineering, and consumer product end markets; foundries and suppliers; and universities and research institutes through its direct sales force and a network of sales agents. The company was formerly known as Voxeljet Technology GmbH and changed its name to voxeljet AG in January 2004. voxeljet AG was founded in 1999 and is headquartered in Friedberg, Germany."
VJET,2018-12-31,6334000,-8753000,35000,-8728000,12919000,9145000,-9964000,-9964000,-1143000,11000,26009000,35973000,16864000,1211000,NA,-8764000,-8728000,-144000,income_statement,Computer Hardware,voxeljet AG,"voxeljet AG provides three-dimensional (3D) printers and on-demand parts services to industrial and commercial customers in Europe, the Middle East, Africa, the Asia Pacific, and the Americas. It operates in two segments, Systems and Services. The Systems segment develops, manufactures, and sells 3D printers. This segment also offers consumables, including particulate materials and proprietary chemical binding agents, maintenance contracts, and spare parts. The Services segment prints on-demand parts for its customers, as well as creates parts, molds, cores, and models using 3D computer-aided design at its service center; and provides casting services. It serves automotive, aerospace, art and architecture, engineering, and consumer product end markets; foundries and suppliers; and universities and research institutes through its direct sales force and a network of sales agents. The company was formerly known as Voxeljet Technology GmbH and changed its name to voxeljet AG in January 2004. voxeljet AG was founded in 1999 and is headquartered in Friedberg, Germany."
VJET,2019-12-31,7212000,-14222000,-13000,-13967000,13754000,7488000,-13057000,-13057000,-1458000,9000,24602000,37659000,17114000,-1165000,NA,-14231000,-13967000,-421000,income_statement,Computer Hardware,voxeljet AG,"voxeljet AG provides three-dimensional (3D) printers and on-demand parts services to industrial and commercial customers in Europe, the Middle East, Africa, the Asia Pacific, and the Americas. It operates in two segments, Systems and Services. The Systems segment develops, manufactures, and sells 3D printers. This segment also offers consumables, including particulate materials and proprietary chemical binding agents, maintenance contracts, and spare parts. The Services segment prints on-demand parts for its customers, as well as creates parts, molds, cores, and models using 3D computer-aided design at its service center; and provides casting services. It serves automotive, aerospace, art and architecture, engineering, and consumer product end markets; foundries and suppliers; and universities and research institutes through its direct sales force and a network of sales agents. The company was formerly known as Voxeljet Technology GmbH and changed its name to voxeljet AG in January 2004. voxeljet AG was founded in 1999 and is headquartered in Friedberg, Germany."
VKTX,2017-12-31,13741000,-20578000,NA,-20578000,5329000,0,-19070000,-19070000,-1951000,0,0,19070000,0,-1508000,NA,-20578000,-20578000,NA,income_statement,Biotechnology,"Viking Therapeutics, Inc.","Viking Therapeutics, Inc., a clinical-stage biopharmaceutical company, focuses on the development of novel therapies for metabolic and endocrine disorders. Its lead drug candidate is VK2809, an orally available tissue and receptor-subtype selective agonist of the thyroid hormone receptor beta, which is in Phase 2b clinical trials to treat patients with biopsy-confirmed non-alcoholic steatohepatitis. The company's lead drug candidate also includes VK5211, an orally available non-steroidal selective androgen receptor modulator that is in Phase II clinical trials for the treatment of patients recovering from non-elective hip fracture surgery. It is also developing VK0612, an orally available Phase 2b-ready drug candidate for type 2 diabetes; and VK0214, an orally available tissue and receptor-subtype selective agonist of the thyroid hormone receptor beta for X-linked adrenoleukodystrophy. Viking Therapeutics, Inc. was founded in 2012 and is headquartered in San Diego, California."
VKTX,2018-12-31,19040000,-22063000,NA,-22063000,7121000,0,-26161000,-26161000,-562000,0,0,26161000,0,4098000,NA,-22063000,-22063000,NA,income_statement,Biotechnology,"Viking Therapeutics, Inc.","Viking Therapeutics, Inc., a clinical-stage biopharmaceutical company, focuses on the development of novel therapies for metabolic and endocrine disorders. Its lead drug candidate is VK2809, an orally available tissue and receptor-subtype selective agonist of the thyroid hormone receptor beta, which is in Phase 2b clinical trials to treat patients with biopsy-confirmed non-alcoholic steatohepatitis. The company's lead drug candidate also includes VK5211, an orally available non-steroidal selective androgen receptor modulator that is in Phase II clinical trials for the treatment of patients recovering from non-elective hip fracture surgery. It is also developing VK0612, an orally available Phase 2b-ready drug candidate for type 2 diabetes; and VK0214, an orally available tissue and receptor-subtype selective agonist of the thyroid hormone receptor beta for X-linked adrenoleukodystrophy. Viking Therapeutics, Inc. was founded in 2012 and is headquartered in San Diego, California."
VKTX,2019-12-31,23559000,-25779000,NA,-25779000,9128000,0,-32687000,-32687000,-146000,0,0,32687000,0,6908000,NA,-25779000,-25779000,NA,income_statement,Biotechnology,"Viking Therapeutics, Inc.","Viking Therapeutics, Inc., a clinical-stage biopharmaceutical company, focuses on the development of novel therapies for metabolic and endocrine disorders. Its lead drug candidate is VK2809, an orally available tissue and receptor-subtype selective agonist of the thyroid hormone receptor beta, which is in Phase 2b clinical trials to treat patients with biopsy-confirmed non-alcoholic steatohepatitis. The company's lead drug candidate also includes VK5211, an orally available non-steroidal selective androgen receptor modulator that is in Phase II clinical trials for the treatment of patients recovering from non-elective hip fracture surgery. It is also developing VK0612, an orally available Phase 2b-ready drug candidate for type 2 diabetes; and VK0214, an orally available tissue and receptor-subtype selective agonist of the thyroid hormone receptor beta for X-linked adrenoleukodystrophy. Viking Therapeutics, Inc. was founded in 2012 and is headquartered in San Diego, California."
VKTX,2020-12-31,31931000,-39495000,NA,-39495000,10731000,0,-42662000,-42662000,-106000,0,0,42662000,0,3167000,NA,-39495000,-39495000,NA,income_statement,Biotechnology,"Viking Therapeutics, Inc.","Viking Therapeutics, Inc., a clinical-stage biopharmaceutical company, focuses on the development of novel therapies for metabolic and endocrine disorders. Its lead drug candidate is VK2809, an orally available tissue and receptor-subtype selective agonist of the thyroid hormone receptor beta, which is in Phase 2b clinical trials to treat patients with biopsy-confirmed non-alcoholic steatohepatitis. The company's lead drug candidate also includes VK5211, an orally available non-steroidal selective androgen receptor modulator that is in Phase II clinical trials for the treatment of patients recovering from non-elective hip fracture surgery. It is also developing VK0612, an orally available Phase 2b-ready drug candidate for type 2 diabetes; and VK0214, an orally available tissue and receptor-subtype selective agonist of the thyroid hormone receptor beta for X-linked adrenoleukodystrophy. Viking Therapeutics, Inc. was founded in 2012 and is headquartered in San Diego, California."
VLDR,2017-12-31,31610000,25571000,NA,15761000,23934000,80377000,24833000,24833000,-14000,9810000,182090000,157257000,101713000,738000,NA,15761000,12139000,NA,income_statement,Scientific & Technical Instruments,"Velodyne Lidar, Inc.","Velodyne Lidar, Inc. develops and produces lidar sensors for use in industrial, 3D mapping, drones, and auto applications in North America, the Asia Pacific, Europe, the Middle East, and Africa. The company offers surround-view hybrid solid state, directional solid state, and dome lidars; and Vella, an advanced driver assistance systems (ADAS) software solution built around lidar. Its products are used in various applications, including autonomous vehicles, ADAS, UAVs, mapping, industrial automation, self-driving rovers, autonomous vessels, smart city initiatives, and robotics. The company has a strategic partnership with Beijing Trunk Technology Co., Ltd. Velodyne Lidar, Inc. was founded in 2018 and is headquartered in San Jose, California."
VLDR,2018-12-31,51993000,-55672000,NA,-62300000,35039000,30880000,-56152000,-56152000,-14000,6628000,142946000,199098000,112066000,480000,NA,-62300000,-62300000,NA,income_statement,Scientific & Technical Instruments,"Velodyne Lidar, Inc.","Velodyne Lidar, Inc. develops and produces lidar sensors for use in industrial, 3D mapping, drones, and auto applications in North America, the Asia Pacific, Europe, the Middle East, and Africa. The company offers surround-view hybrid solid state, directional solid state, and dome lidars; and Vella, an advanced driver assistance systems (ADAS) software solution built around lidar. Its products are used in various applications, including autonomous vehicles, ADAS, UAVs, mapping, industrial automation, self-driving rovers, autonomous vessels, smart city initiatives, and robotics. The company has a strategic partnership with Beijing Trunk Technology Co., Ltd. Velodyne Lidar, Inc. was founded in 2018 and is headquartered in San Jose, California."
VLDR,2019-12-31,56850000,-67909000,NA,-67226000,41731000,29768000,-68813000,-68813000,-77000,-683000,101398000,170211000,71630000,904000,NA,-67226000,-67226000,NA,income_statement,Scientific & Technical Instruments,"Velodyne Lidar, Inc.","Velodyne Lidar, Inc. develops and produces lidar sensors for use in industrial, 3D mapping, drones, and auto applications in North America, the Asia Pacific, Europe, the Middle East, and Africa. The company offers surround-view hybrid solid state, directional solid state, and dome lidars; and Vella, an advanced driver assistance systems (ADAS) software solution built around lidar. Its products are used in various applications, including autonomous vehicles, ADAS, UAVs, mapping, industrial automation, self-driving rovers, autonomous vessels, smart city initiatives, and robotics. The company has a strategic partnership with Beijing Trunk Technology Co., Ltd. Velodyne Lidar, Inc. was founded in 2018 and is headquartered in San Jose, California."
VLGEA,2017-07-29,NA,39123000,NA,22921000,371495000,436711000,40734000,40734000,-4452000,16202000,1604574000,1563840000,1167863000,-1611000,NA,22921000,22379000,NA,income_statement,Grocery Stores,"Village Super Market, Inc.","Village Super Market, Inc. operates a chain of supermarkets in the United States. Its stores feature specialty departments, such as an on-site bakery, an expanded delicatessen, various natural and organic foods, ethnic and international foods, prepared foods, and pharmacies. The company operates a chain of 30 ShopRite supermarkets, 5 Fairway Markets, and 3 Gourmet Garage specialty markets located in New Jersey, New York, Pennsylvania, and Maryland. Village Super Market, Inc. was founded in 1937 and is based in Springfield, New Jersey."
VLGEA,2018-07-28,NA,32838000,NA,25080000,384577000,443029000,33453000,33453000,-4460000,7758000,1615045000,1581592000,1172016000,-615000,NA,25080000,24372000,NA,income_statement,Grocery Stores,"Village Super Market, Inc.","Village Super Market, Inc. operates a chain of supermarkets in the United States. Its stores feature specialty departments, such as an on-site bakery, an expanded delicatessen, various natural and organic foods, ethnic and international foods, prepared foods, and pharmacies. The company operates a chain of 30 ShopRite supermarkets, 5 Fairway Markets, and 3 Gourmet Garage specialty markets located in New Jersey, New York, Pennsylvania, and Maryland. Village Super Market, Inc. was founded in 1937 and is based in Springfield, New Jersey."
VLGEA,2019-07-27,NA,35523000,NA,25539000,395165000,456716000,34261000,34261000,-4436000,9984000,1643502000,1609241000,1186786000,1262000,NA,25539000,24879000,NA,income_statement,Grocery Stores,"Village Super Market, Inc.","Village Super Market, Inc. operates a chain of supermarkets in the United States. Its stores feature specialty departments, such as an on-site bakery, an expanded delicatessen, various natural and organic foods, ethnic and international foods, prepared foods, and pharmacies. The company operates a chain of 30 ShopRite supermarkets, 5 Fairway Markets, and 3 Gourmet Garage specialty markets located in New Jersey, New York, Pennsylvania, and Maryland. Village Super Market, Inc. was founded in 1937 and is based in Springfield, New Jersey."
VLGEA,2020-07-25,NA,31733000,NA,24939000,447566000,506475000,27551000,27551000,-2611000,6794000,1804594000,1777043000,1298119000,4182000,NA,24939000,24220000,NA,income_statement,Grocery Stores,"Village Super Market, Inc.","Village Super Market, Inc. operates a chain of supermarkets in the United States. Its stores feature specialty departments, such as an on-site bakery, an expanded delicatessen, various natural and organic foods, ethnic and international foods, prepared foods, and pharmacies. The company operates a chain of 30 ShopRite supermarkets, 5 Fairway Markets, and 3 Gourmet Garage specialty markets located in New Jersey, New York, Pennsylvania, and Maryland. Village Super Market, Inc. was founded in 1937 and is based in Springfield, New Jersey."
VLO,2017-12-31,NA,3207000000,909000000,4065000000,793000000,6439000000,3599000000,3599000000,-468000000,-949000000,88407000000,84808000000,81968000000,-453000000,NA,4156000000,4051000000,61000000,income_statement,NA,NA,NA
VLO,2018-12-31,NA,4232000000,1064000000,3122000000,965000000,7441000000,4547000000,4547000000,-470000000,879000000,111407000000,106860000000,103966000000,-315000000,NA,3353000000,3113000000,-125000000,income_statement,NA,NA,NA
VLO,2019-12-31,NA,3486000000,733000000,2422000000,819000000,6531000000,3885000000,3885000000,-454000000,702000000,102729000000,98844000000,96198000000,-399000000,NA,2784000000,2415000000,-428000000,income_statement,NA,NA,NA
VLO,2020-12-31,NA,-2010000000,NA,-1421000000,756000000,1266000000,-1549000000,-1549000000,-563000000,-903000000,64912000000,66461000000,63646000000,-461000000,NA,-1107000000,-1421000000,-262000000,income_statement,NA,NA,NA
VLON,2018-12-31,1813019,-4312646,NA,-4312646,800688,0,-2613707,-2613707,-197026,0,0,2613707,0,-1698939,NA,-4312646,-4312646,NA,income_statement,Biotechnology,Vallon Pharmaceuticals Inc.,"Vallon Pharmaceuticals, Inc., a biopharmaceutical company, focuses on the development and commercialization of prescription drugs for central nervous system disorders. The company develops abuse-deterrent amphetamine immediate-release, an abuse-deterrent oral formulation of immediate-release dextroamphetamine for the treatment of attention-deficit/hyperactivity disorder and narcolepsy. It also develops ADMIR, an abuse deterrent formulation of Ritalin. The company was incorporated in 2018 and is based in Philadelphia, Pennsylvania."
VLON,2019-12-31,1882434,-3464492,NA,-3464492,1271987,0,-3154421,-3154421,-197026,0,0,3154421,0,-310071,NA,-3464492,-3464492,NA,income_statement,Biotechnology,Vallon Pharmaceuticals Inc.,"Vallon Pharmaceuticals, Inc., a biopharmaceutical company, focuses on the development and commercialization of prescription drugs for central nervous system disorders. The company develops abuse-deterrent amphetamine immediate-release, an abuse-deterrent oral formulation of immediate-release dextroamphetamine for the treatment of attention-deficit/hyperactivity disorder and narcolepsy. It also develops ADMIR, an abuse deterrent formulation of Ritalin. The company was incorporated in 2018 and is based in Philadelphia, Pennsylvania."
VLY,2017-12-31,NA,252738000,NA,161907000,391335000,720064000,0,282575000,NA,90831000,720064000,437489000,0,-29837000,NA,161907000,152458000,46154000,income_statement,Banks—Regional,Valley National Bancorp,"Valley National Bancorp operates as the holding company for the Valley National Bank that provides commercial, retail, insurance, and wealth management financial services. The company operates through Commercial Lending, Consumer Lending, and Investment Management segments. Its deposit products include non-interest bearing, savings, NOW, and money market accounts, as well as certificates of deposit. The company offers various loan products comprising residential mortgage loans, automobile loans, secured personal lines of credit, and home equity loans; and floating rate and adjustable rate commercial and industrial loans, as well as fixed rate owner occupied and commercial real estate loans. It also invests in securities and interest-bearing deposits with other banks; and offers international banking services, such as standby letters of credit, documentary letters of credit and related products, and other ancillary services, such as foreign exchange transactions, documentary collections, foreign wire transfers, and transaction accounts for non-resident aliens. In addition, the company provides asset management advisory, trust, and asset-based lending support services; property and casualty, life, health, and title insurance agency services; and health care equipment lending and other commercial equipment leasing services, as well as real estate related investments. Further, it offers other banking services comprising automated teller machine, telephone and Internet banking, remote deposit capturing, overdraft, drive-in and night deposit, and safe deposit services. The company operates 238 branches in New Jersey, New York, Florida, and Alabama. Valley National Bancorp was founded in 1927 and is based in New York, New York."
VLY,2018-12-31,NA,329693000,NA,261428000,462483000,934554000,0,408314000,NA,68265000,934554000,526240000,0,-78621000,NA,261428000,248740000,63757000,income_statement,Banks—Regional,Valley National Bancorp,"Valley National Bancorp operates as the holding company for the Valley National Bank that provides commercial, retail, insurance, and wealth management financial services. The company operates through Commercial Lending, Consumer Lending, and Investment Management segments. Its deposit products include non-interest bearing, savings, NOW, and money market accounts, as well as certificates of deposit. The company offers various loan products comprising residential mortgage loans, automobile loans, secured personal lines of credit, and home equity loans; and floating rate and adjustable rate commercial and industrial loans, as well as fixed rate owner occupied and commercial real estate loans. It also invests in securities and interest-bearing deposits with other banks; and offers international banking services, such as standby letters of credit, documentary letters of credit and related products, and other ancillary services, such as foreign exchange transactions, documentary collections, foreign wire transfers, and transaction accounts for non-resident aliens. In addition, the company provides asset management advisory, trust, and asset-based lending support services; property and casualty, life, health, and title insurance agency services; and health care equipment lending and other commercial equipment leasing services, as well as real estate related investments. Further, it offers other banking services comprising automated teller machine, telephone and Internet banking, remote deposit capturing, overdraft, drive-in and night deposit, and safe deposit services. The company operates 238 branches in New Jersey, New York, Florida, and Alabama. Valley National Bancorp was founded in 1927 and is based in New York, New York."
VLY,2019-12-31,NA,456795000,NA,309793000,454807000,1070886000,0,553016000,NA,147002000,1070886000,517870000,0,-96221000,NA,309793000,297105000,63063000,income_statement,Banks—Regional,Valley National Bancorp,"Valley National Bancorp operates as the holding company for the Valley National Bank that provides commercial, retail, insurance, and wealth management financial services. The company operates through Commercial Lending, Consumer Lending, and Investment Management segments. Its deposit products include non-interest bearing, savings, NOW, and money market accounts, as well as certificates of deposit. The company offers various loan products comprising residential mortgage loans, automobile loans, secured personal lines of credit, and home equity loans; and floating rate and adjustable rate commercial and industrial loans, as well as fixed rate owner occupied and commercial real estate loans. It also invests in securities and interest-bearing deposits with other banks; and offers international banking services, such as standby letters of credit, documentary letters of credit and related products, and other ancillary services, such as foreign exchange transactions, documentary collections, foreign wire transfers, and transaction accounts for non-resident aliens. In addition, the company provides asset management advisory, trust, and asset-based lending support services; property and casualty, life, health, and title insurance agency services; and health care equipment lending and other commercial equipment leasing services, as well as real estate related investments. Further, it offers other banking services comprising automated teller machine, telephone and Internet banking, remote deposit capturing, overdraft, drive-in and night deposit, and safe deposit services. The company operates 238 branches in New Jersey, New York, Florida, and Alabama. Valley National Bancorp was founded in 1927 and is based in New York, New York."
VLY,2020-12-31,NA,530066000,NA,390606000,503236000,1162879000,0,587768000,NA,139460000,1162879000,575111000,0,-57702000,NA,390606000,377918000,71875000,income_statement,Banks—Regional,Valley National Bancorp,"Valley National Bancorp operates as the holding company for the Valley National Bank that provides commercial, retail, insurance, and wealth management financial services. The company operates through Commercial Lending, Consumer Lending, and Investment Management segments. Its deposit products include non-interest bearing, savings, NOW, and money market accounts, as well as certificates of deposit. The company offers various loan products comprising residential mortgage loans, automobile loans, secured personal lines of credit, and home equity loans; and floating rate and adjustable rate commercial and industrial loans, as well as fixed rate owner occupied and commercial real estate loans. It also invests in securities and interest-bearing deposits with other banks; and offers international banking services, such as standby letters of credit, documentary letters of credit and related products, and other ancillary services, such as foreign exchange transactions, documentary collections, foreign wire transfers, and transaction accounts for non-resident aliens. In addition, the company provides asset management advisory, trust, and asset-based lending support services; property and casualty, life, health, and title insurance agency services; and health care equipment lending and other commercial equipment leasing services, as well as real estate related investments. Further, it offers other banking services comprising automated teller machine, telephone and Internet banking, remote deposit capturing, overdraft, drive-in and night deposit, and safe deposit services. The company operates 238 branches in New Jersey, New York, Florida, and Alabama. Valley National Bancorp was founded in 1927 and is based in New York, New York."
VLYPO,2017-12-31,NA,252738000,NA,161907000,391335000,720064000,0,282575000,NA,90831000,720064000,437489000,0,-29837000,NA,161907000,152458000,46154000,income_statement,Banks—Regional,Valley National Bancorp - 5.5%,"Valley National Bancorp operates as the holding company for the Valley National Bank that provides commercial, retail, insurance, and wealth management financial services. The company operates through Commercial Lending, Consumer Lending, and Investment Management segments. Its deposit products include non-interest bearing, savings, NOW, and money market accounts, as well as certificates of deposit. The company offers various loan products comprising residential mortgage loans, automobile loans, secured personal lines of credit, and home equity loans; and floating rate and adjustable rate commercial and industrial loans, as well as fixed rate owner occupied and commercial real estate loans. It also invests in securities and interest-bearing deposits with other banks; and offers international banking services, such as standby letters of credit, documentary letters of credit and related products, and other ancillary services, such as foreign exchange transactions, documentary collections, foreign wire transfers, and transaction accounts for non-resident aliens. In addition, the company provides asset management advisory, trust, and asset-based lending support services; property and casualty, life, health, and title insurance agency services; and health care equipment lending and other commercial equipment leasing services, as well as real estate related investments. Further, it offers other banking services comprising automated teller machine, telephone and Internet banking, remote deposit capturing, overdraft, drive-in and night deposit, and safe deposit services. The company operates 238 branches in New Jersey, New York, Florida, and Alabama. Valley National Bancorp was founded in 1927 and is based in New York, New York."
VLYPO,2018-12-31,NA,329693000,NA,261428000,462483000,934554000,0,408314000,NA,68265000,934554000,526240000,0,-78621000,NA,261428000,248740000,63757000,income_statement,Banks—Regional,Valley National Bancorp - 5.5%,"Valley National Bancorp operates as the holding company for the Valley National Bank that provides commercial, retail, insurance, and wealth management financial services. The company operates through Commercial Lending, Consumer Lending, and Investment Management segments. Its deposit products include non-interest bearing, savings, NOW, and money market accounts, as well as certificates of deposit. The company offers various loan products comprising residential mortgage loans, automobile loans, secured personal lines of credit, and home equity loans; and floating rate and adjustable rate commercial and industrial loans, as well as fixed rate owner occupied and commercial real estate loans. It also invests in securities and interest-bearing deposits with other banks; and offers international banking services, such as standby letters of credit, documentary letters of credit and related products, and other ancillary services, such as foreign exchange transactions, documentary collections, foreign wire transfers, and transaction accounts for non-resident aliens. In addition, the company provides asset management advisory, trust, and asset-based lending support services; property and casualty, life, health, and title insurance agency services; and health care equipment lending and other commercial equipment leasing services, as well as real estate related investments. Further, it offers other banking services comprising automated teller machine, telephone and Internet banking, remote deposit capturing, overdraft, drive-in and night deposit, and safe deposit services. The company operates 238 branches in New Jersey, New York, Florida, and Alabama. Valley National Bancorp was founded in 1927 and is based in New York, New York."
VLYPO,2019-12-31,NA,456795000,NA,309793000,454807000,1070886000,0,553016000,NA,147002000,1070886000,517870000,0,-96221000,NA,309793000,297105000,63063000,income_statement,Banks—Regional,Valley National Bancorp - 5.5%,"Valley National Bancorp operates as the holding company for the Valley National Bank that provides commercial, retail, insurance, and wealth management financial services. The company operates through Commercial Lending, Consumer Lending, and Investment Management segments. Its deposit products include non-interest bearing, savings, NOW, and money market accounts, as well as certificates of deposit. The company offers various loan products comprising residential mortgage loans, automobile loans, secured personal lines of credit, and home equity loans; and floating rate and adjustable rate commercial and industrial loans, as well as fixed rate owner occupied and commercial real estate loans. It also invests in securities and interest-bearing deposits with other banks; and offers international banking services, such as standby letters of credit, documentary letters of credit and related products, and other ancillary services, such as foreign exchange transactions, documentary collections, foreign wire transfers, and transaction accounts for non-resident aliens. In addition, the company provides asset management advisory, trust, and asset-based lending support services; property and casualty, life, health, and title insurance agency services; and health care equipment lending and other commercial equipment leasing services, as well as real estate related investments. Further, it offers other banking services comprising automated teller machine, telephone and Internet banking, remote deposit capturing, overdraft, drive-in and night deposit, and safe deposit services. The company operates 238 branches in New Jersey, New York, Florida, and Alabama. Valley National Bancorp was founded in 1927 and is based in New York, New York."
VLYPO,2020-12-31,NA,530066000,NA,390606000,503236000,1162879000,0,587768000,NA,139460000,1162879000,575111000,0,-57702000,NA,390606000,377918000,71875000,income_statement,Banks—Regional,Valley National Bancorp - 5.5%,"Valley National Bancorp operates as the holding company for the Valley National Bank that provides commercial, retail, insurance, and wealth management financial services. The company operates through Commercial Lending, Consumer Lending, and Investment Management segments. Its deposit products include non-interest bearing, savings, NOW, and money market accounts, as well as certificates of deposit. The company offers various loan products comprising residential mortgage loans, automobile loans, secured personal lines of credit, and home equity loans; and floating rate and adjustable rate commercial and industrial loans, as well as fixed rate owner occupied and commercial real estate loans. It also invests in securities and interest-bearing deposits with other banks; and offers international banking services, such as standby letters of credit, documentary letters of credit and related products, and other ancillary services, such as foreign exchange transactions, documentary collections, foreign wire transfers, and transaction accounts for non-resident aliens. In addition, the company provides asset management advisory, trust, and asset-based lending support services; property and casualty, life, health, and title insurance agency services; and health care equipment lending and other commercial equipment leasing services, as well as real estate related investments. Further, it offers other banking services comprising automated teller machine, telephone and Internet banking, remote deposit capturing, overdraft, drive-in and night deposit, and safe deposit services. The company operates 238 branches in New Jersey, New York, Florida, and Alabama. Valley National Bancorp was founded in 1927 and is based in New York, New York."
VLYPP,2017-12-31,NA,252738000,NA,161907000,391335000,720064000,0,282575000,NA,90831000,720064000,437489000,0,-29837000,NA,161907000,152458000,46154000,income_statement,Banks—Regional,Valley National Bancorp - 6.25%,"Valley National Bancorp operates as the holding company for the Valley National Bank that provides commercial, retail, insurance, and wealth management financial services. The company operates through Commercial Lending, Consumer Lending, and Investment Management segments. Its deposit products include non-interest bearing, savings, NOW, and money market accounts, as well as certificates of deposit. The company offers various loan products comprising residential mortgage loans, automobile loans, secured personal lines of credit, and home equity loans; and floating rate and adjustable rate commercial and industrial loans, as well as fixed rate owner occupied and commercial real estate loans. It also invests in securities and interest-bearing deposits with other banks; and offers international banking services, such as standby letters of credit, documentary letters of credit and related products, and other ancillary services, such as foreign exchange transactions, documentary collections, foreign wire transfers, and transaction accounts for non-resident aliens. In addition, the company provides asset management advisory, trust, and asset-based lending support services; property and casualty, life, health, and title insurance agency services; and health care equipment lending and other commercial equipment leasing services, as well as real estate related investments. Further, it offers other banking services comprising automated teller machine, telephone and Internet banking, remote deposit capturing, overdraft, drive-in and night deposit, and safe deposit services. The company operates 238 branches in New Jersey, New York, Florida, and Alabama. Valley National Bancorp was founded in 1927 and is based in New York, New York."
VLYPP,2018-12-31,NA,329693000,NA,261428000,462483000,934554000,0,408314000,NA,68265000,934554000,526240000,0,-78621000,NA,261428000,248740000,63757000,income_statement,Banks—Regional,Valley National Bancorp - 6.25%,"Valley National Bancorp operates as the holding company for the Valley National Bank that provides commercial, retail, insurance, and wealth management financial services. The company operates through Commercial Lending, Consumer Lending, and Investment Management segments. Its deposit products include non-interest bearing, savings, NOW, and money market accounts, as well as certificates of deposit. The company offers various loan products comprising residential mortgage loans, automobile loans, secured personal lines of credit, and home equity loans; and floating rate and adjustable rate commercial and industrial loans, as well as fixed rate owner occupied and commercial real estate loans. It also invests in securities and interest-bearing deposits with other banks; and offers international banking services, such as standby letters of credit, documentary letters of credit and related products, and other ancillary services, such as foreign exchange transactions, documentary collections, foreign wire transfers, and transaction accounts for non-resident aliens. In addition, the company provides asset management advisory, trust, and asset-based lending support services; property and casualty, life, health, and title insurance agency services; and health care equipment lending and other commercial equipment leasing services, as well as real estate related investments. Further, it offers other banking services comprising automated teller machine, telephone and Internet banking, remote deposit capturing, overdraft, drive-in and night deposit, and safe deposit services. The company operates 238 branches in New Jersey, New York, Florida, and Alabama. Valley National Bancorp was founded in 1927 and is based in New York, New York."
VLYPP,2019-12-31,NA,456795000,NA,309793000,454807000,1070886000,0,553016000,NA,147002000,1070886000,517870000,0,-96221000,NA,309793000,297105000,63063000,income_statement,Banks—Regional,Valley National Bancorp - 6.25%,"Valley National Bancorp operates as the holding company for the Valley National Bank that provides commercial, retail, insurance, and wealth management financial services. The company operates through Commercial Lending, Consumer Lending, and Investment Management segments. Its deposit products include non-interest bearing, savings, NOW, and money market accounts, as well as certificates of deposit. The company offers various loan products comprising residential mortgage loans, automobile loans, secured personal lines of credit, and home equity loans; and floating rate and adjustable rate commercial and industrial loans, as well as fixed rate owner occupied and commercial real estate loans. It also invests in securities and interest-bearing deposits with other banks; and offers international banking services, such as standby letters of credit, documentary letters of credit and related products, and other ancillary services, such as foreign exchange transactions, documentary collections, foreign wire transfers, and transaction accounts for non-resident aliens. In addition, the company provides asset management advisory, trust, and asset-based lending support services; property and casualty, life, health, and title insurance agency services; and health care equipment lending and other commercial equipment leasing services, as well as real estate related investments. Further, it offers other banking services comprising automated teller machine, telephone and Internet banking, remote deposit capturing, overdraft, drive-in and night deposit, and safe deposit services. The company operates 238 branches in New Jersey, New York, Florida, and Alabama. Valley National Bancorp was founded in 1927 and is based in New York, New York."
VLYPP,2020-12-31,NA,530066000,NA,390606000,503236000,1162879000,0,587768000,NA,139460000,1162879000,575111000,0,-57702000,NA,390606000,377918000,71875000,income_statement,Banks—Regional,Valley National Bancorp - 6.25%,"Valley National Bancorp operates as the holding company for the Valley National Bank that provides commercial, retail, insurance, and wealth management financial services. The company operates through Commercial Lending, Consumer Lending, and Investment Management segments. Its deposit products include non-interest bearing, savings, NOW, and money market accounts, as well as certificates of deposit. The company offers various loan products comprising residential mortgage loans, automobile loans, secured personal lines of credit, and home equity loans; and floating rate and adjustable rate commercial and industrial loans, as well as fixed rate owner occupied and commercial real estate loans. It also invests in securities and interest-bearing deposits with other banks; and offers international banking services, such as standby letters of credit, documentary letters of credit and related products, and other ancillary services, such as foreign exchange transactions, documentary collections, foreign wire transfers, and transaction accounts for non-resident aliens. In addition, the company provides asset management advisory, trust, and asset-based lending support services; property and casualty, life, health, and title insurance agency services; and health care equipment lending and other commercial equipment leasing services, as well as real estate related investments. Further, it offers other banking services comprising automated teller machine, telephone and Internet banking, remote deposit capturing, overdraft, drive-in and night deposit, and safe deposit services. The company operates 238 branches in New Jersey, New York, Florida, and Alabama. Valley National Bancorp was founded in 1927 and is based in New York, New York."
VMAR,2018-08-31,NA,-34115,NA,-185848,507350,501727,-6123,-6123,-39951,151733,1271566,1277689,769839,-27992,NA,-185848,-185848,NA,income_statement,Leisure,Vision Marine Technologies Inc.,"Vision Marine Technologies Inc., doing business as Canadian Electric Boat Company, designs, manufactures, rents, and sells electric powerboats in Canada. It offers powerboats to commercial and retail customers, as well as the operators of rental fleets. The company also designs, manufactures, and sells electric outboard powertrain systems and its related technologies to original equipment manufacturers. It also sells its products online. The company was formerly known as The Canadian Electric Boat Company. Vision Marine Technologies Inc. was founded in 1995 and is headquartered in Boisbriand, Canada."
VMAR,2019-08-31,NA,297453,NA,233066,946422,1285364,333700,333700,-34457,64387,2869377,2535677,1584013,-36247,NA,233066,233066,NA,income_statement,Leisure,Vision Marine Technologies Inc.,"Vision Marine Technologies Inc., doing business as Canadian Electric Boat Company, designs, manufactures, rents, and sells electric powerboats in Canada. It offers powerboats to commercial and retail customers, as well as the operators of rental fleets. The company also designs, manufactures, and sells electric outboard powertrain systems and its related technologies to original equipment manufacturers. It also sells its products online. The company was formerly known as The Canadian Electric Boat Company. Vision Marine Technologies Inc. was founded in 1995 and is headquartered in Boisbriand, Canada."
VMAR,2020-08-31,NA,-2254223,NA,-2275532,1420705,604390,-2155823,-2155823,-107105,21309,2417173,4572996,1812783,-98400,NA,-2275532,-2275532,NA,income_statement,Leisure,Vision Marine Technologies Inc.,"Vision Marine Technologies Inc., doing business as Canadian Electric Boat Company, designs, manufactures, rents, and sells electric powerboats in Canada. It offers powerboats to commercial and retail customers, as well as the operators of rental fleets. The company also designs, manufactures, and sells electric outboard powertrain systems and its related technologies to original equipment manufacturers. It also sells its products online. The company was formerly known as The Canadian Electric Boat Company. Vision Marine Technologies Inc. was founded in 1995 and is headquartered in Boisbriand, Canada."
VMC,2017-12-31,NA,361316000,NA,601185000,327887000,993513000,643802000,643802000,-295522000,-232075000,3890296000,3246494000,2896783000,-282486000,7794000,593391000,601185000,21824000,income_statement,NA,NA,NA
VMC,2018-12-31,NA,623290000,NA,515805000,339277000,1100945000,756763000,756763000,-137977000,105449000,4382869000,3626106000,3281924000,-133473000,-2036000,517841000,515805000,4905000,income_statement,NA,NA,NA
VMC,2019-12-31,NA,757701000,NA,617662000,372093000,1255901000,872461000,872461000,-130155000,135198000,4929103000,4056642000,3673202000,-114760000,-4841000,622503000,617662000,11347000,income_statement,NA,NA,NA
VMC,2020-12-31,NA,743798000,NA,584480000,359772000,1281481000,891734000,891734000,-134393000,155803000,4856826000,3965092000,3575345000,-147936000,-3515000,587995000,584480000,29975000,income_statement,NA,NA,NA
VMD,2016-12-31,848000,109000,NA,1228000,18144000,18859000,383000,383000,-323000,-1119000,31356000,30973000,12497000,-274000,NA,1228000,1228000,71000,income_statement,Medical Devices,"Viemed Healthcare, Inc.","Viemed Healthcare, Inc., through its subsidiaries, provides in-home durable medical equipment and health care solutions to patients in the United States. The company offers respiratory services and related equipment, including non-invasive ventilators; bi-level, continuous, and automatic continuous positive airway pressure (PAP) machines; and oxygen units, as well as services of respiratory therapists; and respiratory disease management, neuromuscular care, and oxygen therapy services. It also provides in-home sleep apnea testing services to determine the existence of sleep apnea at home. In addition, the company leases non-invasive and invasive ventilators, PAP machines, percussion vests, oxygen concentrator units, and respiratory equipment, as well as sells medical equipment and/or patient medical services. Further, it provides therapy and counseling to patients in their homes using its technology. The company was founded in 2006 and is headquartered in Lafayette, Louisiana."
VMD,2017-12-31,848000,8191000,NA,8176000,24561000,34615000,8824000,8824000,-272000,15000,46928000,38104000,12313000,-633000,NA,8176000,8176000,71000,income_statement,Medical Devices,"Viemed Healthcare, Inc.","Viemed Healthcare, Inc., through its subsidiaries, provides in-home durable medical equipment and health care solutions to patients in the United States. The company offers respiratory services and related equipment, including non-invasive ventilators; bi-level, continuous, and automatic continuous positive airway pressure (PAP) machines; and oxygen units, as well as services of respiratory therapists; and respiratory disease management, neuromuscular care, and oxygen therapy services. It also provides in-home sleep apnea testing services to determine the existence of sleep apnea at home. In addition, the company leases non-invasive and invasive ventilators, PAP machines, percussion vests, oxygen concentrator units, and respiratory equipment, as well as sells medical equipment and/or patient medical services. Further, it provides therapy and counseling to patients in their homes using its technology. The company was founded in 2006 and is headquartered in Lafayette, Louisiana."
VMD,2018-12-31,848000,9670000,NA,9508000,34304000,47775000,10110000,10110000,-181000,162000,64464000,54354000,16689000,-440000,NA,9508000,9508000,71000,income_statement,Medical Devices,"Viemed Healthcare, Inc.","Viemed Healthcare, Inc., through its subsidiaries, provides in-home durable medical equipment and health care solutions to patients in the United States. The company offers respiratory services and related equipment, including non-invasive ventilators; bi-level, continuous, and automatic continuous positive airway pressure (PAP) machines; and oxygen units, as well as services of respiratory therapists; and respiratory disease management, neuromuscular care, and oxygen therapy services. It also provides in-home sleep apnea testing services to determine the existence of sleep apnea at home. In addition, the company leases non-invasive and invasive ventilators, PAP machines, percussion vests, oxygen concentrator units, and respiratory equipment, as well as sells medical equipment and/or patient medical services. Further, it provides therapy and counseling to patients in their homes using its technology. The company was founded in 2006 and is headquartered in Lafayette, Louisiana."
VMD,2019-12-31,848000,8796000,NA,8525000,41381000,56006000,9107000,9107000,-314000,271000,80256000,71149000,24250000,-311000,NA,8525000,8525000,113000,income_statement,Medical Devices,"Viemed Healthcare, Inc.","Viemed Healthcare, Inc., through its subsidiaries, provides in-home durable medical equipment and health care solutions to patients in the United States. The company offers respiratory services and related equipment, including non-invasive ventilators; bi-level, continuous, and automatic continuous positive airway pressure (PAP) machines; and oxygen units, as well as services of respiratory therapists; and respiratory disease management, neuromuscular care, and oxygen therapy services. It also provides in-home sleep apnea testing services to determine the existence of sleep apnea at home. In addition, the company leases non-invasive and invasive ventilators, PAP machines, percussion vests, oxygen concentrator units, and respiratory equipment, as well as sells medical equipment and/or patient medical services. Further, it provides therapy and counseling to patients in their homes using its technology. The company was founded in 2006 and is headquartered in Lafayette, Louisiana."
VNDA,2017-12-31,38547000,-15431000,NA,-15567000,123841000,147235000,-16903000,-16903000,NA,136000,165083000,181986000,17848000,1472000,NA,-15567000,-15567000,NA,income_statement,Biotechnology,Vanda Pharmaceuticals Inc.,"Vanda Pharmaceuticals Inc., a biopharmaceutical company, focuses on the development and commercialization of therapies to address high unmet medical needs. The company's marketed products include HETLIOZ for the treatment of non-24-hour sleep-wake disorders; and Fanapt oral tablets for the treatment of schizophrenia. Its products under development include HETLIOZ (tasimelteon) for the treatment of jet lag disorder, smith-magenis syndrome, pediatric Non-24, autism spectrum, and delayed sleep phase disorder; Fanapt (iloperidone) for the treatment of bipolar disorder and a long acting injectable formulation program for the treatment of schizophrenia; and Tradipitant (VLY-686), a small molecule neurokinin-1 receptor (NK-1R) antagonist, for the treatment of atopic dermatitis, gastroparesis, and motion sickness. The company's products under development also comprise VTR-297, a small molecule histone deacetylase inhibitor for the treatment of hematologic malignancies and with potential use as a treatment for various oncology indications; VQW-765, a small molecule nicotinic acetylcholine receptor partial agonist for the treatment of psychiatric disorders; and a portfolio of cystic fibrosis transmembrane conductance regulator activators and inhibitors for the treatment of dry eye and ocular inflammation, as well as BPO-27 for the treatment of secretory diarrhea disorders, including cholera. It markets its products in the United States, Europe, and Israel. Vanda Pharmaceuticals Inc. was incorporated in 2002 and is headquartered in Washington, the District of Columbia."
VNDA,2018-12-31,43594000,25346000,NA,25208000,105751000,172610000,21738000,21738000,NA,138000,193118000,171380000,20508000,3608000,NA,25208000,25208000,NA,income_statement,Biotechnology,Vanda Pharmaceuticals Inc.,"Vanda Pharmaceuticals Inc., a biopharmaceutical company, focuses on the development and commercialization of therapies to address high unmet medical needs. The company's marketed products include HETLIOZ for the treatment of non-24-hour sleep-wake disorders; and Fanapt oral tablets for the treatment of schizophrenia. Its products under development include HETLIOZ (tasimelteon) for the treatment of jet lag disorder, smith-magenis syndrome, pediatric Non-24, autism spectrum, and delayed sleep phase disorder; Fanapt (iloperidone) for the treatment of bipolar disorder and a long acting injectable formulation program for the treatment of schizophrenia; and Tradipitant (VLY-686), a small molecule neurokinin-1 receptor (NK-1R) antagonist, for the treatment of atopic dermatitis, gastroparesis, and motion sickness. The company's products under development also comprise VTR-297, a small molecule histone deacetylase inhibitor for the treatment of hematologic malignancies and with potential use as a treatment for various oncology indications; VQW-765, a small molecule nicotinic acetylcholine receptor partial agonist for the treatment of psychiatric disorders; and a portfolio of cystic fibrosis transmembrane conductance regulator activators and inhibitors for the treatment of dry eye and ocular inflammation, as well as BPO-27 for the treatment of secretory diarrhea disorders, including cholera. It markets its products in the United States, Europe, and Israel. Vanda Pharmaceuticals Inc. was incorporated in 2002 and is headquartered in Washington, the District of Columbia."
VNDA,2019-12-31,48649000,29028000,NA,115553000,129736000,202700000,22810000,22810000,NA,-86525000,227188000,204378000,24488000,6218000,NA,115553000,115553000,NA,income_statement,Biotechnology,Vanda Pharmaceuticals Inc.,"Vanda Pharmaceuticals Inc., a biopharmaceutical company, focuses on the development and commercialization of therapies to address high unmet medical needs. The company's marketed products include HETLIOZ for the treatment of non-24-hour sleep-wake disorders; and Fanapt oral tablets for the treatment of schizophrenia. Its products under development include HETLIOZ (tasimelteon) for the treatment of jet lag disorder, smith-magenis syndrome, pediatric Non-24, autism spectrum, and delayed sleep phase disorder; Fanapt (iloperidone) for the treatment of bipolar disorder and a long acting injectable formulation program for the treatment of schizophrenia; and Tradipitant (VLY-686), a small molecule neurokinin-1 receptor (NK-1R) antagonist, for the treatment of atopic dermatitis, gastroparesis, and motion sickness. The company's products under development also comprise VTR-297, a small molecule histone deacetylase inhibitor for the treatment of hematologic malignancies and with potential use as a treatment for various oncology indications; VQW-765, a small molecule nicotinic acetylcholine receptor partial agonist for the treatment of psychiatric disorders; and a portfolio of cystic fibrosis transmembrane conductance regulator activators and inhibitors for the treatment of dry eye and ocular inflammation, as well as BPO-27 for the treatment of secretory diarrhea disorders, including cholera. It markets its products in the United States, Europe, and Israel. Vanda Pharmaceuticals Inc. was incorporated in 2002 and is headquartered in Washington, the District of Columbia."
VNDA,2020-12-31,55577000,31655000,NA,23337000,140510000,224804000,27239000,27239000,NA,8318000,248168000,220929000,23364000,4416000,NA,23337000,23337000,NA,income_statement,Biotechnology,Vanda Pharmaceuticals Inc.,"Vanda Pharmaceuticals Inc., a biopharmaceutical company, focuses on the development and commercialization of therapies to address high unmet medical needs. The company's marketed products include HETLIOZ for the treatment of non-24-hour sleep-wake disorders; and Fanapt oral tablets for the treatment of schizophrenia. Its products under development include HETLIOZ (tasimelteon) for the treatment of jet lag disorder, smith-magenis syndrome, pediatric Non-24, autism spectrum, and delayed sleep phase disorder; Fanapt (iloperidone) for the treatment of bipolar disorder and a long acting injectable formulation program for the treatment of schizophrenia; and Tradipitant (VLY-686), a small molecule neurokinin-1 receptor (NK-1R) antagonist, for the treatment of atopic dermatitis, gastroparesis, and motion sickness. The company's products under development also comprise VTR-297, a small molecule histone deacetylase inhibitor for the treatment of hematologic malignancies and with potential use as a treatment for various oncology indications; VQW-765, a small molecule nicotinic acetylcholine receptor partial agonist for the treatment of psychiatric disorders; and a portfolio of cystic fibrosis transmembrane conductance regulator activators and inhibitors for the treatment of dry eye and ocular inflammation, as well as BPO-27 for the treatment of secretory diarrhea disorders, including cholera. It markets its products in the United States, Europe, and Israel. Vanda Pharmaceuticals Inc. was incorporated in 2002 and is headquartered in Washington, the District of Columbia."
VNET,2016-12-31,149337000,-943082000,725802000,-633598000,992574000,712136000,-540556000,-540556000,-198589000,-11160000,3641774000,4182330000,2929638000,-402526000,NA,-931922000,-844082000,-6783000,income_statement,Information Technology Services,"21Vianet Group, Inc.","21Vianet Group, Inc. provides carrier and cloud-neutral Internet data center services to Internet companies, government entities, blue-chip enterprises, and small-to mid-sized enterprises in the People's Republic of China. The company operates in two segments, Hosting and Related Services, and Managed Network Services. It offers hosting and related services to house servers and networking equipment in its data centers, and connects them through a data transmission network. The company's hosting and related services include managed hosting services that offer data center space to house its customers' servers and networking equipment, and provide tailored server administration services; and interconnectivity services that enable customers to connect their servers with Internet backbones and other networks through its border gateway protocol network or single-line, dual-line, or multiple-line network. Its hosting and related services also comprise cloud services that enable businesses to run their applications over the Internet using its IT infrastructure; virtual private network services; Hybrid IT Services, which provide customers with a complete package of infrastructure service offerings; and other value-added services, such as firewall, server load balancing, data backup and recovery, data center management, server management, and backup server services. In addition, the company provides traffic charts and analysis, gateway monitoring for servers, domain name system setup, defense mechanism against distributed denial of service attacks, basic setting of switches and routers, and virus protections; and managed network service. As of December 31, 2019, it operated 26 self-built and 51 partnered data centers located in approximately 20 cities with 36,291 cabinets. It has a strategic partnership with Microsoft Corporation. 21Vianet Group, Inc. was founded in 1999 and is headquartered in Beijing, the People's Republic of China."
VNET,2017-12-31,149143000,-1007814000,151471000,-772730000,776632000,758410000,-199353000,-199353000,-185313000,-90170000,3392705000,3592058000,2634295000,-808461000,NA,-917644000,-914626000,-5439000,income_statement,Information Technology Services,"21Vianet Group, Inc.","21Vianet Group, Inc. provides carrier and cloud-neutral Internet data center services to Internet companies, government entities, blue-chip enterprises, and small-to mid-sized enterprises in the People's Republic of China. The company operates in two segments, Hosting and Related Services, and Managed Network Services. It offers hosting and related services to house servers and networking equipment in its data centers, and connects them through a data transmission network. The company's hosting and related services include managed hosting services that offer data center space to house its customers' servers and networking equipment, and provide tailored server administration services; and interconnectivity services that enable customers to connect their servers with Internet backbones and other networks through its border gateway protocol network or single-line, dual-line, or multiple-line network. Its hosting and related services also comprise cloud services that enable businesses to run their applications over the Internet using its IT infrastructure; virtual private network services; Hybrid IT Services, which provide customers with a complete package of infrastructure service offerings; and other value-added services, such as firewall, server load balancing, data backup and recovery, data center management, server management, and backup server services. In addition, the company provides traffic charts and analysis, gateway monitoring for servers, domain name system setup, defense mechanism against distributed denial of service attacks, basic setting of switches and routers, and virus protections; and managed network service. As of December 31, 2019, it operated 26 self-built and 51 partnered data centers located in approximately 20 cities with 36,291 cabinets. It has a strategic partnership with Microsoft Corporation. 21Vianet Group, Inc. was founded in 1999 and is headquartered in Beijing, the People's Republic of China."
VNET,2018-12-31,92109000,-162325000,268977000,-205065000,634813000,944871000,223574000,223574000,-236066000,24411000,3401037000,3177463000,2456166000,-385899000,NA,-186736000,-205065000,-5027000,income_statement,Information Technology Services,"21Vianet Group, Inc.","21Vianet Group, Inc. provides carrier and cloud-neutral Internet data center services to Internet companies, government entities, blue-chip enterprises, and small-to mid-sized enterprises in the People's Republic of China. The company operates in two segments, Hosting and Related Services, and Managed Network Services. It offers hosting and related services to house servers and networking equipment in its data centers, and connects them through a data transmission network. The company's hosting and related services include managed hosting services that offer data center space to house its customers' servers and networking equipment, and provide tailored server administration services; and interconnectivity services that enable customers to connect their servers with Internet backbones and other networks through its border gateway protocol network or single-line, dual-line, or multiple-line network. Its hosting and related services also comprise cloud services that enable businesses to run their applications over the Internet using its IT infrastructure; virtual private network services; Hybrid IT Services, which provide customers with a complete package of infrastructure service offerings; and other value-added services, such as firewall, server load balancing, data backup and recovery, data center management, server management, and backup server services. In addition, the company provides traffic charts and analysis, gateway monitoring for servers, domain name system setup, defense mechanism against distributed denial of service attacks, basic setting of switches and routers, and virus protections; and managed network service. As of December 31, 2019, it operated 26 self-built and 51 partnered data centers located in approximately 20 cities with 36,291 cabinets. It has a strategic partnership with Microsoft Corporation. 21Vianet Group, Inc. was founded in 1999 and is headquartered in Beijing, the People's Republic of China."
VNET,2019-12-31,88792000,-175809000,278555000,-182292000,621586000,939449000,234376000,234376000,-345955000,5437000,3788967000,3554591000,2849518000,-410185000,NA,-181246000,-182292000,-6862000,income_statement,Information Technology Services,"21Vianet Group, Inc.","21Vianet Group, Inc. provides carrier and cloud-neutral Internet data center services to Internet companies, government entities, blue-chip enterprises, and small-to mid-sized enterprises in the People's Republic of China. The company operates in two segments, Hosting and Related Services, and Managed Network Services. It offers hosting and related services to house servers and networking equipment in its data centers, and connects them through a data transmission network. The company's hosting and related services include managed hosting services that offer data center space to house its customers' servers and networking equipment, and provide tailored server administration services; and interconnectivity services that enable customers to connect their servers with Internet backbones and other networks through its border gateway protocol network or single-line, dual-line, or multiple-line network. Its hosting and related services also comprise cloud services that enable businesses to run their applications over the Internet using its IT infrastructure; virtual private network services; Hybrid IT Services, which provide customers with a complete package of infrastructure service offerings; and other value-added services, such as firewall, server load balancing, data backup and recovery, data center management, server management, and backup server services. In addition, the company provides traffic charts and analysis, gateway monitoring for servers, domain name system setup, defense mechanism against distributed denial of service attacks, basic setting of switches and routers, and virus protections; and managed network service. As of December 31, 2019, it operated 26 self-built and 51 partnered data centers located in approximately 20 cities with 36,291 cabinets. It has a strategic partnership with Microsoft Corporation. 21Vianet Group, Inc. was founded in 1999 and is headquartered in Beijing, the People's Republic of China."
VNO,2017-12-31,NA,319731000,1654986000,227416000,150782000,1207632000,627461000,627461000,-345654000,42375000,2096004000,1468543000,888372000,-307730000,-13228000,277356000,161971000,NA,income_statement,NA,NA,NA
VNO,2018-12-31,NA,459598000,1426214000,449954000,141871000,1190071000,601630000,601630000,-347949000,37633000,2172869000,1571239000,982798000,-142032000,638000,421965000,384788000,NA,income_statement,NA,NA,NA
VNO,2019-12-31,NA,3437731000,1467863000,3147937000,169920000,1080971000,491944000,491944000,-264083000,103439000,2003565000,1511621000,922594000,2945787000,-30000,3334292000,3097497000,NA,income_statement,NA,NA,NA
VNO,2020-12-31,NA,-425215000,1021224000,-297005000,181509000,738885000,157681000,157681000,-229251000,36630000,1527951000,1370270000,789066000,-582896000,NA,-461845000,-348744000,NA,income_statement,NA,NA,NA
VNOM,2016-12-31,NA,-10899000,694940000,-10899000,5209000,73187000,38158000,38158000,-2455000,0,79146000,40988000,5959000,-49057000,NA,-10899000,-10899000,5382000,income_statement,Oil & Gas Midstream,Viper Energy Partners LP,"Viper Energy Partners LP owns, acquires, and exploits oil and natural gas properties in North America. As of December 31, 2019, it had mineral interests in 24,304 net royalty acres in the Permian Basin and Eagle Ford Shale with estimated proved oil and natural gas reserves of 88,946 thousand barrels of crude oil equivalent. Viper Energy Partners GP LLC operates as the general partner of the company. The company was founded in 2013 and is based in Midland, Texas. Viper Energy Partners LP operates as a subsidiary of Diamondback Energy, Inc."
VNOM,2017-12-31,NA,111478000,694940000,111478000,6296000,160636000,113821000,113821000,-3164000,0,172033000,58212000,11397000,-2343000,NA,111478000,111478000,5382000,income_statement,Oil & Gas Midstream,Viper Energy Partners LP,"Viper Energy Partners LP owns, acquires, and exploits oil and natural gas properties in North America. As of December 31, 2019, it had mineral interests in 24,304 net royalty acres in the Permian Basin and Eagle Ford Shale with estimated proved oil and natural gas reserves of 88,946 thousand barrels of crude oil equivalent. Viper Energy Partners GP LLC operates as the general partner of the company. The company was founded in 2013 and is based in Midland, Texas. Viper Energy Partners LP operates as a subsidiary of Diamondback Energy, Inc."
VNOM,2018-12-31,NA,190512000,694940000,143958000,7955000,275024000,202857000,202857000,-13849000,-72365000,275024000,72167000,0,-12345000,NA,262877000,143958000,5382000,income_statement,Oil & Gas Midstream,Viper Energy Partners LP,"Viper Energy Partners LP owns, acquires, and exploits oil and natural gas properties in North America. As of December 31, 2019, it had mineral interests in 24,304 net royalty acres in the Permian Basin and Eagle Ford Shale with estimated proved oil and natural gas reserves of 88,946 thousand barrels of crude oil equivalent. Viper Energy Partners GP LLC operates as the general partner of the company. The company was founded in 2013 and is based in Midland, Texas. Viper Energy Partners LP operates as a subsidiary of Diamondback Energy, Inc."
VNOM,2019-12-31,NA,179628000,1254285000,46281000,7489000,283574000,193185000,193185000,-21076000,-41582000,283574000,90389000,0,-13557000,NA,221210000,46281000,4722000,income_statement,Oil & Gas Midstream,Viper Energy Partners LP,"Viper Energy Partners LP owns, acquires, and exploits oil and natural gas properties in North America. As of December 31, 2019, it had mineral interests in 24,304 net royalty acres in the Permian Basin and Eagle Ford Shale with estimated proved oil and natural gas reserves of 88,946 thousand barrels of crude oil equivalent. Viper Energy Partners GP LLC operates as the general partner of the company. The company was founded in 2013 and is based in Midland, Texas. Viper Energy Partners LP operates as a subsidiary of Diamondback Energy, Inc."
VNT,2017-12-31,126200000,523900000,3900000,373300000,440300000,1073100000,506600000,506600000,-10000000,150600000,2498200000,1991600000,1425100000,17300000,NA,373300000,373300000,NA,income_statement,NA,NA,NA
VNT,2018-12-31,136200000,507300000,3100000,385500000,497800000,1135500000,501500000,501500000,-10000000,121800000,2665900000,2164400000,1530400000,5800000,NA,385500000,385500000,NA,income_statement,NA,NA,NA
VNT,2019-12-31,136400000,565800000,4900000,436500000,487600000,1192800000,568800000,568800000,-10000000,129300000,2772100000,2203300000,1579300000,-3000000,NA,436500000,436500000,NA,income_statement,NA,NA,NA
VNT,2020-12-31,126200000,460300000,NA,342000000,508400000,1188100000,553500000,553500000,-10000000,118300000,2704600000,2151100000,1516500000,-93200000,NA,342000000,342000000,NA,income_statement,NA,NA,NA
VOD,2017-03-31,NA,2792000000,1519000000,-6297000000,9840000000,13055000000,3119000000,3119000000,-1644000000,4764000000,47631000000,44512000000,34576000000,-327000000,-4107000000,-1972000000,-6297000000,96000000,income_statement,Telecom Services,Vodafone Group Plc,"Vodafone Group Plc engages in telecommunication services in Europe and internationally. The company offers mobile services that enable customers to call, text, and access data; fixed line services, including broadband, television (TV) offerings, and voice; and convergence services under the GigaKombi and Vodafone One names to customers. It also provides mobile, fixed, and a suite of converged communication services, such as Internet of Things (IoT) comprising managed IoT connectivity, automotive, and insurance services, as well as smart metering and health solutions; cloud and security portfolio comprising public and private cloud services, as well as cloud-based applications and products for securing networks and devices; and international voice, IP transit, and messaging services to support business customers that include small home offices and large multi-national companies. In addition, the company offers M-Pesa, an African payment platform, which provides money transfer, financial, and business and merchant payment services; and various services to operators through its partner market agreements, as well as rents capacity to mobile virtual network operators to provide mobile services. Vodafone Group Plc has strategic partnerships with Open Fiber; and Mobile TeleSystems PJSC. As of March 31, 2019, it had approximately 650 million mobile customers, 19 million fixed broadband customers, and 14 million TV customers. The company was founded in 1984 and is headquartered in Newbury, the United Kingdom."
VOD,2018-03-31,NA,3878000000,967000000,2439000000,9127000000,13800000000,4741000000,4741000000,-1148000000,-879000000,46571000000,41830000000,32771000000,-863000000,-1969000000,4757000000,2439000000,-68000000,income_statement,Telecom Services,Vodafone Group Plc,"Vodafone Group Plc engages in telecommunication services in Europe and internationally. The company offers mobile services that enable customers to call, text, and access data; fixed line services, including broadband, television (TV) offerings, and voice; and convergence services under the GigaKombi and Vodafone One names to customers. It also provides mobile, fixed, and a suite of converged communication services, such as Internet of Things (IoT) comprising managed IoT connectivity, automotive, and insurance services, as well as smart metering and health solutions; cloud and security portfolio comprising public and private cloud services, as well as cloud-based applications and products for securing networks and devices; and international voice, IP transit, and messaging services to support business customers that include small home offices and large multi-national companies. In addition, the company offers M-Pesa, an African payment platform, which provides money transfer, financial, and business and merchant payment services; and various services to operators through its partner market agreements, as well as rents capacity to mobile virtual network operators to provide mobile services. Vodafone Group Plc has strategic partnerships with Open Fiber; and Mobile TeleSystems PJSC. As of March 31, 2019, it had approximately 650 million mobile customers, 19 million fixed broadband customers, and 14 million TV customers. The company was founded in 1984 and is headquartered in Newbury, the United Kingdom."
VOD,2019-03-31,NA,-2613000000,1227000000,-8020000000,9301000000,13506000000,4058000000,4058000000,-1506000000,1496000000,43666000000,39608000000,30160000000,-6671000000,-3535000000,-4109000000,-8020000000,147000000,income_statement,Telecom Services,Vodafone Group Plc,"Vodafone Group Plc engages in telecommunication services in Europe and internationally. The company offers mobile services that enable customers to call, text, and access data; fixed line services, including broadband, television (TV) offerings, and voice; and convergence services under the GigaKombi and Vodafone One names to customers. It also provides mobile, fixed, and a suite of converged communication services, such as Internet of Things (IoT) comprising managed IoT connectivity, automotive, and insurance services, as well as smart metering and health solutions; cloud and security portfolio comprising public and private cloud services, as well as cloud-based applications and products for securing networks and devices; and international voice, IP transit, and messaging services to support business customers that include small home offices and large multi-national companies. In addition, the company offers M-Pesa, an African payment platform, which provides money transfer, financial, and business and merchant payment services; and various services to operators through its partner market agreements, as well as rents capacity to mobile virtual network operators to provide mobile services. Vodafone Group Plc has strategic partnerships with Open Fiber; and Mobile TeleSystems PJSC. As of March 31, 2019, it had approximately 650 million mobile customers, 19 million fixed broadband customers, and 14 million TV customers. The company was founded in 1984 and is headquartered in Newbury, the United Kingdom."
VOD,2020-03-31,NA,795000000,1215000000,-920000000,9624000000,14292000000,4330000000,4330000000,-2223000000,1250000000,44974000000,40644000000,30682000000,-3535000000,NA,-455000000,-920000000,338000000,income_statement,Telecom Services,Vodafone Group Plc,"Vodafone Group Plc engages in telecommunication services in Europe and internationally. The company offers mobile services that enable customers to call, text, and access data; fixed line services, including broadband, television (TV) offerings, and voice; and convergence services under the GigaKombi and Vodafone One names to customers. It also provides mobile, fixed, and a suite of converged communication services, such as Internet of Things (IoT) comprising managed IoT connectivity, automotive, and insurance services, as well as smart metering and health solutions; cloud and security portfolio comprising public and private cloud services, as well as cloud-based applications and products for securing networks and devices; and international voice, IP transit, and messaging services to support business customers that include small home offices and large multi-national companies. In addition, the company offers M-Pesa, an African payment platform, which provides money transfer, financial, and business and merchant payment services; and various services to operators through its partner market agreements, as well as rents capacity to mobile virtual network operators to provide mobile services. Vodafone Group Plc has strategic partnerships with Open Fiber; and Mobile TeleSystems PJSC. As of March 31, 2019, it had approximately 650 million mobile customers, 19 million fixed broadband customers, and 14 million TV customers. The company was founded in 1984 and is headquartered in Newbury, the United Kingdom."
VOR,2018-12-31,2433000,-4152000,NA,-4152000,427000,0,-2860000,-2860000,-1003000,0,0,2860000,0,-1292000,NA,-4152000,-4152000,NA,income_statement,Biotechnology,Vor Biopharma Inc.,"Vor Biopharma, Inc. develops engineered hematopoietic stem cell (eHSC) therapies for cancer patients. It offers VOR33, an eHSC product candidate that is in preclinical development to treat acute myeloid leukemia (AML). The company's VOR33 eHSCs lacks CD33, a protein that is expressed by AML cancer cells. Vor Biopharma, Inc. was incorporated in 2015 and is based in Cambridge, Massachusetts."
VOR,2019-12-31,6200000,-10839000,NA,-10839000,4217000,0,-10417000,-10417000,-608000,0,0,10417000,0,-422000,NA,-10839000,-12612000,NA,income_statement,Biotechnology,Vor Biopharma Inc.,"Vor Biopharma, Inc. develops engineered hematopoietic stem cell (eHSC) therapies for cancer patients. It offers VOR33, an eHSC product candidate that is in preclinical development to treat acute myeloid leukemia (AML). The company's VOR33 eHSCs lacks CD33, a protein that is expressed by AML cancer cells. Vor Biopharma, Inc. was incorporated in 2015 and is based in Cambridge, Massachusetts."
VOXX,2017-02-28,29517000,-8930000,1310000,4422000,122681000,144030000,-8168000,-8168000,-7105000,338000,514530000,522698000,370500000,-762000,6066000,-9268000,4422000,NA,income_statement,Consumer Electronics,VOXX International Corporation,"VOXX International Corporation, together with its subsidiaries, designs, manufactures, and distributes automotive electronics, consumer electronics, and biometric products in the United States, Europe, and internationally. Its Automotive Electronics segment offers mobile multi-media infotainment and autosound products; satellite radios; smart phone telematics applications; automotive security, vehicle access, and remote start systems; automotive power accessories; rear observation and collision avoidance systems; driver distraction products; power lift gates; turn signal switches; automotive lighting products; automotive sensing and camera systems; USB ports; cruise control systems; and heated seats. The company's Consumer Electronics segment provides speakers; home theater, business music, and streaming music systems; on-ear and in-ear headphones; wired and wireless headphones and ear buds; Bluetooth headphones and ear buds; soundbars and sound bases; digital living network alliance compatible devices; high-definition television and wireless fidelity antennas; high-definition multimedia interface accessories; karaoke and infant/nursery products; activity tracking bands; healthcare wearables; home electronic accessories; other connectivity products; power cords; performance enhancing electronics; TV universal remotes; flat panel TV mounting systems; power supply systems and charging products; electronic equipment cleaning products; personal sound amplifiers; set-top boxes; home and portable stereos; and digital multi-media products. Its Biometrics segment offers iris identification and biometric security related products. The company was formerly known as Audiovox Corporation and changed its name to VOXX International Corporation in December 2011. VOXX International Corporation was founded in 1960 and is headquartered in Orlando, Florida."
VOXX,2018-02-28,26440000,-24104000,-5830000,35304000,124956000,132297000,-19099000,-19099000,-6009000,-17445000,507092000,526191000,374795000,-5005000,34618000,-6659000,35304000,NA,income_statement,Consumer Electronics,VOXX International Corporation,"VOXX International Corporation, together with its subsidiaries, designs, manufactures, and distributes automotive electronics, consumer electronics, and biometric products in the United States, Europe, and internationally. Its Automotive Electronics segment offers mobile multi-media infotainment and autosound products; satellite radios; smart phone telematics applications; automotive security, vehicle access, and remote start systems; automotive power accessories; rear observation and collision avoidance systems; driver distraction products; power lift gates; turn signal switches; automotive lighting products; automotive sensing and camera systems; USB ports; cruise control systems; and heated seats. The company's Consumer Electronics segment provides speakers; home theater, business music, and streaming music systems; on-ear and in-ear headphones; wired and wireless headphones and ear buds; Bluetooth headphones and ear buds; soundbars and sound bases; digital living network alliance compatible devices; high-definition television and wireless fidelity antennas; high-definition multimedia interface accessories; karaoke and infant/nursery products; activity tracking bands; healthcare wearables; home electronic accessories; other connectivity products; power cords; performance enhancing electronics; TV universal remotes; flat panel TV mounting systems; power supply systems and charging products; electronic equipment cleaning products; personal sound amplifiers; set-top boxes; home and portable stereos; and digital multi-media products. Its Biometrics segment offers iris identification and biometric security related products. The company was formerly known as Audiovox Corporation and changed its name to VOXX International Corporation in December 2011. VOXX International Corporation was founded in 1960 and is headquartered in Orlando, Florida."
VOXX,2019-02-28,24387000,-58963000,-12571000,-46091000,110850000,121417000,-13820000,-13820000,-4449000,-6131000,446816000,460636000,325399000,-45143000,NA,-52832000,-46091000,NA,income_statement,Consumer Electronics,VOXX International Corporation,"VOXX International Corporation, together with its subsidiaries, designs, manufactures, and distributes automotive electronics, consumer electronics, and biometric products in the United States, Europe, and internationally. Its Automotive Electronics segment offers mobile multi-media infotainment and autosound products; satellite radios; smart phone telematics applications; automotive security, vehicle access, and remote start systems; automotive power accessories; rear observation and collision avoidance systems; driver distraction products; power lift gates; turn signal switches; automotive lighting products; automotive sensing and camera systems; USB ports; cruise control systems; and heated seats. The company's Consumer Electronics segment provides speakers; home theater, business music, and streaming music systems; on-ear and in-ear headphones; wired and wireless headphones and ear buds; Bluetooth headphones and ear buds; soundbars and sound bases; digital living network alliance compatible devices; high-definition television and wireless fidelity antennas; high-definition multimedia interface accessories; karaoke and infant/nursery products; activity tracking bands; healthcare wearables; home electronic accessories; other connectivity products; power cords; performance enhancing electronics; TV universal remotes; flat panel TV mounting systems; power supply systems and charging products; electronic equipment cleaning products; personal sound amplifiers; set-top boxes; home and portable stereos; and digital multi-media products. Its Biometrics segment offers iris identification and biometric security related products. The company was formerly known as Audiovox Corporation and changed its name to VOXX International Corporation in December 2011. VOXX International Corporation was founded in 1960 and is headquartered in Orlando, Florida."
VOXX,2020-02-29,21602000,-40940000,-27950000,-26443000,107399000,109776000,-19225000,-19225000,-3569000,882000,394889000,414114000,285113000,-21715000,NA,-41822000,-26443000,NA,income_statement,Consumer Electronics,VOXX International Corporation,"VOXX International Corporation, together with its subsidiaries, designs, manufactures, and distributes automotive electronics, consumer electronics, and biometric products in the United States, Europe, and internationally. Its Automotive Electronics segment offers mobile multi-media infotainment and autosound products; satellite radios; smart phone telematics applications; automotive security, vehicle access, and remote start systems; automotive power accessories; rear observation and collision avoidance systems; driver distraction products; power lift gates; turn signal switches; automotive lighting products; automotive sensing and camera systems; USB ports; cruise control systems; and heated seats. The company's Consumer Electronics segment provides speakers; home theater, business music, and streaming music systems; on-ear and in-ear headphones; wired and wireless headphones and ear buds; Bluetooth headphones and ear buds; soundbars and sound bases; digital living network alliance compatible devices; high-definition television and wireless fidelity antennas; high-definition multimedia interface accessories; karaoke and infant/nursery products; activity tracking bands; healthcare wearables; home electronic accessories; other connectivity products; power cords; performance enhancing electronics; TV universal remotes; flat panel TV mounting systems; power supply systems and charging products; electronic equipment cleaning products; personal sound amplifiers; set-top boxes; home and portable stereos; and digital multi-media products. Its Biometrics segment offers iris identification and biometric security related products. The company was formerly known as Audiovox Corporation and changed its name to VOXX International Corporation in December 2011. VOXX International Corporation was founded in 1960 and is headquartered in Orlando, Florida."
VRA,2017-01-28,NA,28042000,30049000,19758000,235496000,276046000,41879000,41879000,-178000,8284000,485937000,444058000,209891000,-13837000,NA,19758000,19758000,-1329000,income_statement,Footwear & Accessories,"Vera Bradley, Inc.","Vera Bradley, Inc., together with its subsidiaries, designs, manufactures, and sells women's handbags, luggage and travel items, fashion and home accessories, and gifts. It operates through three segments: Vera Bradley Direct, Vera Bradley Indirect, and Pura Vida. The company offers bag products, such as totes, crossbodies, satchels, clutches, backpacks, baby bags, and lunch bags; accessories, including wallets, wristlets, eyeglass cases, scarves, and various technology accessories; bracelets, rings, and necklaces under Pura Vida brand name; and travel products consisting of rolling luggage, cosmetics, and travel and packing accessories, as well as travel bags comprising duffel and weekend bags. It also provides home products that include throw blankets, beach towels, and comforters, as well as items, such as mugs and tumblers; and other products, including apparel/footwear, stationery, and merchandising products, as well as freight, licensing, and gift card breakage services. The company sells its Vera Bradley branded products through its full-line and factory outlet stores in the United States; and verabradley.com, an online outlet site, as well as its annual outlet sale in Fort Wayne, Indiana. As of February 1, 2020, it operated 88 full-line and 63 factory outlet stores. The company sells its Pura Vida branded products through wholesale retailers, as well as through Pura Vida websites, including www.puravidabracelets.com and www.puravidabracelets.eu. It also sells its Vera Bradley branded products to approximately 2,200 specialty retail locations, department stores, national accounts, third party e-commerce sites, and third-party inventory liquidators, as well as through licensing agreements. Vera Bradley, Inc. was founded in 1982 and is headquartered in Roanoke, Indiana."
VRA,2018-02-03,NA,15394000,30049000,7016000,221605000,255143000,34320000,34320000,NA,8378000,454648000,420328000,199505000,-18926000,NA,7016000,7016000,-782000,income_statement,Footwear & Accessories,"Vera Bradley, Inc.","Vera Bradley, Inc., together with its subsidiaries, designs, manufactures, and sells women's handbags, luggage and travel items, fashion and home accessories, and gifts. It operates through three segments: Vera Bradley Direct, Vera Bradley Indirect, and Pura Vida. The company offers bag products, such as totes, crossbodies, satchels, clutches, backpacks, baby bags, and lunch bags; accessories, including wallets, wristlets, eyeglass cases, scarves, and various technology accessories; bracelets, rings, and necklaces under Pura Vida brand name; and travel products consisting of rolling luggage, cosmetics, and travel and packing accessories, as well as travel bags comprising duffel and weekend bags. It also provides home products that include throw blankets, beach towels, and comforters, as well as items, such as mugs and tumblers; and other products, including apparel/footwear, stationery, and merchandising products, as well as freight, licensing, and gift card breakage services. The company sells its Vera Bradley branded products through its full-line and factory outlet stores in the United States; and verabradley.com, an online outlet site, as well as its annual outlet sale in Fort Wayne, Indiana. As of February 1, 2020, it operated 88 full-line and 63 factory outlet stores. The company sells its Pura Vida branded products through wholesale retailers, as well as through Pura Vida websites, including www.puravidabracelets.com and www.puravidabracelets.eu. It also sells its Vera Bradley branded products to approximately 2,200 specialty retail locations, department stores, national accounts, third party e-commerce sites, and third-party inventory liquidators, as well as through licensing agreements. Vera Bradley, Inc. was founded in 1982 and is headquartered in Roanoke, Indiana."
VRA,2019-02-02,NA,28226000,30049000,20757000,211840000,238587000,27245000,27245000,NA,7469000,416097000,388852000,177510000,981000,NA,20757000,20757000,-498000,income_statement,Footwear & Accessories,"Vera Bradley, Inc.","Vera Bradley, Inc., together with its subsidiaries, designs, manufactures, and sells women's handbags, luggage and travel items, fashion and home accessories, and gifts. It operates through three segments: Vera Bradley Direct, Vera Bradley Indirect, and Pura Vida. The company offers bag products, such as totes, crossbodies, satchels, clutches, backpacks, baby bags, and lunch bags; accessories, including wallets, wristlets, eyeglass cases, scarves, and various technology accessories; bracelets, rings, and necklaces under Pura Vida brand name; and travel products consisting of rolling luggage, cosmetics, and travel and packing accessories, as well as travel bags comprising duffel and weekend bags. It also provides home products that include throw blankets, beach towels, and comforters, as well as items, such as mugs and tumblers; and other products, including apparel/footwear, stationery, and merchandising products, as well as freight, licensing, and gift card breakage services. The company sells its Vera Bradley branded products through its full-line and factory outlet stores in the United States; and verabradley.com, an online outlet site, as well as its annual outlet sale in Fort Wayne, Indiana. As of February 1, 2020, it operated 88 full-line and 63 factory outlet stores. The company sells its Pura Vida branded products through wholesale retailers, as well as through Pura Vida websites, including www.puravidabracelets.com and www.puravidabracelets.eu. It also sells its Vera Bradley branded products to approximately 2,200 specialty retail locations, department stores, national accounts, third party e-commerce sites, and third-party inventory liquidators, as well as through licensing agreements. Vera Bradley, Inc. was founded in 1982 and is headquartered in Roanoke, Indiana."
VRA,2020-02-01,NA,20559000,30049000,16047000,249274000,280075000,31899000,31899000,NA,5315000,495212000,463313000,215137000,-11340000,NA,15244000,16047000,-1098000,income_statement,Footwear & Accessories,"Vera Bradley, Inc.","Vera Bradley, Inc., together with its subsidiaries, designs, manufactures, and sells women's handbags, luggage and travel items, fashion and home accessories, and gifts. It operates through three segments: Vera Bradley Direct, Vera Bradley Indirect, and Pura Vida. The company offers bag products, such as totes, crossbodies, satchels, clutches, backpacks, baby bags, and lunch bags; accessories, including wallets, wristlets, eyeglass cases, scarves, and various technology accessories; bracelets, rings, and necklaces under Pura Vida brand name; and travel products consisting of rolling luggage, cosmetics, and travel and packing accessories, as well as travel bags comprising duffel and weekend bags. It also provides home products that include throw blankets, beach towels, and comforters, as well as items, such as mugs and tumblers; and other products, including apparel/footwear, stationery, and merchandising products, as well as freight, licensing, and gift card breakage services. The company sells its Vera Bradley branded products through its full-line and factory outlet stores in the United States; and verabradley.com, an online outlet site, as well as its annual outlet sale in Fort Wayne, Indiana. As of February 1, 2020, it operated 88 full-line and 63 factory outlet stores. The company sells its Pura Vida branded products through wholesale retailers, as well as through Pura Vida websites, including www.puravidabracelets.com and www.puravidabracelets.eu. It also sells its Vera Bradley branded products to approximately 2,200 specialty retail locations, department stores, national accounts, third party e-commerce sites, and third-party inventory liquidators, as well as through licensing agreements. Vera Bradley, Inc. was founded in 1982 and is headquartered in Roanoke, Indiana."
VRAY,2016-12-31,11442000,-50636000,NA,-50636000,29104000,-3629000,-44175000,-44175000,-5951000,0,22237000,66412000,25866000,-6461000,NA,-50636000,-50636000,NA,income_statement,Medical Devices,"ViewRay, Inc.","ViewRay, Inc. designs, manufactures, and markets radiation therapy systems. The company offers MRIdian, a magnetic resonance image guided radiation therapy system to image and treat cancer patients. Its MRIdian integrates MRI technology, radiation delivery, and proprietary software to see the soft tissues, shape the dose to accommodate for changes in anatomy, and strike the target using real-time targeting throughout the treatment. The company serves university research and teaching hospitals, community hospitals, private practices, government institutions, and freestanding cancer centers. ViewRay, Inc. markets its MRIdian through a direct sales force and distribution network. It has operations in the United States, France, Germany, and internationally. The company was founded in 2004 and is headquartered in Oakwood, Ohio."
VRAY,2017-12-31,14709000,-72176000,NA,-72176000,39787000,6332000,-48164000,-48164000,-7247000,0,34042000,82206000,27710000,-24012000,NA,-72176000,-72176000,NA,income_statement,Medical Devices,"ViewRay, Inc.","ViewRay, Inc. designs, manufactures, and markets radiation therapy systems. The company offers MRIdian, a magnetic resonance image guided radiation therapy system to image and treat cancer patients. Its MRIdian integrates MRI technology, radiation delivery, and proprietary software to see the soft tissues, shape the dose to accommodate for changes in anatomy, and strike the target using real-time targeting throughout the treatment. The company serves university research and teaching hospitals, community hospitals, private practices, government institutions, and freestanding cancer centers. ViewRay, Inc. markets its MRIdian through a direct sales force and distribution network. It has operations in the United States, France, Germany, and internationally. The company was founded in 2004 and is headquartered in Oakwood, Ohio."
VRAY,2018-12-31,16520000,-76396000,NA,-76396000,65175000,6603000,-75092000,-75092000,-7701000,0,80962000,156054000,74359000,-1304000,NA,-76396000,-79124000,NA,income_statement,Medical Devices,"ViewRay, Inc.","ViewRay, Inc. designs, manufactures, and markets radiation therapy systems. The company offers MRIdian, a magnetic resonance image guided radiation therapy system to image and treat cancer patients. Its MRIdian integrates MRI technology, radiation delivery, and proprietary software to see the soft tissues, shape the dose to accommodate for changes in anatomy, and strike the target using real-time targeting throughout the treatment. The company serves university research and teaching hospitals, community hospitals, private practices, government institutions, and freestanding cancer centers. ViewRay, Inc. markets its MRIdian through a direct sales force and distribution network. It has operations in the United States, France, Germany, and internationally. The company was founded in 2004 and is headquartered in Oakwood, Ohio."
VRAY,2019-12-31,23794000,-120199000,NA,-120199000,91523000,2422000,-112895000,-112895000,-4327000,0,87782000,200677000,85360000,-7304000,NA,-120199000,-120199000,NA,income_statement,Medical Devices,"ViewRay, Inc.","ViewRay, Inc. designs, manufactures, and markets radiation therapy systems. The company offers MRIdian, a magnetic resonance image guided radiation therapy system to image and treat cancer patients. Its MRIdian integrates MRI technology, radiation delivery, and proprietary software to see the soft tissues, shape the dose to accommodate for changes in anatomy, and strike the target using real-time targeting throughout the treatment. The company serves university research and teaching hospitals, community hospitals, private practices, government institutions, and freestanding cancer centers. ViewRay, Inc. markets its MRIdian through a direct sales force and distribution network. It has operations in the United States, France, Germany, and internationally. The company was founded in 2004 and is headquartered in Oakwood, Ohio."
VRCA,2016-12-31,1709000,-1913000,NA,-1913000,204000,0,-1913000,-1913000,-2000,0,0,1913000,0,0,NA,-1913000,-1913000,NA,income_statement,Biotechnology,Verrica Pharmaceuticals Inc.,"Verrica Pharmaceuticals Inc., a clinical stage medical dermatology company, develops and commercializes dermatological treatments in the United States. The company's lead product candidate include VP-102 that is in phase III clinical trial for the treatment of molluscum contagiosum; in phase II clinical trial for the treatment of common warts; and completed phase I clinical trial for the treatment of Genital warts. It is also developing cantharidin-based product candidate, VP-103 for the treatment of plantar warts. The company has a license agreement with Lytix Biopharma AS to develop and commercialize LTX-315 for dermatologic oncology indications. Verrica Pharmaceuticals Inc. was founded in 2013 and is headquartered in West Chester, Pennsylvania."
VRCA,2017-12-31,3730000,-4459000,NA,-4459000,727000,0,-4457000,-4457000,-2000,0,0,4457000,0,-2000,NA,-4459000,-9759000,NA,income_statement,Biotechnology,Verrica Pharmaceuticals Inc.,"Verrica Pharmaceuticals Inc., a clinical stage medical dermatology company, develops and commercializes dermatological treatments in the United States. The company's lead product candidate include VP-102 that is in phase III clinical trial for the treatment of molluscum contagiosum; in phase II clinical trial for the treatment of common warts; and completed phase I clinical trial for the treatment of Genital warts. It is also developing cantharidin-based product candidate, VP-103 for the treatment of plantar warts. The company has a license agreement with Lytix Biopharma AS to develop and commercialize LTX-315 for dermatologic oncology indications. Verrica Pharmaceuticals Inc. was founded in 2013 and is headquartered in West Chester, Pennsylvania."
VRCA,2018-12-31,12826000,-20648000,NA,-20648000,9052000,0,-21878000,-21878000,NA,0,0,21878000,0,1230000,NA,-20648000,-20648000,NA,income_statement,Biotechnology,Verrica Pharmaceuticals Inc.,"Verrica Pharmaceuticals Inc., a clinical stage medical dermatology company, develops and commercializes dermatological treatments in the United States. The company's lead product candidate include VP-102 that is in phase III clinical trial for the treatment of molluscum contagiosum; in phase II clinical trial for the treatment of common warts; and completed phase I clinical trial for the treatment of Genital warts. It is also developing cantharidin-based product candidate, VP-103 for the treatment of plantar warts. The company has a license agreement with Lytix Biopharma AS to develop and commercialize LTX-315 for dermatologic oncology indications. Verrica Pharmaceuticals Inc. was founded in 2013 and is headquartered in West Chester, Pennsylvania."
VRCA,2019-12-31,15436000,-28207000,NA,-28207000,14644000,0,-30080000,-30080000,NA,0,0,30080000,0,1873000,NA,-28207000,-28207000,NA,income_statement,Biotechnology,Verrica Pharmaceuticals Inc.,"Verrica Pharmaceuticals Inc., a clinical stage medical dermatology company, develops and commercializes dermatological treatments in the United States. The company's lead product candidate include VP-102 that is in phase III clinical trial for the treatment of molluscum contagiosum; in phase II clinical trial for the treatment of common warts; and completed phase I clinical trial for the treatment of Genital warts. It is also developing cantharidin-based product candidate, VP-103 for the treatment of plantar warts. The company has a license agreement with Lytix Biopharma AS to develop and commercialize LTX-315 for dermatologic oncology indications. Verrica Pharmaceuticals Inc. was founded in 2013 and is headquartered in West Chester, Pennsylvania."
VRDN,2016-12-31,30421000,-17274000,NA,-17274000,6772000,-10215000,-16987000,-16987000,-326000,0,3477000,20464000,13692000,-287000,NA,-17274000,-17323000,NA,income_statement,Biotechnology,"Viridian Therapeutics, Inc.","Viridian Therapeutics, Inc., a clinical-stage biopharmaceutical company, engages in discovering and developing proprietary RNA-targeted therapies with a specific focus on microRNAs and their role in diseases where there is a high-unmet medical need. Its four lead product candidates include cobomarsen, an inhibitor of miR-155 for treating various blood cancers, such as cutaneous T-cell lymphoma, adult T-cell lymphoma/leukemia, diffuse large B-cell lymphoma, and chronic lymphocytic leukemia; Remlarsen, a replacement for miR-29, a microRNA that is found at abnormally low levels in various pathological fibrotic conditions, including cutaneous and ocular fibrosis, which is in Phase II clinical trial; MRG-229, which is in preclinical trial for the treatment of idiopathic pulmonary fibrosis; and MRG- 110, an inhibitor of miR-92, a microRNA expressed in endothelial cells, which has completed two Phase I clinical trial for the treatment of heart failure, wound healing, and other ischemic disease in the United States and Japan. The company was formerly known as Miragen Therapeutics, Inc. and changed its name to Viridian Therapeutics, Inc. in January 2021. Viridian Therapeutics, Inc. was founded in 2006 and is based in Boulder, Colorado."
VRDN,2017-12-31,30421000,-26512000,NA,-26512000,10912000,-15620000,-26532000,-26532000,-283000,0,4003000,30535000,19623000,20000,NA,-26512000,-26517000,NA,income_statement,Biotechnology,"Viridian Therapeutics, Inc.","Viridian Therapeutics, Inc., a clinical-stage biopharmaceutical company, engages in discovering and developing proprietary RNA-targeted therapies with a specific focus on microRNAs and their role in diseases where there is a high-unmet medical need. Its four lead product candidates include cobomarsen, an inhibitor of miR-155 for treating various blood cancers, such as cutaneous T-cell lymphoma, adult T-cell lymphoma/leukemia, diffuse large B-cell lymphoma, and chronic lymphocytic leukemia; Remlarsen, a replacement for miR-29, a microRNA that is found at abnormally low levels in various pathological fibrotic conditions, including cutaneous and ocular fibrosis, which is in Phase II clinical trial; MRG-229, which is in preclinical trial for the treatment of idiopathic pulmonary fibrosis; and MRG- 110, an inhibitor of miR-92, a microRNA expressed in endothelial cells, which has completed two Phase I clinical trial for the treatment of heart failure, wound healing, and other ischemic disease in the United States and Japan. The company was formerly known as Miragen Therapeutics, Inc. and changed its name to Viridian Therapeutics, Inc. in January 2021. Viridian Therapeutics, Inc. was founded in 2006 and is based in Boulder, Colorado."
VRDN,2018-12-31,30421000,-32703000,NA,-32703000,11049000,-22035000,-33084000,-33084000,-873000,0,8386000,41470000,30421000,281000,NA,-32703000,-32703000,NA,income_statement,Biotechnology,"Viridian Therapeutics, Inc.","Viridian Therapeutics, Inc., a clinical-stage biopharmaceutical company, engages in discovering and developing proprietary RNA-targeted therapies with a specific focus on microRNAs and their role in diseases where there is a high-unmet medical need. Its four lead product candidates include cobomarsen, an inhibitor of miR-155 for treating various blood cancers, such as cutaneous T-cell lymphoma, adult T-cell lymphoma/leukemia, diffuse large B-cell lymphoma, and chronic lymphocytic leukemia; Remlarsen, a replacement for miR-29, a microRNA that is found at abnormally low levels in various pathological fibrotic conditions, including cutaneous and ocular fibrosis, which is in Phase II clinical trial; MRG-229, which is in preclinical trial for the treatment of idiopathic pulmonary fibrosis; and MRG- 110, an inhibitor of miR-92, a microRNA expressed in endothelial cells, which has completed two Phase I clinical trial for the treatment of heart failure, wound healing, and other ischemic disease in the United States and Japan. The company was formerly known as Miragen Therapeutics, Inc. and changed its name to Viridian Therapeutics, Inc. in January 2021. Viridian Therapeutics, Inc. was founded in 2006 and is based in Boulder, Colorado."
VRDN,2019-12-31,NA,-41873000,NA,-41873000,11346000,-28633000,-39979000,-39979000,-835000,0,4461000,44440000,33094000,-1894000,NA,-41873000,-41873000,NA,income_statement,Biotechnology,"Viridian Therapeutics, Inc.","Viridian Therapeutics, Inc., a clinical-stage biopharmaceutical company, engages in discovering and developing proprietary RNA-targeted therapies with a specific focus on microRNAs and their role in diseases where there is a high-unmet medical need. Its four lead product candidates include cobomarsen, an inhibitor of miR-155 for treating various blood cancers, such as cutaneous T-cell lymphoma, adult T-cell lymphoma/leukemia, diffuse large B-cell lymphoma, and chronic lymphocytic leukemia; Remlarsen, a replacement for miR-29, a microRNA that is found at abnormally low levels in various pathological fibrotic conditions, including cutaneous and ocular fibrosis, which is in Phase II clinical trial; MRG-229, which is in preclinical trial for the treatment of idiopathic pulmonary fibrosis; and MRG- 110, an inhibitor of miR-92, a microRNA expressed in endothelial cells, which has completed two Phase I clinical trial for the treatment of heart failure, wound healing, and other ischemic disease in the United States and Japan. The company was formerly known as Miragen Therapeutics, Inc. and changed its name to Viridian Therapeutics, Inc. in January 2021. Viridian Therapeutics, Inc. was founded in 2006 and is based in Boulder, Colorado."
VREX,2017-09-29,67300000,74800000,11200000,51600000,102500000,253500000,83700000,83700000,-12300000,22800000,698100000,614400000,444600000,-13900000,NA,52000000,51600000,NA,income_statement,Medical Devices,Varex Imaging Corporation,"Varex Imaging Corporation designs and manufactures X-ray imaging components. The company operates in two segments, Medical and Industrial. The Medical segment designs, manufactures, sells, and services X-ray imaging components comprising X-ray tubes, digital detectors, high voltage connectors, image-processing software and workstations, 3D reconstruction and computer-aided diagnostic software, collimators, automatic exposure control devices, generators, heat exchangers, ionization chambers, and buckys (a component of X-ray units that holds X-ray film cassettes). This segment's products are used in a range of applications, including radiographic and fluoroscopic imaging, mammography, computed tomography, radiation therapy, oncology, CT, cardiac, surgery, dental, computer-aided detection, and other diagnostic radiography uses. The Industrial segment designs, manufactures, sells, and services Linatron X-ray accelerators, X-ray tubes, digital detectors, and high voltage connectors for use in security and industrial inspection applications, such as airport security, cargo screening at ports and borders, and nondestructive testing and examination in various applications. Varex Imaging Corporation sells its products through imaging system original equipment manufacturers, independent service companies, and distributors, as well as directly to end-users. The company has operations in North America, Latin America, Europe, Russia, the Middle East, India, Africa, Asia, and Australia. Varex Imaging Corporation was founded in 2016 and is based in Salt Lake City, Utah."
VREX,2018-09-28,83000000,25700000,13200000,27500000,123400000,253900000,47500000,47500000,-21700000,-2600000,773400000,725900000,519500000,-21800000,NA,28300000,27500000,NA,income_statement,Medical Devices,Varex Imaging Corporation,"Varex Imaging Corporation designs and manufactures X-ray imaging components. The company operates in two segments, Medical and Industrial. The Medical segment designs, manufactures, sells, and services X-ray imaging components comprising X-ray tubes, digital detectors, high voltage connectors, image-processing software and workstations, 3D reconstruction and computer-aided diagnostic software, collimators, automatic exposure control devices, generators, heat exchangers, ionization chambers, and buckys (a component of X-ray units that holds X-ray film cassettes). This segment's products are used in a range of applications, including radiographic and fluoroscopic imaging, mammography, computed tomography, radiation therapy, oncology, CT, cardiac, surgery, dental, computer-aided detection, and other diagnostic radiography uses. The Industrial segment designs, manufactures, sells, and services Linatron X-ray accelerators, X-ray tubes, digital detectors, and high voltage connectors for use in security and industrial inspection applications, such as airport security, cargo screening at ports and borders, and nondestructive testing and examination in various applications. Varex Imaging Corporation sells its products through imaging system original equipment manufacturers, independent service companies, and distributors, as well as directly to end-users. The company has operations in North America, Latin America, Europe, Russia, the Middle East, India, Africa, Asia, and Australia. Varex Imaging Corporation was founded in 2016 and is based in Salt Lake City, Utah."
VREX,2019-09-27,78100000,21500000,13800000,15500000,121600000,264300000,64600000,64600000,-21100000,5700000,780600000,716000000,516300000,-43100000,NA,15800000,15500000,NA,income_statement,Medical Devices,Varex Imaging Corporation,"Varex Imaging Corporation designs and manufactures X-ray imaging components. The company operates in two segments, Medical and Industrial. The Medical segment designs, manufactures, sells, and services X-ray imaging components comprising X-ray tubes, digital detectors, high voltage connectors, image-processing software and workstations, 3D reconstruction and computer-aided diagnostic software, collimators, automatic exposure control devices, generators, heat exchangers, ionization chambers, and buckys (a component of X-ray units that holds X-ray film cassettes). This segment's products are used in a range of applications, including radiographic and fluoroscopic imaging, mammography, computed tomography, radiation therapy, oncology, CT, cardiac, surgery, dental, computer-aided detection, and other diagnostic radiography uses. The Industrial segment designs, manufactures, sells, and services Linatron X-ray accelerators, X-ray tubes, digital detectors, and high voltage connectors for use in security and industrial inspection applications, such as airport security, cargo screening at ports and borders, and nondestructive testing and examination in various applications. Varex Imaging Corporation sells its products through imaging system original equipment manufacturers, independent service companies, and distributors, as well as directly to end-users. The company has operations in North America, Latin America, Europe, Russia, the Middle East, India, Africa, Asia, and Australia. Varex Imaging Corporation was founded in 2016 and is based in Salt Lake City, Utah."
VREX,2020-10-02,78900000,-72600000,14100000,-57900000,132900000,194400000,-17400000,-17400000,-31400000,-15200000,738300000,755700000,543900000,-55200000,NA,-57400000,-57900000,NA,income_statement,Medical Devices,Varex Imaging Corporation,"Varex Imaging Corporation designs and manufactures X-ray imaging components. The company operates in two segments, Medical and Industrial. The Medical segment designs, manufactures, sells, and services X-ray imaging components comprising X-ray tubes, digital detectors, high voltage connectors, image-processing software and workstations, 3D reconstruction and computer-aided diagnostic software, collimators, automatic exposure control devices, generators, heat exchangers, ionization chambers, and buckys (a component of X-ray units that holds X-ray film cassettes). This segment's products are used in a range of applications, including radiographic and fluoroscopic imaging, mammography, computed tomography, radiation therapy, oncology, CT, cardiac, surgery, dental, computer-aided detection, and other diagnostic radiography uses. The Industrial segment designs, manufactures, sells, and services Linatron X-ray accelerators, X-ray tubes, digital detectors, and high voltage connectors for use in security and industrial inspection applications, such as airport security, cargo screening at ports and borders, and nondestructive testing and examination in various applications. Varex Imaging Corporation sells its products through imaging system original equipment manufacturers, independent service companies, and distributors, as well as directly to end-users. The company has operations in North America, Latin America, Europe, Russia, the Middle East, India, Africa, Asia, and Australia. Varex Imaging Corporation was founded in 2016 and is based in Salt Lake City, Utah."
VRM,2018-12-31,NA,-84949000,NA,-85178000,133842000,60807000,-79892000,-79892000,-8513000,229000,855429000,935321000,794622000,-5057000,NA,-85178000,-98214000,NA,income_statement,Auto & Truck Dealerships,"Vroom, Inc.","Vroom, Inc. operates an e-commerce platform for buying, selling, and trading of new and used cars in the United States. It also offers financing solutions. The company was formerly known as Auto America, Inc. and changed its name to Vroom, Inc. in July 2015. The company was founded in 2012 and is headquartered in New York, New York."
VRM,2019-12-31,NA,-142810000,NA,-142978000,184988000,57859000,-133148000,-133148000,-14596000,168000,1191821000,1324969000,1133962000,-9662000,NA,-142978000,-275728000,NA,income_statement,Auto & Truck Dealerships,"Vroom, Inc.","Vroom, Inc. operates an e-commerce platform for buying, selling, and trading of new and used cars in the United States. It also offers financing solutions. The company was formerly known as Auto America, Inc. and changed its name to Vroom, Inc. in July 2015. The company was founded in 2012 and is headquartered in New York, New York."
VRME,2016-12-31,250180,-1646255,NA,-1646255,3496850,12692,-3734338,-3734338,-12871,0,37055,3771393,24363,2088083,NA,-1646255,-1646255,NA,income_statement,Security & Protection Services,"VerifyMe, Inc.","VerifyMe, Inc. provides security solutions for the identification and authentication of people, products, and packaging for various applications in the United States. The company offers RainbowSecure technology that combines an invisible ink with a proprietary tuned laser to enable counterfeit products to be exposed; SecureLight technology, which changes the color of ink for use in various applications, including credit cards, driver's licenses, passports, stock certificates, clothing labels, currencies, ID cards, and tax stamps, as well as to protect apparels, pharmaceuticals, and other physical products; and SecureLight+ technology, a solution that can be authenticated by proprietary tuned laser devices, and with fluorescent lighting. It also provides VeriPAS technology, which provides brand owners geographical business intelligence on counterfeiting; VeriPAS Smartphone Authenticator technology, a piece of hardware with a built-in lighting system and software that scans invisible RainbowSecure codes; VerifyMe as Authentic technology, a dual-purpose pre-printed label with a visible serialized QR code for consumer scanning purposes, as well as an invisible serialized IR code for inspector scanning, authentication, and tracking purposes; and VerifyMe Beeper technology, an authentication tool that is designed for customers who desire instant authentication on items, such as event tickets at an entry gate. VerifyMe, Inc. has strategic partnerships with INX International Ink Company; and Techind Engineers & Consultants-Impex. The company was formerly known as LaserLock Technologies, Inc. and changed its name to VerifyMe, Inc. in July 2015. VerifyMe, Inc. was founded in 1999 and is based in Rochester, New York."
VRME,2017-12-31,128044,-3385340,NA,-3385340,2707460,0,-2835504,-2835504,-218316,0,0,2835504,0,-549836,NA,-3385340,-3982218,NA,income_statement,Security & Protection Services,"VerifyMe, Inc.","VerifyMe, Inc. provides security solutions for the identification and authentication of people, products, and packaging for various applications in the United States. The company offers RainbowSecure technology that combines an invisible ink with a proprietary tuned laser to enable counterfeit products to be exposed; SecureLight technology, which changes the color of ink for use in various applications, including credit cards, driver's licenses, passports, stock certificates, clothing labels, currencies, ID cards, and tax stamps, as well as to protect apparels, pharmaceuticals, and other physical products; and SecureLight+ technology, a solution that can be authenticated by proprietary tuned laser devices, and with fluorescent lighting. It also provides VeriPAS technology, which provides brand owners geographical business intelligence on counterfeiting; VeriPAS Smartphone Authenticator technology, a piece of hardware with a built-in lighting system and software that scans invisible RainbowSecure codes; VerifyMe as Authentic technology, a dual-purpose pre-printed label with a visible serialized QR code for consumer scanning purposes, as well as an invisible serialized IR code for inspector scanning, authentication, and tracking purposes; and VerifyMe Beeper technology, an authentication tool that is designed for customers who desire instant authentication on items, such as event tickets at an entry gate. VerifyMe, Inc. has strategic partnerships with INX International Ink Company; and Techind Engineers & Consultants-Impex. The company was formerly known as LaserLock Technologies, Inc. and changed its name to VerifyMe, Inc. in July 2015. VerifyMe, Inc. was founded in 1999 and is based in Rochester, New York."
VRME,2018-12-31,187655,-2932462,NA,-2932462,2454228,46082,-2595801,-2595801,-96891,0,74884,2670685,28802,-336661,NA,-2932462,-2932462,NA,income_statement,Security & Protection Services,"VerifyMe, Inc.","VerifyMe, Inc. provides security solutions for the identification and authentication of people, products, and packaging for various applications in the United States. The company offers RainbowSecure technology that combines an invisible ink with a proprietary tuned laser to enable counterfeit products to be exposed; SecureLight technology, which changes the color of ink for use in various applications, including credit cards, driver's licenses, passports, stock certificates, clothing labels, currencies, ID cards, and tax stamps, as well as to protect apparels, pharmaceuticals, and other physical products; and SecureLight+ technology, a solution that can be authenticated by proprietary tuned laser devices, and with fluorescent lighting. It also provides VeriPAS technology, which provides brand owners geographical business intelligence on counterfeiting; VeriPAS Smartphone Authenticator technology, a piece of hardware with a built-in lighting system and software that scans invisible RainbowSecure codes; VerifyMe as Authentic technology, a dual-purpose pre-printed label with a visible serialized QR code for consumer scanning purposes, as well as an invisible serialized IR code for inspector scanning, authentication, and tracking purposes; and VerifyMe Beeper technology, an authentication tool that is designed for customers who desire instant authentication on items, such as event tickets at an entry gate. VerifyMe, Inc. has strategic partnerships with INX International Ink Company; and Techind Engineers & Consultants-Impex. The company was formerly known as LaserLock Technologies, Inc. and changed its name to VerifyMe, Inc. in July 2015. VerifyMe, Inc. was founded in 1999 and is based in Rochester, New York."
VRME,2019-12-31,5119,-2507799,NA,-2507799,2627143,199689,-2432573,-2432573,-96891,0,244748,2677321,45059,-75226,NA,-2507799,-2507799,NA,income_statement,Security & Protection Services,"VerifyMe, Inc.","VerifyMe, Inc. provides security solutions for the identification and authentication of people, products, and packaging for various applications in the United States. The company offers RainbowSecure technology that combines an invisible ink with a proprietary tuned laser to enable counterfeit products to be exposed; SecureLight technology, which changes the color of ink for use in various applications, including credit cards, driver's licenses, passports, stock certificates, clothing labels, currencies, ID cards, and tax stamps, as well as to protect apparels, pharmaceuticals, and other physical products; and SecureLight+ technology, a solution that can be authenticated by proprietary tuned laser devices, and with fluorescent lighting. It also provides VeriPAS technology, which provides brand owners geographical business intelligence on counterfeiting; VeriPAS Smartphone Authenticator technology, a piece of hardware with a built-in lighting system and software that scans invisible RainbowSecure codes; VerifyMe as Authentic technology, a dual-purpose pre-printed label with a visible serialized QR code for consumer scanning purposes, as well as an invisible serialized IR code for inspector scanning, authentication, and tracking purposes; and VerifyMe Beeper technology, an authentication tool that is designed for customers who desire instant authentication on items, such as event tickets at an entry gate. VerifyMe, Inc. has strategic partnerships with INX International Ink Company; and Techind Engineers & Consultants-Impex. The company was formerly known as LaserLock Technologies, Inc. and changed its name to VerifyMe, Inc. in July 2015. VerifyMe, Inc. was founded in 1999 and is based in Rochester, New York."
VRNA,2016-12-31,4522000,-5973000,NA,-5019000,2498000,0,-7020000,-7020000,-50000,-954000,0,7020000,0,1047000,NA,-5019000,-5019000,NA,income_statement,Biotechnology,Verona Pharma plc,"Verona Pharma plc, a clinical stage biopharmaceutical company, focuses on develops and commercializes therapies for the treatment of respiratory diseases with unmet medical needs. Its product candidate, ensifentrine (RPL554), is an inhaled, dual inhibitor of the enzymes phosphodiesterase 3 and 4 that acts as both a bronchodilator and an anti-inflammatory agent in a single compound. The formulations of ensifentrine are under development for the treatment chronic obstructive pulmonary disease (COPD): nebulized ensifentrine is in Phase 2b clinical development for the maintenance treatment of COPD; and a dry powder inhaler and a pressurized metered-dose inhaler. The company also focuses on developing ensifentrine for the treatment of cystic fibrosis and asthma. Verona Pharma plc was founded in 2005 and is headquartered in London, the United Kingdom."
VRNA,2017-12-31,23717000,-25203000,NA,-20497000,6039000,0,-29756000,-29756000,-50000,-4706000,0,29756000,0,4553000,NA,-20497000,-20497000,NA,income_statement,Biotechnology,Verona Pharma plc,"Verona Pharma plc, a clinical stage biopharmaceutical company, focuses on develops and commercializes therapies for the treatment of respiratory diseases with unmet medical needs. Its product candidate, ensifentrine (RPL554), is an inhaled, dual inhibitor of the enzymes phosphodiesterase 3 and 4 that acts as both a bronchodilator and an anti-inflammatory agent in a single compound. The formulations of ensifentrine are under development for the treatment chronic obstructive pulmonary disease (COPD): nebulized ensifentrine is in Phase 2b clinical development for the maintenance treatment of COPD; and a dry powder inhaler and a pressurized metered-dose inhaler. The company also focuses on developing ensifentrine for the treatment of cystic fibrosis and asthma. Verona Pharma plc was founded in 2005 and is headquartered in London, the United Kingdom."
VRNA,2018-12-31,19294000,-24133000,NA,-19901000,6297000,0,-25591000,-25591000,-50000,-4232000,0,25591000,0,1458000,NA,-19901000,-19901000,NA,income_statement,Biotechnology,Verona Pharma plc,"Verona Pharma plc, a clinical stage biopharmaceutical company, focuses on develops and commercializes therapies for the treatment of respiratory diseases with unmet medical needs. Its product candidate, ensifentrine (RPL554), is an inhaled, dual inhibitor of the enzymes phosphodiesterase 3 and 4 that acts as both a bronchodilator and an anti-inflammatory agent in a single compound. The formulations of ensifentrine are under development for the treatment chronic obstructive pulmonary disease (COPD): nebulized ensifentrine is in Phase 2b clinical development for the maintenance treatment of COPD; and a dry powder inhaler and a pressurized metered-dose inhaler. The company also focuses on developing ensifentrine for the treatment of cystic fibrosis and asthma. Verona Pharma plc was founded in 2005 and is headquartered in London, the United Kingdom."
VRNA,2019-12-31,33476000,-39206000,NA,-31941000,7607000,0,-41083000,-41083000,-50000,-7265000,0,41083000,0,1877000,NA,-31941000,-31941000,NA,income_statement,Biotechnology,Verona Pharma plc,"Verona Pharma plc, a clinical stage biopharmaceutical company, focuses on develops and commercializes therapies for the treatment of respiratory diseases with unmet medical needs. Its product candidate, ensifentrine (RPL554), is an inhaled, dual inhibitor of the enzymes phosphodiesterase 3 and 4 that acts as both a bronchodilator and an anti-inflammatory agent in a single compound. The formulations of ensifentrine are under development for the treatment chronic obstructive pulmonary disease (COPD): nebulized ensifentrine is in Phase 2b clinical development for the maintenance treatment of COPD; and a dry powder inhaler and a pressurized metered-dose inhaler. The company also focuses on developing ensifentrine for the treatment of cystic fibrosis and asthma. Verona Pharma plc was founded in 2005 and is headquartered in London, the United Kingdom."
VRNS,2017-12-31,47369000,-11057000,NA,-13844000,160726000,194676000,-13419000,-13419000,-389000,2787000,215390000,228809000,20714000,2362000,NA,-13844000,-13844000,1158000,income_statement,Software—Infrastructure,"Varonis Systems, Inc.","Varonis Systems, Inc. provides software products and services that allow enterprises to manage, analyze, and secure enterprise data in North America, Europe, the Middle East, Africa, and internationally. Its software enables enterprises to protect data stored on premises and in the cloud, including sensitive files and emails; confidential personal data belonging to customers, and patients and employees' data; financial records; strategic and product plans; and other intellectual property. The company offers DatAdvantage that captures, aggregates, normalizes, and analyzes every data access event for users on Windows and UNIX/Linux servers, storage devices, email systems, and Intranet servers; and DatAlert that profiles users and their behaviors related to systems and data, detects and alerts on deviations that indicate compromise, and provides a Web-based dashboard and investigative interface. It also provides Data Classification Engine that identifies and tags data based on criteria set in various metadata dimensions, and provides business and information technology (IT) personnel with actionable intelligence about data; and DataPrivilege, which provides a self-service Web portal that allows users to request access to data necessary for their business functions, and owners to grant access without IT intervention. In addition, the company offers Data Transport Engine, which provides an execution engine that unifies the manipulation of data and metadata, translating business decisions, and instructions into technical commands, such as data migration or archiving; and DatAnswers that offers search functionality for enterprise data. It sells its products and services through a network of distributors and resellers. The company serves IT, security, and business personnel. Varonis Systems, Inc. was incorporated in 2004 and is headquartered in New York, New York."
VRNS,2018-12-31,69971000,-28165000,NA,-28578000,201769000,242605000,-29135000,-29135000,-389000,413000,270288000,299423000,27683000,970000,NA,-28578000,-28578000,2648000,income_statement,Software—Infrastructure,"Varonis Systems, Inc.","Varonis Systems, Inc. provides software products and services that allow enterprises to manage, analyze, and secure enterprise data in North America, Europe, the Middle East, Africa, and internationally. Its software enables enterprises to protect data stored on premises and in the cloud, including sensitive files and emails; confidential personal data belonging to customers, and patients and employees' data; financial records; strategic and product plans; and other intellectual property. The company offers DatAdvantage that captures, aggregates, normalizes, and analyzes every data access event for users on Windows and UNIX/Linux servers, storage devices, email systems, and Intranet servers; and DatAlert that profiles users and their behaviors related to systems and data, detects and alerts on deviations that indicate compromise, and provides a Web-based dashboard and investigative interface. It also provides Data Classification Engine that identifies and tags data based on criteria set in various metadata dimensions, and provides business and information technology (IT) personnel with actionable intelligence about data; and DataPrivilege, which provides a self-service Web portal that allows users to request access to data necessary for their business functions, and owners to grant access without IT intervention. In addition, the company offers Data Transport Engine, which provides an execution engine that unifies the manipulation of data and metadata, translating business decisions, and instructions into technical commands, such as data migration or archiving; and DatAnswers that offers search functionality for enterprise data. It sells its products and services through a network of distributors and resellers. The company serves IT, security, and business personnel. Varonis Systems, Inc. was incorporated in 2004 and is headquartered in New York, New York."
VRNS,2019-12-31,80602000,-76376000,NA,-78764000,212018000,219281000,-75987000,-75987000,-389000,2388000,254190000,330177000,34909000,-389000,NA,-78764000,-78764000,2648000,income_statement,Software—Infrastructure,"Varonis Systems, Inc.","Varonis Systems, Inc. provides software products and services that allow enterprises to manage, analyze, and secure enterprise data in North America, Europe, the Middle East, Africa, and internationally. Its software enables enterprises to protect data stored on premises and in the cloud, including sensitive files and emails; confidential personal data belonging to customers, and patients and employees' data; financial records; strategic and product plans; and other intellectual property. The company offers DatAdvantage that captures, aggregates, normalizes, and analyzes every data access event for users on Windows and UNIX/Linux servers, storage devices, email systems, and Intranet servers; and DatAlert that profiles users and their behaviors related to systems and data, detects and alerts on deviations that indicate compromise, and provides a Web-based dashboard and investigative interface. It also provides Data Classification Engine that identifies and tags data based on criteria set in various metadata dimensions, and provides business and information technology (IT) personnel with actionable intelligence about data; and DataPrivilege, which provides a self-service Web portal that allows users to request access to data necessary for their business functions, and owners to grant access without IT intervention. In addition, the company offers Data Transport Engine, which provides an execution engine that unifies the manipulation of data and metadata, translating business decisions, and instructions into technical commands, such as data migration or archiving; and DatAnswers that offers search functionality for enterprise data. It sells its products and services through a network of distributors and resellers. The company serves IT, security, and business personnel. Varonis Systems, Inc. was incorporated in 2004 and is headquartered in New York, New York."
VRNS,2020-12-31,99030000,-85898000,NA,-94010000,223895000,248728000,-78090000,-78090000,-6113000,8112000,292689000,370779000,43961000,-7808000,NA,-94010000,-94010000,3893000,income_statement,Software—Infrastructure,"Varonis Systems, Inc.","Varonis Systems, Inc. provides software products and services that allow enterprises to manage, analyze, and secure enterprise data in North America, Europe, the Middle East, Africa, and internationally. Its software enables enterprises to protect data stored on premises and in the cloud, including sensitive files and emails; confidential personal data belonging to customers, and patients and employees' data; financial records; strategic and product plans; and other intellectual property. The company offers DatAdvantage that captures, aggregates, normalizes, and analyzes every data access event for users on Windows and UNIX/Linux servers, storage devices, email systems, and Intranet servers; and DatAlert that profiles users and their behaviors related to systems and data, detects and alerts on deviations that indicate compromise, and provides a Web-based dashboard and investigative interface. It also provides Data Classification Engine that identifies and tags data based on criteria set in various metadata dimensions, and provides business and information technology (IT) personnel with actionable intelligence about data; and DataPrivilege, which provides a self-service Web portal that allows users to request access to data necessary for their business functions, and owners to grant access without IT intervention. In addition, the company offers Data Transport Engine, which provides an execution engine that unifies the manipulation of data and metadata, translating business decisions, and instructions into technical commands, such as data migration or archiving; and DatAnswers that offers search functionality for enterprise data. It sells its products and services through a network of distributors and resellers. The company serves IT, security, and business personnel. Varonis Systems, Inc. was incorporated in 2004 and is headquartered in New York, New York."
VRNT,2017-01-31,171070000,-23474000,8460000,-29380000,397052000,676849000,27266000,27266000,-34962000,2772000,1062106000,1034840000,385257000,-50740000,NA,-26246000,-29380000,NA,income_statement,Software—Infrastructure,Verint Systems Inc.,"Verint Systems Inc. provides actionable intelligence solutions worldwide. It operates through Customer Engagement and Cyber Intelligence segments. The company offers Workforce Forecasting and Scheduling for management of workforce scheduling in contact centers, back office operations, and branches; Verint Mobile apps that deliver work-life balance ownership to employees and managers on-the-go; Knowledge Management solution for reduce training time, increase first call resolution, and improve customer satisfaction scores; Virtual Assistant, which provides automated and real-time support for the employee; Verint Real-Time Analytics that surfaces contextual guidance to an employee; Verint Robotic Process Automation solutions; and Verint Employee Desktop that unifies disparate applications on an employee's desktop. It also offers Verint Recording for capturing customer interactions across voice and digital channels; Verint Automated Quality Management products that automate the quality process from scoring evaluations to assigning coaching; Verint Performance Management, which triggers automated workflows; Verint Interaction Analytics to reduce cost by identifying operational process challenges; Verint Desktop and Process Analytics; Verint Work Manager; and Verint Performance Management solutions. In addition, the company provides Intelligent Virtual Assistant; Web Self-Service that enable customers to self-serve on the web or via their mobile devices; Communities, which enable organizations to manage online communities for their employees, customers, and partners; Verint Experience Cloud that connects siloes of customer experience data to identify problems, predict outcomes, and drive actions; Omni-Channel Recording, which captures customer interaction data; compliance recording that supports compliance audits and the avoidance of fines; and Fraud Prevention And Cyber Intelligence Solutions. The company was founded in 1994 and is headquartered in Melville, New York."
VRNT,2018-01-31,190643000,18900000,11744000,-6627000,406760000,726658000,56830000,56830000,-33430000,22354000,1135229000,1078399000,408571000,-37930000,NA,-3454000,-6627000,NA,income_statement,Software—Infrastructure,Verint Systems Inc.,"Verint Systems Inc. provides actionable intelligence solutions worldwide. It operates through Customer Engagement and Cyber Intelligence segments. The company offers Workforce Forecasting and Scheduling for management of workforce scheduling in contact centers, back office operations, and branches; Verint Mobile apps that deliver work-life balance ownership to employees and managers on-the-go; Knowledge Management solution for reduce training time, increase first call resolution, and improve customer satisfaction scores; Virtual Assistant, which provides automated and real-time support for the employee; Verint Real-Time Analytics that surfaces contextual guidance to an employee; Verint Robotic Process Automation solutions; and Verint Employee Desktop that unifies disparate applications on an employee's desktop. It also offers Verint Recording for capturing customer interactions across voice and digital channels; Verint Automated Quality Management products that automate the quality process from scoring evaluations to assigning coaching; Verint Performance Management, which triggers automated workflows; Verint Interaction Analytics to reduce cost by identifying operational process challenges; Verint Desktop and Process Analytics; Verint Work Manager; and Verint Performance Management solutions. In addition, the company provides Intelligent Virtual Assistant; Web Self-Service that enable customers to self-serve on the web or via their mobile devices; Communities, which enable organizations to manage online communities for their employees, customers, and partners; Verint Experience Cloud that connects siloes of customer experience data to identify problems, predict outcomes, and drive actions; Omni-Channel Recording, which captures customer interaction data; compliance recording that supports compliance audits and the avoidance of fines; and Fraud Prevention And Cyber Intelligence Solutions. The company was founded in 1994 and is headquartered in Melville, New York."
VRNT,2019-01-31,209106000,77762000,11568000,65991000,422044000,805937000,118374000,118374000,-36724000,7542000,1229747000,1111373000,423810000,-40612000,NA,70220000,65991000,NA,income_statement,Software—Infrastructure,Verint Systems Inc.,"Verint Systems Inc. provides actionable intelligence solutions worldwide. It operates through Customer Engagement and Cyber Intelligence segments. The company offers Workforce Forecasting and Scheduling for management of workforce scheduling in contact centers, back office operations, and branches; Verint Mobile apps that deliver work-life balance ownership to employees and managers on-the-go; Knowledge Management solution for reduce training time, increase first call resolution, and improve customer satisfaction scores; Virtual Assistant, which provides automated and real-time support for the employee; Verint Real-Time Analytics that surfaces contextual guidance to an employee; Verint Robotic Process Automation solutions; and Verint Employee Desktop that unifies disparate applications on an employee's desktop. It also offers Verint Recording for capturing customer interactions across voice and digital channels; Verint Automated Quality Management products that automate the quality process from scoring evaluations to assigning coaching; Verint Performance Management, which triggers automated workflows; Verint Interaction Analytics to reduce cost by identifying operational process challenges; Verint Desktop and Process Analytics; Verint Work Manager; and Verint Performance Management solutions. In addition, the company provides Intelligent Virtual Assistant; Web Self-Service that enable customers to self-serve on the web or via their mobile devices; Communities, which enable organizations to manage online communities for their employees, customers, and partners; Verint Experience Cloud that connects siloes of customer experience data to identify problems, predict outcomes, and drive actions; Omni-Channel Recording, which captures customer interaction data; compliance recording that supports compliance audits and the avoidance of fines; and Fraud Prevention And Cyber Intelligence Solutions. The company was founded in 1994 and is headquartered in Melville, New York."
VRNT,2020-01-31,231683000,53303000,13069000,28684000,478802000,863852000,97925000,97925000,-40426000,17620000,1303634000,1205709000,439782000,-44622000,NA,35683000,28684000,NA,income_statement,Software—Infrastructure,Verint Systems Inc.,"Verint Systems Inc. provides actionable intelligence solutions worldwide. It operates through Customer Engagement and Cyber Intelligence segments. The company offers Workforce Forecasting and Scheduling for management of workforce scheduling in contact centers, back office operations, and branches; Verint Mobile apps that deliver work-life balance ownership to employees and managers on-the-go; Knowledge Management solution for reduce training time, increase first call resolution, and improve customer satisfaction scores; Virtual Assistant, which provides automated and real-time support for the employee; Verint Real-Time Analytics that surfaces contextual guidance to an employee; Verint Robotic Process Automation solutions; and Verint Employee Desktop that unifies disparate applications on an employee's desktop. It also offers Verint Recording for capturing customer interactions across voice and digital channels; Verint Automated Quality Management products that automate the quality process from scoring evaluations to assigning coaching; Verint Performance Management, which triggers automated workflows; Verint Interaction Analytics to reduce cost by identifying operational process challenges; Verint Desktop and Process Analytics; Verint Work Manager; and Verint Performance Management solutions. In addition, the company provides Intelligent Virtual Assistant; Web Self-Service that enable customers to self-serve on the web or via their mobile devices; Communities, which enable organizations to manage online communities for their employees, customers, and partners; Verint Experience Cloud that connects siloes of customer experience data to identify problems, predict outcomes, and drive actions; Omni-Channel Recording, which captures customer interaction data; compliance recording that supports compliance audits and the avoidance of fines; and Fraud Prevention And Cyber Intelligence Solutions. The company was founded in 1994 and is headquartered in Melville, New York."
VRPX,2018-12-31,1142176,-2640938,NA,-2640938,1483786,0,-2625962,-2625962,-14976,0,0,2625962,0,-14976,NA,-2640938,-2640938,NA,income_statement,Biotechnology,"Virpax Pharmaceuticals, Inc. Common Stock","Virpax Pharmaceuticals, Inc. develops and manufactures non-opioid and non-addictive based drug compounds and drug delivery systems for pain management. It offers products, such as Probudur, an injectable bupivacaine hydrogel for postoperative pain management; Epoladerm, a diclofenac metered-dose spray film for acute musculoskeletal pain; and NES100, an endogenous enkephalin intranasal spray for acute and chronic spray. The company develops drug delivery technologies, such as Topical metered-dose spray, Liposomal in Hydrogel encapsulation, and Enkephalin Intranasal spray. It also develops therapies to manage post-traumatic stress disorder (PTSD), as well as to help prevent viral spread, including influenza and SARS-CoV-2 (Covid-19). Virpax Pharmaceuticals, Inc. was founded in 2016 and is based in Malvern, Pennsylvania."
VRPX,2019-12-31,622741,-3306512,NA,-3306512,2559127,0,-3181868,-3181868,-124644,0,0,3181868,0,-124644,NA,-3306512,-3306512,NA,income_statement,Biotechnology,"Virpax Pharmaceuticals, Inc. Common Stock","Virpax Pharmaceuticals, Inc. develops and manufactures non-opioid and non-addictive based drug compounds and drug delivery systems for pain management. It offers products, such as Probudur, an injectable bupivacaine hydrogel for postoperative pain management; Epoladerm, a diclofenac metered-dose spray film for acute musculoskeletal pain; and NES100, an endogenous enkephalin intranasal spray for acute and chronic spray. The company develops drug delivery technologies, such as Topical metered-dose spray, Liposomal in Hydrogel encapsulation, and Enkephalin Intranasal spray. It also develops therapies to manage post-traumatic stress disorder (PTSD), as well as to help prevent viral spread, including influenza and SARS-CoV-2 (Covid-19). Virpax Pharmaceuticals, Inc. was founded in 2016 and is based in Malvern, Pennsylvania."
VRRM,2016-12-31,NA,47657114,NA,28996084,53033871,134843644,48392837,48392837,-2706499,18661030,230749586,182356749,95905942,-735723,NA,28996084,28996084,NA,income_statement,Security & Protection Services,Verra Mobility Corporation,"Verra Mobility Corporation provides smart mobility technology solutions and services in the United States, Canada, and Europe. It operates through two segments, Government Solutions and Commercial Services. The Government Solutions segment offers automated safety solutions, including services and technologies that enable photo enforcement through road safety camera programs, which detects and process traffic violations related to red light, speed, school bus, and city bus lanes. This segment serves municipalities, counties, school districts, and law enforcement agencies. The Commercial Services segment provides automated toll and violations management, and title and registration solutions to rental car companies, fleet management companies, and other large fleet owners. The company is headquartered in Mesa, Arizona."
VRRM,2017-12-31,NA,-9947000,NA,19478000,45662000,139812000,48424000,48424000,-21733000,-29425000,232110000,183686000,92298000,-58371000,NA,19478000,18238000,NA,income_statement,Security & Protection Services,Verra Mobility Corporation,"Verra Mobility Corporation provides smart mobility technology solutions and services in the United States, Canada, and Europe. It operates through two segments, Government Solutions and Commercial Services. The Government Solutions segment offers automated safety solutions, including services and technologies that enable photo enforcement through road safety camera programs, which detects and process traffic violations related to red light, speed, school bus, and city bus lanes. This segment serves municipalities, counties, school districts, and law enforcement agencies. The Commercial Services segment provides automated toll and violations management, and title and registration solutions to rental car companies, fleet management companies, and other large fleet owners. The company is headquartered in Mesa, Arizona."
VRRM,2018-12-31,NA,-74635000,NA,-58394000,65478000,252028000,83197000,83197000,-69550000,-16241000,370146000,286949000,118118000,-157832000,NA,-58394000,-58394000,NA,income_statement,Security & Protection Services,Verra Mobility Corporation,"Verra Mobility Corporation provides smart mobility technology solutions and services in the United States, Canada, and Europe. It operates through two segments, Government Solutions and Commercial Services. The Government Solutions segment offers automated safety solutions, including services and technologies that enable photo enforcement through road safety camera programs, which detects and process traffic violations related to red light, speed, school bus, and city bus lanes. This segment serves municipalities, counties, school districts, and law enforcement agencies. The Commercial Services segment provides automated toll and violations management, and title and registration solutions to rental car companies, fleet management companies, and other large fleet owners. The company is headquartered in Mesa, Arizona."
VRRM,2019-12-31,NA,46924000,NA,33343000,83125000,303617000,104721000,104721000,-60729000,13581000,448737000,344016000,145120000,-57797000,NA,33343000,33343000,NA,income_statement,Security & Protection Services,Verra Mobility Corporation,"Verra Mobility Corporation provides smart mobility technology solutions and services in the United States, Canada, and Europe. It operates through two segments, Government Solutions and Commercial Services. The Government Solutions segment offers automated safety solutions, including services and technologies that enable photo enforcement through road safety camera programs, which detects and process traffic violations related to red light, speed, school bus, and city bus lanes. This segment serves municipalities, counties, school districts, and law enforcement agencies. The Commercial Services segment provides automated toll and violations management, and title and registration solutions to rental car companies, fleet management companies, and other large fleet owners. The company is headquartered in Mesa, Arizona."
VRSK,2016-12-31,NA,653700000,NA,591200000,300000000,1295300000,783700000,783700000,-120000000,202200000,1995200000,1211500000,699900000,-130000000,139700000,451500000,591200000,NA,income_statement,NA,NA,NA
VRSK,2017-12-31,NA,691000000,NA,555100000,316000000,1361400000,808000000,808000000,-119400000,135900000,2145200000,1337200000,783800000,-117000000,NA,555100000,555100000,NA,income_statement,NA,NA,NA
VRSK,2018-12-31,NA,719700000,NA,598700000,377200000,1508900000,835600000,835600000,-129700000,121000000,2395100000,1559500000,886200000,-115900000,NA,598700000,598700000,NA,income_statement,NA,NA,NA
VRSK,2019-12-31,NA,568400000,NA,449900000,475500000,1630300000,831100000,831100000,-126800000,118500000,2607100000,1776000000,976800000,-262700000,NA,449900000,449900000,NA,income_statement,NA,NA,NA
VRSN,2017-12-31,52342000,599012000,NA,457248000,211705000,971769000,707722000,707722000,-136336000,141764000,1165095000,457373000,193326000,-108710000,NA,457248000,457248000,NA,income_statement,NA,NA,NA
VRSN,2018-12-31,57884000,729516000,NA,582489000,197559000,1022835000,767392000,767392000,-114845000,147027000,1214969000,447577000,192134000,-37876000,NA,582489000,582489000,NA,income_statement,NA,NA,NA
VRSN,2019-12-31,60805000,758776000,NA,612299000,184262000,1051194000,806127000,806127000,-90611000,146477000,1231661000,425534000,180467000,-47351000,NA,612299000,612299000,NA,income_statement,NA,NA,NA
VRSN,2020-12-31,74671000,750244000,NA,814888000,186003000,1084875000,824201000,824201000,-90144000,-64644000,1265052000,440851000,180177000,-73957000,NA,814888000,814888000,NA,income_statement,NA,NA,NA
VRTS,2017-12-31,NA,80429000,20845000,37012000,6100000,162226000,68615000,68615000,-47250000,40490000,425607000,356992000,263381000,11814000,NA,39939000,28676000,71841000,income_statement,Asset Management,"Virtus Investment Partners, Inc","Virtus Investment Partners, Inc. is a publicly owned investment manager. The firm primarily provides its services to individual and institutional clients. It launches separate client focused equity and fixed income portfolios. The firm launches equity, fixed income, and balanced mutual funds for its clients. It invests in the public equity, fixed income, and real estate markets. The firm also invests in exchange traded funds. It employs a multi manager approach for its products. The firm employs quantitative analysis to make its investments. It benchmarks the performance of its portfolios against the S&P 500 Index. The firm conducts in-house research to make its investments. Virtus Investment Partners, Inc. was founded in 1988 and is based in Hartford, Connecticut."
VRTS,2018-12-31,NA,109041000,71439000,75529000,6900000,221293000,113186000,113186000,-84233000,32961000,552235000,439049000,330942000,-4145000,NA,76080000,67192000,71468000,income_statement,Asset Management,"Virtus Investment Partners, Inc","Virtus Investment Partners, Inc. is a publicly owned investment manager. The firm primarily provides its services to individual and institutional clients. It launches separate client focused equity and fixed income portfolios. The firm launches equity, fixed income, and balanced mutual funds for its clients. It invests in the public equity, fixed income, and real estate markets. The firm also invests in exchange traded funds. It employs a multi manager approach for its products. The firm employs quantitative analysis to make its investments. It benchmarks the performance of its portfolios against the S&P 500 Index. The firm conducts in-house research to make its investments. Virtus Investment Partners, Inc. was founded in 1988 and is based in Hartford, Connecticut."
VRTS,2019-12-31,NA,140685000,74403000,95649000,5100000,240626000,127012000,127012000,-111478000,35177000,563246000,436234000,322620000,13673000,NA,105508000,87312000,73278000,income_statement,Asset Management,"Virtus Investment Partners, Inc","Virtus Investment Partners, Inc. is a publicly owned investment manager. The firm primarily provides its services to individual and institutional clients. It launches separate client focused equity and fixed income portfolios. The firm launches equity, fixed income, and balanced mutual funds for its clients. It invests in the public equity, fixed income, and real estate markets. The firm also invests in exchange traded funds. It employs a multi manager approach for its products. The firm employs quantitative analysis to make its investments. It benchmarks the performance of its portfolios against the S&P 500 Index. The firm conducts in-house research to make its investments. Virtus Investment Partners, Inc. was founded in 1988 and is based in Hartford, Connecticut."
VRTS,2020-12-31,NA,163898000,NA,79957000,NA,259587000,144319000,144319000,-97331000,43935000,603896000,459577000,344309000,19579000,NA,119963000,79957000,80481000,income_statement,Asset Management,"Virtus Investment Partners, Inc","Virtus Investment Partners, Inc. is a publicly owned investment manager. The firm primarily provides its services to individual and institutional clients. It launches separate client focused equity and fixed income portfolios. The firm launches equity, fixed income, and balanced mutual funds for its clients. It invests in the public equity, fixed income, and real estate markets. The firm also invests in exchange traded funds. It employs a multi manager approach for its products. The firm employs quantitative analysis to make its investments. It benchmarks the performance of its portfolios against the S&P 500 Index. The firm conducts in-house research to make its investments. Virtus Investment Partners, Inc. was founded in 1988 and is based in Hartford, Connecticut."
VRTX,2017-12-31,NA,-15689000,13727000,263484000,496079000,888908000,392829000,392829000,-69298000,-107324000,2488652000,2095823000,1599744000,-408518000,NA,91635000,263191000,NA,income_statement,NA,NA,NA
VRTX,2018-12-31,NA,600241000,NA,2096896000,557616000,1221582000,663966000,663966000,-72471000,-1486862000,3047597000,2383631000,1826015000,-63725000,NA,2087103000,2096395000,NA,income_statement,NA,NA,NA
VRTX,2019-12-31,NA,1394919000,NA,1176810000,658498000,1860523000,1202025000,1202025000,-58502000,218109000,4162821000,2960796000,2302298000,192894000,NA,1176810000,1176810000,NA,income_statement,NA,NA,NA
VRTX,2020-12-31,NA,3116798000,NA,2711647000,770456000,3639846000,2869390000,2869390000,-58151000,405151000,6205683000,3336293000,2565837000,247408000,NA,2711647000,2711647000,NA,income_statement,NA,NA,NA
VS,2016-12-31,NA,-4997392,1615397,-3612918,1595920,0,-4799998,-4799998,-2928,0,0,4799998,0,-197394,NA,-4997392,-3612918,NA,income_statement,Electronic Gaming & Multimedia,Versus Systems Inc.,"Versus Systems Inc. operates a business-to-business software platform that allows video game publishers and developers to offer prize-based matches of their games to their players in Canada and the United States. The company is headquartered in Vancouver, Canada."
VS,2017-12-31,NA,-6982356,-1151915,-4227038,3150138,0,-6963253,-6963253,-2928,0,0,6963253,0,-19103,NA,-6982356,-4227038,NA,income_statement,Electronic Gaming & Multimedia,Versus Systems Inc.,"Versus Systems Inc. operates a business-to-business software platform that allows video game publishers and developers to offer prize-based matches of their games to their players in Canada and the United States. The company is headquartered in Vancouver, Canada."
VS,2018-12-31,NA,-9373171,-5893609,-4631477,5379002,1450,-9023545,-9023545,-77669,0,1620,9025165,170,-349626,NA,-9373171,-4631477,NA,income_statement,Electronic Gaming & Multimedia,Versus Systems Inc.,"Versus Systems Inc. operates a business-to-business software platform that allows video game publishers and developers to offer prize-based matches of their games to their players in Canada and the United States. The company is headquartered in Vancouver, Canada."
VS,2019-12-31,NA,-9627605,-6024450,-6869121,5969504,664922,-9001642,-9001642,-329718,0,664922,9666564,0,-625963,NA,-9627605,-6869121,NA,income_statement,Electronic Gaming & Multimedia,Versus Systems Inc.,"Versus Systems Inc. operates a business-to-business software platform that allows video game publishers and developers to offer prize-based matches of their games to their players in Canada and the United States. The company is headquartered in Vancouver, Canada."
VSAT,2017-03-31,129647000,25384000,3313000,23767000,333468000,510362000,36459000,36459000,-12083000,3617000,1559337000,1522878000,1048975000,-11075000,NA,21767000,23767000,NA,income_statement,Communication Equipment,"ViaSat, Inc.","Viasat, Inc. provides broadband and communications products and services worldwide. It operates through three segments: Satellite Services, Commercial Networks, and Government Systems. The company's Satellite Services segment offers satellite-based fixed broadband services, including broadband internet access and voice over internet protocol services to consumers and businesses; in-flight entertainment, internet, and aviation software services to commercial airlines; community internet services; and mobile broadband services, including satellite-based internet services to energy offshore vessels, cruise ships, consumer ferries, and yachts. As of March 31, 2020, this segment provided broadband Internet services to approximately 590,000 subscribers. Its Commercial Networks segment offers fixed satellite networks comprising satellite network infrastructure and ground terminals; mobile broadband satellite communication systems; and antenna systems for terrestrial and satellite applications, such as earth imaging, remote sensing, mobile satellite communication, Ka-band earth stations, and other multi-band antennas. This segment also provides design and technology services, including analysis, design, development, and specification of satellites and ground systems; application specific integrated circuit and monolithic microwave integrated circuit design; and network function virtualization. The company's Government Systems segment offers various mobile and fixed broadband modems, terminals, network access control systems, and antenna systems; cybersecurity and information assurance products and services; and tactical radio and information distribution systems to enable voice, and real-time collection and dissemination of video and data using secure, and jam-resistant transmission links. The company was founded in 1986 and is headquartered in Carlsbad, California."
VSAT,2018-03-31,168347000,-103492000,10841000,-67305000,385420000,473811000,-92187000,-92187000,-4026000,-35217000,1594625000,1686812000,1120814000,-11305000,NA,-68275000,-67305000,NA,income_statement,Communication Equipment,"ViaSat, Inc.","Viasat, Inc. provides broadband and communications products and services worldwide. It operates through three segments: Satellite Services, Commercial Networks, and Government Systems. The company's Satellite Services segment offers satellite-based fixed broadband services, including broadband internet access and voice over internet protocol services to consumers and businesses; in-flight entertainment, internet, and aviation software services to commercial airlines; community internet services; and mobile broadband services, including satellite-based internet services to energy offshore vessels, cruise ships, consumer ferries, and yachts. As of March 31, 2020, this segment provided broadband Internet services to approximately 590,000 subscribers. Its Commercial Networks segment offers fixed satellite networks comprising satellite network infrastructure and ground terminals; mobile broadband satellite communication systems; and antenna systems for terrestrial and satellite applications, such as earth imaging, remote sensing, mobile satellite communication, Ka-band earth stations, and other multi-band antennas. This segment also provides design and technology services, including analysis, design, development, and specification of satellites and ground systems; application specific integrated circuit and monolithic microwave integrated circuit design; and network function virtualization. The company's Government Systems segment offers various mobile and fixed broadband modems, terminals, network access control systems, and antenna systems; cybersecurity and information assurance products and services; and tactical radio and information distribution systems to enable voice, and real-time collection and dissemination of video and data using secure, and jam-resistant transmission links. The company was founded in 1986 and is headquartered in Carlsbad, California."
VSAT,2019-03-31,123044000,-107483000,8330000,-67623000,465958000,530537000,-68120000,-68120000,-50010000,-41014000,2068258000,2136378000,1537721000,-39363000,NA,-66469000,-67623000,NA,income_statement,Communication Equipment,"ViaSat, Inc.","Viasat, Inc. provides broadband and communications products and services worldwide. It operates through three segments: Satellite Services, Commercial Networks, and Government Systems. The company's Satellite Services segment offers satellite-based fixed broadband services, including broadband internet access and voice over internet protocol services to consumers and businesses; in-flight entertainment, internet, and aviation software services to commercial airlines; community internet services; and mobile broadband services, including satellite-based internet services to energy offshore vessels, cruise ships, consumer ferries, and yachts. As of March 31, 2020, this segment provided broadband Internet services to approximately 590,000 subscribers. Its Commercial Networks segment offers fixed satellite networks comprising satellite network infrastructure and ground terminals; mobile broadband satellite communication systems; and antenna systems for terrestrial and satellite applications, such as earth imaging, remote sensing, mobile satellite communication, Ka-band earth stations, and other multi-band antennas. This segment also provides design and technology services, including analysis, design, development, and specification of satellites and ground systems; application specific integrated circuit and monolithic microwave integrated circuit design; and network function virtualization. The company's Government Systems segment offers various mobile and fixed broadband modems, terminals, network access control systems, and antenna systems; cybersecurity and information assurance products and services; and tactical radio and information distribution systems to enable voice, and real-time collection and dissemination of video and data using secure, and jam-resistant transmission links. The company was founded in 1986 and is headquartered in Carlsbad, California."
VSAT,2020-03-31,130434000,5898000,22355000,-212000,523085000,699551000,38421000,38421000,-38641000,-7915000,2309238000,2270817000,1609687000,-32523000,NA,13813000,-212000,NA,income_statement,Communication Equipment,"ViaSat, Inc.","Viasat, Inc. provides broadband and communications products and services worldwide. It operates through three segments: Satellite Services, Commercial Networks, and Government Systems. The company's Satellite Services segment offers satellite-based fixed broadband services, including broadband internet access and voice over internet protocol services to consumers and businesses; in-flight entertainment, internet, and aviation software services to commercial airlines; community internet services; and mobile broadband services, including satellite-based internet services to energy offshore vessels, cruise ships, consumer ferries, and yachts. As of March 31, 2020, this segment provided broadband Internet services to approximately 590,000 subscribers. Its Commercial Networks segment offers fixed satellite networks comprising satellite network infrastructure and ground terminals; mobile broadband satellite communication systems; and antenna systems for terrestrial and satellite applications, such as earth imaging, remote sensing, mobile satellite communication, Ka-band earth stations, and other multi-band antennas. This segment also provides design and technology services, including analysis, design, development, and specification of satellites and ground systems; application specific integrated circuit and monolithic microwave integrated circuit design; and network function virtualization. The company's Government Systems segment offers various mobile and fixed broadband modems, terminals, network access control systems, and antenna systems; cybersecurity and information assurance products and services; and tactical radio and information distribution systems to enable voice, and real-time collection and dissemination of video and data using secure, and jam-resistant transmission links. The company was founded in 1986 and is headquartered in Carlsbad, California."
VSEC,2016-12-31,NA,41674000,NA,26793000,6609000,74205000,51529000,51529000,-9855000,14881000,691790000,640261000,617585000,-9855000,NA,26793000,26793000,617764000,income_statement,Aerospace & Defense,VSE Corporation,"VSE Corporation operates as a diversified products and services aftermarket company in the United States. The company operates in three segments: Supply Chain Management Group, Aviation Group, and Federal Services Group. The Supply Chain Management Group segment offers sourcing, acquisition, scheduling, transportation, shipping, logistics, data management, and other services to assist its clients with supply chain management. It sells vehicle parts and mission critical supply chain services to support the United States Postal Service (USPS) vehicle fleet and commercial truck fleets; and fleet management and sustainment solutions, and managed inventory services to the Department of Defense (DoD). The Aviation Group segment provides maintenance, repair, and overhaul (MRO) services; and parts supply and distribution for commercial and general aviation jet aircraft engines and engine accessories. It serves commercial airlines, regional airlines, cargo transporters, MRO integrators and providers, aviation manufacturers, corporate and private aircraft owners, and agricultural clients. The Federal Services Group segment offers foreign military sales services and refurbishment services to extend and enhance the life of existing vehicles and equipment; fleet-wide ship and aircraft support; aircraft sustainment and maintenance; and other technical, management, engineering, logistics, maintenance, configuration management, prototyping, technology, and field support services to the U.S. Navy and Marine Corps, U.S. Army and Army Reserve, U.S. Air Force, and other customers. This segment also provides energy consulting services, and IT solutions and services for various DoD and federal civilian agencies. VSE Corporation was founded in 1959 and is headquartered in Alexandria, Virginia."
VSEC,2017-12-31,NA,45085000,NA,39096000,2429000,72771000,54325000,54325000,-9240000,5989000,760113000,705788000,687342000,-9240000,NA,39096000,39096000,617764000,income_statement,Aerospace & Defense,VSE Corporation,"VSE Corporation operates as a diversified products and services aftermarket company in the United States. The company operates in three segments: Supply Chain Management Group, Aviation Group, and Federal Services Group. The Supply Chain Management Group segment offers sourcing, acquisition, scheduling, transportation, shipping, logistics, data management, and other services to assist its clients with supply chain management. It sells vehicle parts and mission critical supply chain services to support the United States Postal Service (USPS) vehicle fleet and commercial truck fleets; and fleet management and sustainment solutions, and managed inventory services to the Department of Defense (DoD). The Aviation Group segment provides maintenance, repair, and overhaul (MRO) services; and parts supply and distribution for commercial and general aviation jet aircraft engines and engine accessories. It serves commercial airlines, regional airlines, cargo transporters, MRO integrators and providers, aviation manufacturers, corporate and private aircraft owners, and agricultural clients. The Federal Services Group segment offers foreign military sales services and refurbishment services to extend and enhance the life of existing vehicles and equipment; fleet-wide ship and aircraft support; aircraft sustainment and maintenance; and other technical, management, engineering, logistics, maintenance, configuration management, prototyping, technology, and field support services to the U.S. Navy and Marine Corps, U.S. Army and Army Reserve, U.S. Air Force, and other customers. This segment also provides energy consulting services, and IT solutions and services for various DoD and federal civilian agencies. VSE Corporation was founded in 1959 and is headquartered in Alexandria, Virginia."
VSEC,2018-12-31,NA,45248000,NA,35080000,3714000,72261000,52530000,52530000,-8982000,10168000,697218000,644688000,624957000,-7282000,NA,35080000,35080000,617764000,income_statement,Aerospace & Defense,VSE Corporation,"VSE Corporation operates as a diversified products and services aftermarket company in the United States. The company operates in three segments: Supply Chain Management Group, Aviation Group, and Federal Services Group. The Supply Chain Management Group segment offers sourcing, acquisition, scheduling, transportation, shipping, logistics, data management, and other services to assist its clients with supply chain management. It sells vehicle parts and mission critical supply chain services to support the United States Postal Service (USPS) vehicle fleet and commercial truck fleets; and fleet management and sustainment solutions, and managed inventory services to the Department of Defense (DoD). The Aviation Group segment provides maintenance, repair, and overhaul (MRO) services; and parts supply and distribution for commercial and general aviation jet aircraft engines and engine accessories. It serves commercial airlines, regional airlines, cargo transporters, MRO integrators and providers, aviation manufacturers, corporate and private aircraft owners, and agricultural clients. The Federal Services Group segment offers foreign military sales services and refurbishment services to extend and enhance the life of existing vehicles and equipment; fleet-wide ship and aircraft support; aircraft sustainment and maintenance; and other technical, management, engineering, logistics, maintenance, configuration management, prototyping, technology, and field support services to the U.S. Navy and Marine Corps, U.S. Army and Army Reserve, U.S. Air Force, and other customers. This segment also provides energy consulting services, and IT solutions and services for various DoD and federal civilian agencies. VSE Corporation was founded in 1959 and is headquartered in Alexandria, Virginia."
VSEC,2019-12-31,NA,46427000,NA,37024000,3784000,83766000,60665000,60665000,-13830000,9403000,752627000,691962000,668861000,-14238000,NA,37024000,37024000,NA,income_statement,Aerospace & Defense,VSE Corporation,"VSE Corporation operates as a diversified products and services aftermarket company in the United States. The company operates in three segments: Supply Chain Management Group, Aviation Group, and Federal Services Group. The Supply Chain Management Group segment offers sourcing, acquisition, scheduling, transportation, shipping, logistics, data management, and other services to assist its clients with supply chain management. It sells vehicle parts and mission critical supply chain services to support the United States Postal Service (USPS) vehicle fleet and commercial truck fleets; and fleet management and sustainment solutions, and managed inventory services to the Department of Defense (DoD). The Aviation Group segment provides maintenance, repair, and overhaul (MRO) services; and parts supply and distribution for commercial and general aviation jet aircraft engines and engine accessories. It serves commercial airlines, regional airlines, cargo transporters, MRO integrators and providers, aviation manufacturers, corporate and private aircraft owners, and agricultural clients. The Federal Services Group segment offers foreign military sales services and refurbishment services to extend and enhance the life of existing vehicles and equipment; fleet-wide ship and aircraft support; aircraft sustainment and maintenance; and other technical, management, engineering, logistics, maintenance, configuration management, prototyping, technology, and field support services to the U.S. Navy and Marine Corps, U.S. Army and Army Reserve, U.S. Air Force, and other customers. This segment also provides energy consulting services, and IT solutions and services for various DoD and federal civilian agencies. VSE Corporation was founded in 1959 and is headquartered in Alexandria, Virginia."
VSTA,2018-12-31,NA,14760000,NA,-4160000,544196000,705832000,163976000,163976000,-129712000,18920000,985444000,821468000,279612000,-149216000,NA,-4160000,-4160000,-11472000,income_statement,Education & Training Services,Vasta Platform Limited,"Vasta Platform Limited, an education company, provides educational and digital solutions to private schools operating in the K-12 educational sector in Brazil. The company operates in two segments, Content & EdTech Platform and Digital Platform. The Content & EdTech Platform segment offers core and complementary educational content solutions through digital and printed content, including textbooks, learning systems, and other complimentary educational services. The Digital Platform segment provides physical and digital e-commerce platform, and other digital services. As of March 31, 2020, its network of business-to-business customers consisted of 4,167 partner schools; and enrolled students included 1,311 thousand. The company also sells textbooks, as well as operates an e-commerce channel for the sale of educational content, such as textbooks, school materials, stationery, and others; and offers university admission preparatory exam courses. It serves various stakeholders, including students, parents, educators, administrators, and private school owners. The company was founded in 1966 and is based in SÃ£o Paulo, Brazil."
VSTA,2019-12-31,NA,-90315000,NA,-60708000,461019000,542634000,82454000,82454000,-133507000,-29607000,989683000,907229000,447049000,-172769000,NA,-60708000,-60708000,-5136000,income_statement,Education & Training Services,Vasta Platform Limited,"Vasta Platform Limited, an education company, provides educational and digital solutions to private schools operating in the K-12 educational sector in Brazil. The company operates in two segments, Content & EdTech Platform and Digital Platform. The Content & EdTech Platform segment offers core and complementary educational content solutions through digital and printed content, including textbooks, learning systems, and other complimentary educational services. The Digital Platform segment provides physical and digital e-commerce platform, and other digital services. As of March 31, 2020, its network of business-to-business customers consisted of 4,167 partner schools; and enrolled students included 1,311 thousand. The company also sells textbooks, as well as operates an e-commerce channel for the sale of educational content, such as textbooks, school materials, stationery, and others; and offers university admission preparatory exam courses. It serves various stakeholders, including students, parents, educators, administrators, and private school owners. The company was founded in 1966 and is based in SÃ£o Paulo, Brazil."
VSTM,2016-12-31,19779000,-36440000,NA,-36440000,17223000,0,-37002000,-37002000,-559000,0,0,37002000,0,562000,NA,-36440000,-36440000,NA,income_statement,Biotechnology,"Verastem, Inc.","Verastem, Inc., a biopharmaceutical company, focusing on developing and commercializing medicines to improve the survival and quality of life of cancer patients. It markets COPIKTRA (duvelisib), an oral inhibitor of phosphoinositide 3-kinase (PI3K) and dual inhibitor of PI3K-delta and PI3K-gamma, which is indicated for the treatment of adult patients with relapsed or refractory chronic lymphocytic leukemia/small lymphocytic lymphoma after at least two prior therapies and relapsed or refractory follicular lymphoma (FL) after at least two prior systemic therapies. The indication in FL is approved under accelerated approval based on overall response rate. In addition, it is developing the focal adhesion kinase inhibitor defactinib, which is being investigated in combination with immunotherapeutic agents for the treatment of various different cancer types, including pancreatic cancer, ovarian cancer, non-small cell lung cancer (NSCLC), mesothelioma, and other solid tumors. Verastem, Inc. has collaboration agreements with Yakult Honsha Co., Ltd. and CSPC Pharmaceutical Group Limited. The company was founded in 2010 and is based in Needham, Massachusetts."
VSTM,2017-12-31,46423000,-67802000,NA,-67802000,21381000,0,-67804000,-67804000,-559000,0,0,67804000,0,2000,NA,-67802000,-67802000,NA,income_statement,Biotechnology,"Verastem, Inc.","Verastem, Inc., a biopharmaceutical company, focusing on developing and commercializing medicines to improve the survival and quality of life of cancer patients. It markets COPIKTRA (duvelisib), an oral inhibitor of phosphoinositide 3-kinase (PI3K) and dual inhibitor of PI3K-delta and PI3K-gamma, which is indicated for the treatment of adult patients with relapsed or refractory chronic lymphocytic leukemia/small lymphocytic lymphoma after at least two prior therapies and relapsed or refractory follicular lymphoma (FL) after at least two prior systemic therapies. The indication in FL is approved under accelerated approval based on overall response rate. In addition, it is developing the focal adhesion kinase inhibitor defactinib, which is being investigated in combination with immunotherapeutic agents for the treatment of various different cancer types, including pancreatic cancer, ovarian cancer, non-small cell lung cancer (NSCLC), mesothelioma, and other solid tumors. Verastem, Inc. has collaboration agreements with Yakult Honsha Co., Ltd. and CSPC Pharmaceutical Group Limited. The company was founded in 2010 and is based in Needham, Massachusetts."
VSTM,2018-12-31,43648000,-72434000,NA,-72434000,77265000,26553000,-94783000,-94783000,-5810000,0,26718000,121501000,165000,22349000,NA,-72434000,-72434000,NA,income_statement,Biotechnology,"Verastem, Inc.","Verastem, Inc., a biopharmaceutical company, focusing on developing and commercializing medicines to improve the survival and quality of life of cancer patients. It markets COPIKTRA (duvelisib), an oral inhibitor of phosphoinositide 3-kinase (PI3K) and dual inhibitor of PI3K-delta and PI3K-gamma, which is indicated for the treatment of adult patients with relapsed or refractory chronic lymphocytic leukemia/small lymphocytic lymphoma after at least two prior therapies and relapsed or refractory follicular lymphoma (FL) after at least two prior systemic therapies. The indication in FL is approved under accelerated approval based on overall response rate. In addition, it is developing the focal adhesion kinase inhibitor defactinib, which is being investigated in combination with immunotherapeutic agents for the treatment of various different cancer types, including pancreatic cancer, ovarian cancer, non-small cell lung cancer (NSCLC), mesothelioma, and other solid tumors. Verastem, Inc. has collaboration agreements with Yakult Honsha Co., Ltd. and CSPC Pharmaceutical Group Limited. The company was founded in 2010 and is based in Needham, Massachusetts."
VSTM,2019-12-31,45778000,-149209000,NA,-149209000,101212000,16218000,-132341000,-132341000,-20608000,0,17456000,149797000,1238000,-16868000,NA,-149209000,-149209000,NA,income_statement,Biotechnology,"Verastem, Inc.","Verastem, Inc., a biopharmaceutical company, focusing on developing and commercializing medicines to improve the survival and quality of life of cancer patients. It markets COPIKTRA (duvelisib), an oral inhibitor of phosphoinositide 3-kinase (PI3K) and dual inhibitor of PI3K-delta and PI3K-gamma, which is indicated for the treatment of adult patients with relapsed or refractory chronic lymphocytic leukemia/small lymphocytic lymphoma after at least two prior therapies and relapsed or refractory follicular lymphoma (FL) after at least two prior systemic therapies. The indication in FL is approved under accelerated approval based on overall response rate. In addition, it is developing the focal adhesion kinase inhibitor defactinib, which is being investigated in combination with immunotherapeutic agents for the treatment of various different cancer types, including pancreatic cancer, ovarian cancer, non-small cell lung cancer (NSCLC), mesothelioma, and other solid tumors. Verastem, Inc. has collaboration agreements with Yakult Honsha Co., Ltd. and CSPC Pharmaceutical Group Limited. The company was founded in 2010 and is based in Needham, Massachusetts."
VTAQ,2019-12-31,NA,-2900,NA,-2900,NA,0,0,NA,NA,0,0,0,0,-2900,NA,-2900,-2900,NA,income_statement,Shell Companies,Ventoux CCM Acquisition Corp.,"Ventoux CCM Acquisition Corp. does not have significant operations. It intends to effect a merger, share exchange, asset acquisition, share purchase, reorganization, or similar business combination with one or more businesses in hospitality, leisure, travel, and dining sectors. The company was founded in 2019 and is based in Greenwich, Connecticut."
VTGN,2017-03-31,4893700,-10253100,NA,-10255500,6604800,1250000,-10248500,-10248500,-4600,2400,1250000,11498500,0,-4600,NA,-10255500,-11623600,NA,income_statement,Biotechnology,"VistaGen Therapeutics, Inc.","VistaGen Therapeutics, Inc., a clinical-stage biopharmaceutical company, engages in developing and commercializing various medicines with the potential to care for anxiety, depression, and other disorders of the central nervous system (CNS). The company's CNS pipeline includes PH94B, a rapid-onset neuroactive nasal spray, which is in preparation for Phase III development for the acute treatment of anxiety in adults with social anxiety disorder. Its PH94B product also has potential to treat a range of anxiety disorders, including adjustment disorder with anxiety, postpartum anxiety, post-traumatic stress disorder, preprocedural anxiety, panic, and others. The company's CNS pipeline also comprises PH10, a rapid-onset neuroactive nasal spray, which is in preparation for Phase 2B clinical development as a stand-alone treatment for major depressive disorder (MDD); and AV-101, an oral N-methyl-D-aspartate receptor antagonist, which is in development in combination with probenecid as a potential treatment of levodopa-induced dyskinesia, MDD, neuropathic pain, and suicidal ideation. It has contract research and development agreement with Cato Research Ltd.; license and option agreements with Pherin Pharmaceuticals, Inc.; license and collaboration agreement with EverInsight Therapeutics Inc.; and license and sublicense agreement with BlueRock Therapeutics, LP. The company was founded in 1998 and is headquartered in South San Francisco, California."
VTGN,2018-03-31,7350500,-14343500,NA,-14345900,6849100,0,-14199600,-14199600,-8900,2400,0,14199600,0,-143900,NA,-14345900,-15575500,NA,income_statement,Biotechnology,"VistaGen Therapeutics, Inc.","VistaGen Therapeutics, Inc., a clinical-stage biopharmaceutical company, engages in developing and commercializing various medicines with the potential to care for anxiety, depression, and other disorders of the central nervous system (CNS). The company's CNS pipeline includes PH94B, a rapid-onset neuroactive nasal spray, which is in preparation for Phase III development for the acute treatment of anxiety in adults with social anxiety disorder. Its PH94B product also has potential to treat a range of anxiety disorders, including adjustment disorder with anxiety, postpartum anxiety, post-traumatic stress disorder, preprocedural anxiety, panic, and others. The company's CNS pipeline also comprises PH10, a rapid-onset neuroactive nasal spray, which is in preparation for Phase 2B clinical development as a stand-alone treatment for major depressive disorder (MDD); and AV-101, an oral N-methyl-D-aspartate receptor antagonist, which is in development in combination with probenecid as a potential treatment of levodopa-induced dyskinesia, MDD, neuropathic pain, and suicidal ideation. It has contract research and development agreement with Cato Research Ltd.; license and option agreements with Pherin Pharmaceuticals, Inc.; license and collaboration agreement with EverInsight Therapeutics Inc.; and license and sublicense agreement with BlueRock Therapeutics, LP. The company was founded in 1998 and is headquartered in South San Francisco, California."
VTGN,2019-03-31,17098500,-24587000,NA,-24589600,7457800,0,-24556300,-24556300,-8000,2600,0,24556300,0,-30700,NA,-24589600,-25729500,NA,income_statement,Biotechnology,"VistaGen Therapeutics, Inc.","VistaGen Therapeutics, Inc., a clinical-stage biopharmaceutical company, engages in developing and commercializing various medicines with the potential to care for anxiety, depression, and other disorders of the central nervous system (CNS). The company's CNS pipeline includes PH94B, a rapid-onset neuroactive nasal spray, which is in preparation for Phase III development for the acute treatment of anxiety in adults with social anxiety disorder. Its PH94B product also has potential to treat a range of anxiety disorders, including adjustment disorder with anxiety, postpartum anxiety, post-traumatic stress disorder, preprocedural anxiety, panic, and others. The company's CNS pipeline also comprises PH10, a rapid-onset neuroactive nasal spray, which is in preparation for Phase 2B clinical development as a stand-alone treatment for major depressive disorder (MDD); and AV-101, an oral N-methyl-D-aspartate receptor antagonist, which is in development in combination with probenecid as a potential treatment of levodopa-induced dyskinesia, MDD, neuropathic pain, and suicidal ideation. It has contract research and development agreement with Cato Research Ltd.; license and option agreements with Pherin Pharmaceuticals, Inc.; license and collaboration agreement with EverInsight Therapeutics Inc.; and license and sublicense agreement with BlueRock Therapeutics, LP. The company was founded in 1998 and is headquartered in South San Francisco, California."
VTGN,2020-03-31,12839200,-20771400,NA,-20774000,7962300,0,-20801500,-20801500,-14900,2600,0,20801500,0,30100,NA,-20774000,-22037600,NA,income_statement,Biotechnology,"VistaGen Therapeutics, Inc.","VistaGen Therapeutics, Inc., a clinical-stage biopharmaceutical company, engages in developing and commercializing various medicines with the potential to care for anxiety, depression, and other disorders of the central nervous system (CNS). The company's CNS pipeline includes PH94B, a rapid-onset neuroactive nasal spray, which is in preparation for Phase III development for the acute treatment of anxiety in adults with social anxiety disorder. Its PH94B product also has potential to treat a range of anxiety disorders, including adjustment disorder with anxiety, postpartum anxiety, post-traumatic stress disorder, preprocedural anxiety, panic, and others. The company's CNS pipeline also comprises PH10, a rapid-onset neuroactive nasal spray, which is in preparation for Phase 2B clinical development as a stand-alone treatment for major depressive disorder (MDD); and AV-101, an oral N-methyl-D-aspartate receptor antagonist, which is in development in combination with probenecid as a potential treatment of levodopa-induced dyskinesia, MDD, neuropathic pain, and suicidal ideation. It has contract research and development agreement with Cato Research Ltd.; license and option agreements with Pherin Pharmaceuticals, Inc.; license and collaboration agreement with EverInsight Therapeutics Inc.; and license and sublicense agreement with BlueRock Therapeutics, LP. The company was founded in 1998 and is headquartered in South San Francisco, California."
VTNR,2016-12-31,NA,-4068288,103897,-3952821,20154399,16319100,-10112514,-10112514,-3094956,-117646,98078914,108191428,81759814,6044226,NA,-3950642,-15537395,NA,income_statement,Oil & Gas Refining & Marketing,"Vertex Energy, Inc","Vertex Energy, Inc., an environmental services company, provides a range of services designed to aggregate, process, and recycle industrial and commercial waste systems in the Gulf Coast and Central Midwest regions of the United States. The company operates in three segments: Black Oil, Refining and Marketing, and Recovery. The Black Oil segment collects and purchases used motor oil directly from third-party generators; aggregates used motor oil from a network of local and regional collectors; and sells used motor oil to customers for use as a feedstock or replacement fuel for industrial burners. It also produces and sells a vacuum gas oil product to refineries and marine fuels market; and base oil product to lubricant packagers and distributors. The Refining and Marketing segment gathers hydrocarbon streams in the form of petroleum distillates, transmix, and other chemical products that are purchased from pipeline operators, refineries, chemical processing facilities, and third-party providers; and sells end products, such as gasoline blendstock, pygas, and fuel oil cutter stock to oil companies or to petroleum trading and blending companies. The Recovery segment generates solutions for the recovery and management of hydrocarbon streams; and owns and operates a fleet of trucks and other vehicles used for shipping and handling equipment and scrap materials. Vertex Energy, Inc. is headquartered in Houston, Texas."
VTNR,2017-12-31,NA,-8412548,399005,-8433233,21685542,21272603,-7056263,-7056263,-3483062,-274423,145499092,152555355,124226489,-1356285,NA,-8138125,-11824602,NA,income_statement,Oil & Gas Refining & Marketing,"Vertex Energy, Inc","Vertex Energy, Inc., an environmental services company, provides a range of services designed to aggregate, process, and recycle industrial and commercial waste systems in the Gulf Coast and Central Midwest regions of the United States. The company operates in three segments: Black Oil, Refining and Marketing, and Recovery. The Black Oil segment collects and purchases used motor oil directly from third-party generators; aggregates used motor oil from a network of local and regional collectors; and sells used motor oil to customers for use as a feedstock or replacement fuel for industrial burners. It also produces and sells a vacuum gas oil product to refineries and marine fuels market; and base oil product to lubricant packagers and distributors. The Refining and Marketing segment gathers hydrocarbon streams in the form of petroleum distillates, transmix, and other chemical products that are purchased from pipeline operators, refineries, chemical processing facilities, and third-party providers; and sells end products, such as gasoline blendstock, pygas, and fuel oil cutter stock to oil companies or to petroleum trading and blending companies. The Recovery segment generates solutions for the recovery and management of hydrocarbon streams; and owns and operates a fleet of trucks and other vehicles used for shipping and handling equipment and scrap materials. Vertex Energy, Inc. is headquartered in Houston, Texas."
VTNR,2018-12-31,NA,-1983579,1438213,-2217767,21927264,29406622,488348,488348,-3281855,0,180720661,180232313,151314039,-2471927,NA,-1983579,-8037304,NA,income_statement,Oil & Gas Refining & Marketing,"Vertex Energy, Inc","Vertex Energy, Inc., an environmental services company, provides a range of services designed to aggregate, process, and recycle industrial and commercial waste systems in the Gulf Coast and Central Midwest regions of the United States. The company operates in three segments: Black Oil, Refining and Marketing, and Recovery. The Black Oil segment collects and purchases used motor oil directly from third-party generators; aggregates used motor oil from a network of local and regional collectors; and sells used motor oil to customers for use as a feedstock or replacement fuel for industrial burners. It also produces and sells a vacuum gas oil product to refineries and marine fuels market; and base oil product to lubricant packagers and distributors. The Refining and Marketing segment gathers hydrocarbon streams in the form of petroleum distillates, transmix, and other chemical products that are purchased from pipeline operators, refineries, chemical processing facilities, and third-party providers; and sells end products, such as gasoline blendstock, pygas, and fuel oil cutter stock to oil companies or to petroleum trading and blending companies. The Recovery segment generates solutions for the recovery and management of hydrocarbon streams; and owns and operates a fleet of trucks and other vehicles used for shipping and handling equipment and scrap materials. Vertex Energy, Inc. is headquartered in Houston, Texas."
VTNR,2019-12-31,NA,-5485553,5174267,-5048579,24182407,28588452,-2774044,-2774044,-3070071,0,163365565,166139609,134777113,-2711509,NA,-5485553,-11445628,NA,income_statement,Oil & Gas Refining & Marketing,"Vertex Energy, Inc","Vertex Energy, Inc., an environmental services company, provides a range of services designed to aggregate, process, and recycle industrial and commercial waste systems in the Gulf Coast and Central Midwest regions of the United States. The company operates in three segments: Black Oil, Refining and Marketing, and Recovery. The Black Oil segment collects and purchases used motor oil directly from third-party generators; aggregates used motor oil from a network of local and regional collectors; and sells used motor oil to customers for use as a feedstock or replacement fuel for industrial burners. It also produces and sells a vacuum gas oil product to refineries and marine fuels market; and base oil product to lubricant packagers and distributors. The Refining and Marketing segment gathers hydrocarbon streams in the form of petroleum distillates, transmix, and other chemical products that are purchased from pipeline operators, refineries, chemical processing facilities, and third-party providers; and sells end products, such as gasoline blendstock, pygas, and fuel oil cutter stock to oil companies or to petroleum trading and blending companies. The Recovery segment generates solutions for the recovery and management of hydrocarbon streams; and owns and operates a fleet of trucks and other vehicles used for shipping and handling equipment and scrap materials. Vertex Energy, Inc. is headquartered in Houston, Texas."
VTR,2016-12-31,NA,621069000,269241000,649231000,126875000,2004931000,979132000,979132000,-419740000,-31343000,3447004000,2467872000,1442073000,-358063000,-922000,652412000,649231000,NA,income_statement,NA,NA,NA
VTR,2017-12-31,NA,1301423000,224449000,1356470000,135490000,2081091000,1057653000,1057653000,-448196000,-59799000,3567554000,2509901000,1486463000,243770000,-110000,1361222000,1356470000,NA,income_statement,NA,NA,NA
VTR,2018-12-31,NA,376038000,243878000,409467000,151982000,2010286000,938665000,938665000,-442497000,-39953000,3701584000,2762919000,1691298000,-562627000,-10000,415991000,409467000,NA,income_statement,NA,NA,NA
VTR,2019-12-31,NA,382987000,373238000,433016000,165996000,2048785000,837169000,837169000,-451662000,-56310000,3859312000,3022143000,1810527000,-454182000,NA,439297000,433016000,NA,income_statement,NA,NA,NA
VTRS,2016-12-31,697800000,121700000,1400000,480000000,2351400000,4998500000,1949300000,1949300000,-454800000,-358300000,11076900000,9127600000,6078400000,-1827600000,NA,480000000,480000000,NA,income_statement,NA,NA,NA
VTRS,2017-12-31,665600000,903000000,NA,696000000,2564000000,4976200000,1746600000,1746600000,-534600000,207000000,11907700000,10161100000,6931500000,-843600000,NA,696000000,696000000,NA,income_statement,NA,NA,NA
VTRS,2018-12-31,586300000,298400000,NA,352500000,2397300000,4572000000,1588400000,1588400000,-542300000,-54100000,11433900000,9845500000,6861900000,-1290000000,NA,352500000,352500000,NA,income_statement,NA,NA,NA
VTRS,2019-12-31,518800000,154400000,NA,16800000,2499600000,4551900000,1533500000,1533500000,-517300000,137600000,11500500000,9967000000,6948600000,-1379100000,NA,16800000,16800000,NA,income_statement,NA,NA,NA
VTRU,2018-12-31,NA,-50215000,NA,-45204000,127956000,199288000,70291000,70291000,-62517000,-5011000,383449000,313158000,184161000,-120506000,NA,-45204000,-45204000,1041000,income_statement,Education & Training Services,Vitru Limited,"Vitru Limited operates as a distance learning education company in the postsecondary digital education market in Brazil. The company offers distance learning undergraduate courses in hybrid methodology, which consists of weekly in-person meetings with on-site tutors. Its courses comprise primary of pedagogy, business administration, accounting, physical education, vocational, engineering, and health-related courses. The company also offer continuing education courses primarily in pedagogy, finance and business, as well as in other subjects, such as law, engineering, IT, and health-related courses through hybrid model, online, and on-campus. In addition, it operates 10 campuses that offers traditional on campus undergraduate courses, including business administration, accounting, physical education, vocational, engineering, law, and health-related courses. The company was founded in 2014 and is based in FlorianÃ³polis, Brazil."
VTRU,2019-12-31,NA,-77052000,NA,-66160000,175457000,249706000,73344000,73344000,-56651000,-10892000,461067000,387723000,211361000,-150396000,NA,-66160000,-66160000,905000,income_statement,Education & Training Services,Vitru Limited,"Vitru Limited operates as a distance learning education company in the postsecondary digital education market in Brazil. The company offers distance learning undergraduate courses in hybrid methodology, which consists of weekly in-person meetings with on-site tutors. Its courses comprise primary of pedagogy, business administration, accounting, physical education, vocational, engineering, and health-related courses. The company also offer continuing education courses primarily in pedagogy, finance and business, as well as in other subjects, such as law, engineering, IT, and health-related courses through hybrid model, online, and on-campus. In addition, it operates 10 campuses that offers traditional on campus undergraduate courses, including business administration, accounting, physical education, vocational, engineering, law, and health-related courses. The company was founded in 2014 and is based in FlorianÃ³polis, Brazil."
VTSI,2016-12-31,1084590,2152774,NA,2050022,6431194,9682110,2166326,2166326,NA,102752,15652168,13485842,5970058,-13552,NA,2050022,2050022,NA,income_statement,Aerospace & Defense,"VirTra, Inc.","VirTra, Inc. provides force training simulators, firearms training simulators, and driving simulators for law enforcement, military, educational, and civilian worldwide. The company's products comprise V-300 simulator, a 300 degree wrap-around screen for simulation training; V-180 simulator, a 180 degree screen for smaller spaces or budgets; V-100, a single-screen based simulator system; V-100 MIL, a single-screen small arms training simulator; and V-ST PRO, a realistic single screen firearms shooting and skills training simulator. It also offers V-Author, a software that allows users to create, edit, and train with content specific to agency's objectives; Simulated Recoil Kits, a range of realistic and reliable simulated recoil kits/weapons; and Threat-Fire, a return fire device that applies real-world stress on the trainees during simulation training. In addition, the company provides VirTra Driving Sim, a vehicle-based simulator; Virtual Interactive Coursework Training Academy, which enables law enforcement agencies to each, train, test, and sustain departmental training requirements; Subscription Training Equipment Partnership, a program that allows agencies to utilize VirTra's simulator products, accessories, and V-VICTA interactive coursework on a subscription basis; and TASER, an OC spray and low-light training devices. It sells its simulators and related products through a direct sales force and distribution partners. The company was formerly known as VirTra Systems, Inc. and changed its name to VirTra, Inc. in October 2016. VirTra, Inc. was founded in 1993 and is based in Tempe, Arizona."
VTSI,2017-12-31,1285064,756990,NA,3262282,7641765,10233346,1306517,1306517,NA,-2505292,16524225,15217708,6290879,-549527,NA,3262282,3262282,NA,income_statement,Aerospace & Defense,"VirTra, Inc.","VirTra, Inc. provides force training simulators, firearms training simulators, and driving simulators for law enforcement, military, educational, and civilian worldwide. The company's products comprise V-300 simulator, a 300 degree wrap-around screen for simulation training; V-180 simulator, a 180 degree screen for smaller spaces or budgets; V-100, a single-screen based simulator system; V-100 MIL, a single-screen small arms training simulator; and V-ST PRO, a realistic single screen firearms shooting and skills training simulator. It also offers V-Author, a software that allows users to create, edit, and train with content specific to agency's objectives; Simulated Recoil Kits, a range of realistic and reliable simulated recoil kits/weapons; and Threat-Fire, a return fire device that applies real-world stress on the trainees during simulation training. In addition, the company provides VirTra Driving Sim, a vehicle-based simulator; Virtual Interactive Coursework Training Academy, which enables law enforcement agencies to each, train, test, and sustain departmental training requirements; Subscription Training Equipment Partnership, a program that allows agencies to utilize VirTra's simulator products, accessories, and V-VICTA interactive coursework on a subscription basis; and TASER, an OC spray and low-light training devices. It sells its simulators and related products through a direct sales force and distribution partners. The company was formerly known as VirTra Systems, Inc. and changed its name to VirTra, Inc. in October 2016. VirTra, Inc. was founded in 1993 and is based in Tempe, Arizona."
VTSI,2018-12-31,1357982,1128090,NA,818092,8425144,11049840,1266714,1266714,NA,309998,18080126,16813412,7030286,-138624,NA,818092,818092,NA,income_statement,Aerospace & Defense,"VirTra, Inc.","VirTra, Inc. provides force training simulators, firearms training simulators, and driving simulators for law enforcement, military, educational, and civilian worldwide. The company's products comprise V-300 simulator, a 300 degree wrap-around screen for simulation training; V-180 simulator, a 180 degree screen for smaller spaces or budgets; V-100, a single-screen based simulator system; V-100 MIL, a single-screen small arms training simulator; and V-ST PRO, a realistic single screen firearms shooting and skills training simulator. It also offers V-Author, a software that allows users to create, edit, and train with content specific to agency's objectives; Simulated Recoil Kits, a range of realistic and reliable simulated recoil kits/weapons; and Threat-Fire, a return fire device that applies real-world stress on the trainees during simulation training. In addition, the company provides VirTra Driving Sim, a vehicle-based simulator; Virtual Interactive Coursework Training Academy, which enables law enforcement agencies to each, train, test, and sustain departmental training requirements; Subscription Training Equipment Partnership, a program that allows agencies to utilize VirTra's simulator products, accessories, and V-VICTA interactive coursework on a subscription basis; and TASER, an OC spray and low-light training devices. It sells its simulators and related products through a direct sales force and distribution partners. The company was formerly known as VirTra Systems, Inc. and changed its name to VirTra, Inc. in October 2016. VirTra, Inc. was founded in 1993 and is based in Tempe, Arizona."
VTSI,2019-12-31,1345513,371448,NA,-75277,7997686,9713691,370492,370492,NA,446725,18711923,18341431,8998232,956,NA,-75277,-75277,NA,income_statement,Aerospace & Defense,"VirTra, Inc.","VirTra, Inc. provides force training simulators, firearms training simulators, and driving simulators for law enforcement, military, educational, and civilian worldwide. The company's products comprise V-300 simulator, a 300 degree wrap-around screen for simulation training; V-180 simulator, a 180 degree screen for smaller spaces or budgets; V-100, a single-screen based simulator system; V-100 MIL, a single-screen small arms training simulator; and V-ST PRO, a realistic single screen firearms shooting and skills training simulator. It also offers V-Author, a software that allows users to create, edit, and train with content specific to agency's objectives; Simulated Recoil Kits, a range of realistic and reliable simulated recoil kits/weapons; and Threat-Fire, a return fire device that applies real-world stress on the trainees during simulation training. In addition, the company provides VirTra Driving Sim, a vehicle-based simulator; Virtual Interactive Coursework Training Academy, which enables law enforcement agencies to each, train, test, and sustain departmental training requirements; Subscription Training Equipment Partnership, a program that allows agencies to utilize VirTra's simulator products, accessories, and V-VICTA interactive coursework on a subscription basis; and TASER, an OC spray and low-light training devices. It sells its simulators and related products through a direct sales force and distribution partners. The company was formerly known as VirTra Systems, Inc. and changed its name to VirTra, Inc. in October 2016. VirTra, Inc. was founded in 1993 and is based in Tempe, Arizona."
VTVT,2016-12-31,39640000,-55353000,122515000,-16352000,9906000,-45114000,-55020000,-55020000,-398000,0,634000,55654000,45748000,-333000,NA,-55353000,-16352000,NA,income_statement,Biotechnology,vTv Therapeutics Inc.,"vTv Therapeutics Inc., a clinical-stage biopharmaceutical company, discovers and develops orally administered small molecule drug candidates to fill unmet medical needs. The company is developing Azeliragon, an orally administered, small molecule antagonist targeting the receptor for advanced glycation end products, which is in Phase II clinical trials for the treatment of mild Alzheimer's disease. It is also developing TTP399, an orally administered, liver-selective glucokinase activator that has completed Phase II clinical trials to treat type 2 diabetes, as well as is in Phase II/III clinical trials for treating type 1 diabetes; and TTP273, an orally administered, non-peptidic agonist that targets the glucagon-like peptide-1 receptor, which has completed Phase II clinical trials for the treatment of type 2 diabetes. In addition, the company is developing HPP737, HPP971, and HPP3033 for the treatment of chronic disease. It has a license agreement with Reneo Pharmaceuticals, Inc. to develop and commercialize peroxisome proliferation activated receptor delta agonist program, including the compound HPP593. vTv Therapeutics Inc. also has license and research agreements with Hangzhou Zhongmei Huadong Pharmaceutical Co., Ltd.; Newsoara Biopharma Co., Ltd.; JDRF International; Novo Nordisk A/S; and Columbia University. The company was founded in 2015 and is headquartered in High Point, North Carolina. vTv Therapeutics Inc. is a subsidiary of MacAndrews & Forbes Incorporated."
VTVT,2017-12-31,39640000,-53847000,131440000,-16144000,11333000,-39349000,-50682000,-50682000,-3092000,800000,291000,50973000,39640000,-3165000,NA,-54647000,-16144000,NA,income_statement,Biotechnology,vTv Therapeutics Inc.,"vTv Therapeutics Inc., a clinical-stage biopharmaceutical company, discovers and develops orally administered small molecule drug candidates to fill unmet medical needs. The company is developing Azeliragon, an orally administered, small molecule antagonist targeting the receptor for advanced glycation end products, which is in Phase II clinical trials for the treatment of mild Alzheimer's disease. It is also developing TTP399, an orally administered, liver-selective glucokinase activator that has completed Phase II clinical trials to treat type 2 diabetes, as well as is in Phase II/III clinical trials for treating type 1 diabetes; and TTP273, an orally administered, non-peptidic agonist that targets the glucagon-like peptide-1 receptor, which has completed Phase II clinical trials for the treatment of type 2 diabetes. In addition, the company is developing HPP737, HPP971, and HPP3033 for the treatment of chronic disease. It has a license agreement with Reneo Pharmaceuticals, Inc. to develop and commercialize peroxisome proliferation activated receptor delta agonist program, including the compound HPP593. vTv Therapeutics Inc. also has license and research agreements with Hangzhou Zhongmei Huadong Pharmaceutical Co., Ltd.; Newsoara Biopharma Co., Ltd.; JDRF International; Novo Nordisk A/S; and Columbia University. The company was founded in 2015 and is headquartered in High Point, North Carolina. vTv Therapeutics Inc. is a subsidiary of MacAndrews & Forbes Incorporated."
VTVT,2018-12-31,NA,-23645000,62482000,-7911000,9223000,-10601000,-19824000,-19824000,-3290000,200000,12434000,32258000,23035000,-3821000,NA,-23845000,-8650000,NA,income_statement,Biotechnology,vTv Therapeutics Inc.,"vTv Therapeutics Inc., a clinical-stage biopharmaceutical company, discovers and develops orally administered small molecule drug candidates to fill unmet medical needs. The company is developing Azeliragon, an orally administered, small molecule antagonist targeting the receptor for advanced glycation end products, which is in Phase II clinical trials for the treatment of mild Alzheimer's disease. It is also developing TTP399, an orally administered, liver-selective glucokinase activator that has completed Phase II clinical trials to treat type 2 diabetes, as well as is in Phase II/III clinical trials for treating type 1 diabetes; and TTP273, an orally administered, non-peptidic agonist that targets the glucagon-like peptide-1 receptor, which has completed Phase II clinical trials for the treatment of type 2 diabetes. In addition, the company is developing HPP737, HPP971, and HPP3033 for the treatment of chronic disease. It has a license agreement with Reneo Pharmaceuticals, Inc. to develop and commercialize peroxisome proliferation activated receptor delta agonist program, including the compound HPP593. vTv Therapeutics Inc. also has license and research agreements with Hangzhou Zhongmei Huadong Pharmaceutical Co., Ltd.; Newsoara Biopharma Co., Ltd.; JDRF International; Novo Nordisk A/S; and Columbia University. The company was founded in 2015 and is headquartered in High Point, North Carolina. vTv Therapeutics Inc. is a subsidiary of MacAndrews & Forbes Incorporated."
VTVT,2019-12-31,NA,-21838000,40183000,-13044000,8537000,-12355000,-20892000,-20892000,-1827000,100000,2764000,23656000,15119000,-946000,NA,-21938000,-17913000,NA,income_statement,Biotechnology,vTv Therapeutics Inc.,"vTv Therapeutics Inc., a clinical-stage biopharmaceutical company, discovers and develops orally administered small molecule drug candidates to fill unmet medical needs. The company is developing Azeliragon, an orally administered, small molecule antagonist targeting the receptor for advanced glycation end products, which is in Phase II clinical trials for the treatment of mild Alzheimer's disease. It is also developing TTP399, an orally administered, liver-selective glucokinase activator that has completed Phase II clinical trials to treat type 2 diabetes, as well as is in Phase II/III clinical trials for treating type 1 diabetes; and TTP273, an orally administered, non-peptidic agonist that targets the glucagon-like peptide-1 receptor, which has completed Phase II clinical trials for the treatment of type 2 diabetes. In addition, the company is developing HPP737, HPP971, and HPP3033 for the treatment of chronic disease. It has a license agreement with Reneo Pharmaceuticals, Inc. to develop and commercialize peroxisome proliferation activated receptor delta agonist program, including the compound HPP593. vTv Therapeutics Inc. also has license and research agreements with Hangzhou Zhongmei Huadong Pharmaceutical Co., Ltd.; Newsoara Biopharma Co., Ltd.; JDRF International; Novo Nordisk A/S; and Columbia University. The company was founded in 2015 and is headquartered in High Point, North Carolina. vTv Therapeutics Inc. is a subsidiary of MacAndrews & Forbes Incorporated."
VUZI,2016-12-31,6947878,-19250082,NA,-19250082,8508719,-2287989,-18567525,-18567525,-664519,0,2127378,20694903,4415367,-682557,NA,-19250082,-20870130,52271,income_statement,Consumer Electronics,Vuzix Corporation,"Vuzix Corporation designs, manufactures, markets, and sells augmented reality (AR) wearable display and computing devices for consumer and enterprise markets. The company offers its products in the form of smart glasses and AR glasses. Its personal display and wearable computing devices offer users a portable viewing experience; provide solutions for mobility; wearable displays; and virtual and augmented reality. The company's wearable display devices are worn like eyeglasses and attached to head-worn mounts; and these devices typically include cameras, sensors, and a computer that enable a user to view, record, and interact with video and digital content such as computer data, the Internet, social media, and entertainment applications. The company was formerly known as Icuiti Corporation and changed its name to Vuzix Corporation in September 2007. Vuzix Corporation was founded in 1997 and is headquartered in West Henrietta, New York. It also has offices in Rochester, New York; Oxford, the United Kingdom; and Tokyo, Japan."
VUZI,2017-12-31,6706690,-19633502,NA,-19633502,9821248,-1828080,-19382909,-19382909,-263494,0,5537753,24920662,7365833,-250593,NA,-19633502,-21348436,28363,income_statement,Consumer Electronics,Vuzix Corporation,"Vuzix Corporation designs, manufactures, markets, and sells augmented reality (AR) wearable display and computing devices for consumer and enterprise markets. The company offers its products in the form of smart glasses and AR glasses. Its personal display and wearable computing devices offer users a portable viewing experience; provide solutions for mobility; wearable displays; and virtual and augmented reality. The company's wearable display devices are worn like eyeglasses and attached to head-worn mounts; and these devices typically include cameras, sensors, and a computer that enable a user to view, record, and interact with video and digital content such as computer data, the Internet, social media, and entertainment applications. The company was formerly known as Icuiti Corporation and changed its name to Vuzix Corporation in September 2007. Vuzix Corporation was founded in 1997 and is headquartered in West Henrietta, New York. It also has offices in Rochester, New York; Oxford, the United Kingdom; and Tokyo, Japan."
VUZI,2018-12-31,10378728,-21875713,NA,-21875713,11795877,1979698,-21722488,-21722488,-19332,0,8094368,29816856,6114670,-153225,NA,-21875713,-23695881,57917,income_statement,Consumer Electronics,Vuzix Corporation,"Vuzix Corporation designs, manufactures, markets, and sells augmented reality (AR) wearable display and computing devices for consumer and enterprise markets. The company offers its products in the form of smart glasses and AR glasses. Its personal display and wearable computing devices offer users a portable viewing experience; provide solutions for mobility; wearable displays; and virtual and augmented reality. The company's wearable display devices are worn like eyeglasses and attached to head-worn mounts; and these devices typically include cameras, sensors, and a computer that enable a user to view, record, and interact with video and digital content such as computer data, the Internet, social media, and entertainment applications. The company was formerly known as Icuiti Corporation and changed its name to Vuzix Corporation in September 2007. Vuzix Corporation was founded in 1997 and is headquartered in West Henrietta, New York. It also has offices in Rochester, New York; Oxford, the United Kingdom; and Tokyo, Japan."
VUZI,2019-12-31,8900837,-26476370,NA,-26476370,10815703,-4408121,-26676511,-26676511,NA,0,6670604,33347115,11078725,200141,NA,-26476370,-28408230,110269,income_statement,Consumer Electronics,Vuzix Corporation,"Vuzix Corporation designs, manufactures, markets, and sells augmented reality (AR) wearable display and computing devices for consumer and enterprise markets. The company offers its products in the form of smart glasses and AR glasses. Its personal display and wearable computing devices offer users a portable viewing experience; provide solutions for mobility; wearable displays; and virtual and augmented reality. The company's wearable display devices are worn like eyeglasses and attached to head-worn mounts; and these devices typically include cameras, sensors, and a computer that enable a user to view, record, and interact with video and digital content such as computer data, the Internet, social media, and entertainment applications. The company was formerly known as Icuiti Corporation and changed its name to Vuzix Corporation in September 2007. Vuzix Corporation was founded in 1997 and is headquartered in West Henrietta, New York. It also has offices in Rochester, New York; Oxford, the United Kingdom; and Tokyo, Japan."
VVOS,2018-12-31,NA,-8439156,NA,-8439156,10436129,2710620,-8336182,-8336182,-102974,0,3792261,12128443,1081641,-102974,NA,-8439156,-9439156,NA,income_statement,Medical Devices,"Vivos Therapeutics, Inc.","Vivos Therapeutics, Inc., a medical technology company, engages in the development and commercialization of technology solutions for patients with sleep disordered breathing (SDB) comprising mild-to-moderate obstructive sleep apnea (OSA). The company's solutions cover proprietary alternatives for treating mild-to-moderate OSA; craniofacial and anatomical anomalies that are associated with mild-to-moderate OSA. Its treatment for OSA involves specially designed and customized oral appliances and treatment protocols. The company, through its Vivos Integrated Healthcare Network, provides access to healthcare providers for delivering care for patients suffering from sleep disordered breathing, including mild-to-moderate OSA. Vivos Therapeutics, Inc. also licenses its intellectual property to third-party manufacturers, which fabricate appliance devices for healthcare professionals. It caters to general dentists, medical doctors, myofunctional therapists, chiropractors, healthcare providers, and patients in the United States and Canada. Vivos Therapeutics, Inc. was founded in 2007 and is based in Highlands Ranch, Colorado."
VVOS,2019-12-31,NA,-10754319,NA,-10754319,18483248,8657243,-10577233,-10577233,-137876,0,11393277,21970510,2736034,-177086,NA,-10754319,-11754319,NA,income_statement,Medical Devices,"Vivos Therapeutics, Inc.","Vivos Therapeutics, Inc., a medical technology company, engages in the development and commercialization of technology solutions for patients with sleep disordered breathing (SDB) comprising mild-to-moderate obstructive sleep apnea (OSA). The company's solutions cover proprietary alternatives for treating mild-to-moderate OSA; craniofacial and anatomical anomalies that are associated with mild-to-moderate OSA. Its treatment for OSA involves specially designed and customized oral appliances and treatment protocols. The company, through its Vivos Integrated Healthcare Network, provides access to healthcare providers for delivering care for patients suffering from sleep disordered breathing, including mild-to-moderate OSA. Vivos Therapeutics, Inc. also licenses its intellectual property to third-party manufacturers, which fabricate appliance devices for healthcare professionals. It caters to general dentists, medical doctors, myofunctional therapists, chiropractors, healthcare providers, and patients in the United States and Canada. Vivos Therapeutics, Inc. was founded in 2007 and is based in Highlands Ranch, Colorado."
VVPR,2018-03-31,NA,-34137000,184000,-27879000,12814000,5123000,-8951000,-8951000,-3145000,-6258000,33647000,42598000,28524000,-25186000,NA,-27879000,-27879000,NA,income_statement,Solar,VivoPower International PLC,"VivoPower International PLC, together with its subsidiaries, operates as a solar and critical power services company in the United States, Australia, and the United Kingdom. It operates through Critical Power Services and Solar Development segments. The Critical Power Services segment offers energy infrastructure generation and distribution solutions, including the design, supply, installation, and maintenance of power and control systems to a range of government, and commercial and industrial customers. The Solar Development segment engages in the origination, development, construction, financing, operation, optimization, and sale of photovoltaic solar projects. The company was founded in 2014 and is headquartered in London, the United Kingdom."
VVPR,2019-03-31,NA,-10666000,184000,-11223000,7685000,6310000,-2795000,-2795000,-3243000,557000,39036000,41831000,32726000,-7867000,NA,-11223000,-11223000,NA,income_statement,Solar,VivoPower International PLC,"VivoPower International PLC, together with its subsidiaries, operates as a solar and critical power services company in the United States, Australia, and the United Kingdom. It operates through Critical Power Services and Solar Development segments. The Critical Power Services segment offers energy infrastructure generation and distribution solutions, including the design, supply, installation, and maintenance of power and control systems to a range of government, and commercial and industrial customers. The Solar Development segment engages in the origination, development, construction, financing, operation, optimization, and sale of photovoltaic solar projects. The company was founded in 2014 and is headquartered in London, the United Kingdom."
VVPR,2019-06-30,NA,-5416000,184000,-5784000,5164000,6628000,-284000,-284000,-3092000,368000,54468000,54752000,47840000,-5132000,NA,-5784000,-5784000,NA,income_statement,Solar,VivoPower International PLC,"VivoPower International PLC, together with its subsidiaries, operates as a solar and critical power services company in the United States, Australia, and the United Kingdom. It operates through Critical Power Services and Solar Development segments. The Critical Power Services segment offers energy infrastructure generation and distribution solutions, including the design, supply, installation, and maintenance of power and control systems to a range of government, and commercial and industrial customers. The Solar Development segment engages in the origination, development, construction, financing, operation, optimization, and sale of photovoltaic solar projects. The company was founded in 2014 and is headquartered in London, the United Kingdom."
VVPR,2020-06-30,NA,-4390000,184000,-5103000,5479000,7825000,580000,580000,-3107000,713000,48710000,48130000,40885000,-4970000,NA,-5103000,-5103000,NA,income_statement,Solar,VivoPower International PLC,"VivoPower International PLC, together with its subsidiaries, operates as a solar and critical power services company in the United States, Australia, and the United Kingdom. It operates through Critical Power Services and Solar Development segments. The Critical Power Services segment offers energy infrastructure generation and distribution solutions, including the design, supply, installation, and maintenance of power and control systems to a range of government, and commercial and industrial customers. The Solar Development segment engages in the origination, development, construction, financing, operation, optimization, and sale of photovoltaic solar projects. The company was founded in 2014 and is headquartered in London, the United Kingdom."
VXRT,2016-12-31,14540000,-16362000,NA,-16362000,3234000,-9487000,-12721000,-12721000,-3943000,0,8147000,20868000,17634000,-3641000,NA,-16362000,-19248000,NA,income_statement,Biotechnology,"Vaxart, Inc. - Common Stock","Vaxart, Inc., a clinical-stage biotechnology company, engages in the discovery and development of oral recombinant protein vaccines based on its proprietary oral vaccine platform. The company's product pipeline includes norovirus vaccine, an oral tablet vaccine, which has completed Phase I clinical trials with bivalent oral tablet vaccine for the GI.1 and GII.4 norovirus strains; seasonal influenza vaccine, which is in Phase II clinical trials for treatment of H1 influenza infection; respiratory syncytial virus vaccine; and coronavirus vaccine. It is also developing therapeutic immune-oncology vaccines for cervical cancer and dysplasia caused by human papillomavirus. The company has a research collaboration agreement with Janssen Vaccines & Prevention B.V. (Janssen) to evaluate the company's proprietary oral vaccine platform for the Janssen universal influenza vaccine program. Vaxart, Inc. is headquartered in South San Francisco, California."
VXRT,2017-12-31,14540000,-9582000,NA,-9582000,2599000,-6516000,-9115000,-9115000,-3036000,0,5839000,14954000,12355000,-467000,NA,-9582000,-12460000,NA,income_statement,Biotechnology,"Vaxart, Inc. - Common Stock","Vaxart, Inc., a clinical-stage biotechnology company, engages in the discovery and development of oral recombinant protein vaccines based on its proprietary oral vaccine platform. The company's product pipeline includes norovirus vaccine, an oral tablet vaccine, which has completed Phase I clinical trials with bivalent oral tablet vaccine for the GI.1 and GII.4 norovirus strains; seasonal influenza vaccine, which is in Phase II clinical trials for treatment of H1 influenza infection; respiratory syncytial virus vaccine; and coronavirus vaccine. It is also developing therapeutic immune-oncology vaccines for cervical cancer and dysplasia caused by human papillomavirus. The company has a research collaboration agreement with Janssen Vaccines & Prevention B.V. (Janssen) to evaluate the company's proprietary oral vaccine platform for the Janssen universal influenza vaccine program. Vaxart, Inc. is headquartered in South San Francisco, California."
VXRT,2018-12-31,14540000,-17898000,NA,-18007000,6681000,-13116000,-19797000,-19797000,-2680000,109000,4159000,23956000,17275000,1899000,NA,-18007000,-18346000,NA,income_statement,Biotechnology,"Vaxart, Inc. - Common Stock","Vaxart, Inc., a clinical-stage biotechnology company, engages in the discovery and development of oral recombinant protein vaccines based on its proprietary oral vaccine platform. The company's product pipeline includes norovirus vaccine, an oral tablet vaccine, which has completed Phase I clinical trials with bivalent oral tablet vaccine for the GI.1 and GII.4 norovirus strains; seasonal influenza vaccine, which is in Phase II clinical trials for treatment of H1 influenza infection; respiratory syncytial virus vaccine; and coronavirus vaccine. It is also developing therapeutic immune-oncology vaccines for cervical cancer and dysplasia caused by human papillomavirus. The company has a research collaboration agreement with Janssen Vaccines & Prevention B.V. (Janssen) to evaluate the company's proprietary oral vaccine platform for the Janssen universal influenza vaccine program. Vaxart, Inc. is headquartered in South San Francisco, California."
VXRT,2019-12-31,14540000,-18155000,NA,-18645000,6187000,-4678000,-10865000,-10865000,-2388000,490000,9862000,20727000,14540000,-7290000,NA,-18645000,-18645000,NA,income_statement,Biotechnology,"Vaxart, Inc. - Common Stock","Vaxart, Inc., a clinical-stage biotechnology company, engages in the discovery and development of oral recombinant protein vaccines based on its proprietary oral vaccine platform. The company's product pipeline includes norovirus vaccine, an oral tablet vaccine, which has completed Phase I clinical trials with bivalent oral tablet vaccine for the GI.1 and GII.4 norovirus strains; seasonal influenza vaccine, which is in Phase II clinical trials for treatment of H1 influenza infection; respiratory syncytial virus vaccine; and coronavirus vaccine. It is also developing therapeutic immune-oncology vaccines for cervical cancer and dysplasia caused by human papillomavirus. The company has a research collaboration agreement with Janssen Vaccines & Prevention B.V. (Janssen) to evaluate the company's proprietary oral vaccine platform for the Janssen universal influenza vaccine program. Vaxart, Inc. is headquartered in South San Francisco, California."
VYGR,2016-12-31,NA,-40141000,NA,-40193000,13270000,-28029000,-41299000,-41299000,NA,52000,14220000,55519000,42249000,1158000,NA,-40193000,-40193000,NA,income_statement,Biotechnology,"Voyager Therapeutics, Inc.","Voyager Therapeutics, Inc., a clinical-stage gene therapy company, focuses on the development of treatments for patients suffering from severe neurological diseases. The company's lead clinical candidate is the VY-AADC, which is in open-label Phase 1b clinical trial for the treatment of Parkinson's disease. Its preclinical programs comprise VY-SOD102 for the treatment of amyotrophic lateral sclerosis; VY-HTT01 for Huntington's disease; VY-FXN01 for Friedreich's ataxia; Tau program for the treatment of tauopathies, including Alzheimer's disease, progressive supranuclear palsy, and frontotemporal dementia; and alpha-synuclein program for synucleinopathies, Parkinson's disease, Lewy Body Dementia, and multiple system atrophy. The company has strategic collaboration agreements with the University of Massachusetts; and ClearPoint Neuro, Inc., as well as collaborations with Brammer Bio and Fujifilm Diosynth Biotechnologies to support the development of its gene therapy programs. It also has a collaboration and license agreement with Neurocrine Biosciences, Inc. for the research, development, and commercialization of adeno-associated virus-based gene therapy products. Voyager Therapeutics, Inc. was founded in 2013 and is headquartered in Cambridge, Massachusetts."
VYGR,2017-12-31,NA,-70698000,NA,-70698000,19738000,-52125000,-71863000,-71863000,NA,0,10135000,81998000,62260000,1165000,NA,-70698000,-70698000,NA,income_statement,Biotechnology,"Voyager Therapeutics, Inc.","Voyager Therapeutics, Inc., a clinical-stage gene therapy company, focuses on the development of treatments for patients suffering from severe neurological diseases. The company's lead clinical candidate is the VY-AADC, which is in open-label Phase 1b clinical trial for the treatment of Parkinson's disease. Its preclinical programs comprise VY-SOD102 for the treatment of amyotrophic lateral sclerosis; VY-HTT01 for Huntington's disease; VY-FXN01 for Friedreich's ataxia; Tau program for the treatment of tauopathies, including Alzheimer's disease, progressive supranuclear palsy, and frontotemporal dementia; and alpha-synuclein program for synucleinopathies, Parkinson's disease, Lewy Body Dementia, and multiple system atrophy. The company has strategic collaboration agreements with the University of Massachusetts; and ClearPoint Neuro, Inc., as well as collaborations with Brammer Bio and Fujifilm Diosynth Biotechnologies to support the development of its gene therapy programs. It also has a collaboration and license agreement with Neurocrine Biosciences, Inc. for the research, development, and commercialization of adeno-associated virus-based gene therapy products. Voyager Therapeutics, Inc. was founded in 2013 and is headquartered in Cambridge, Massachusetts."
VYGR,2018-12-31,NA,-88468000,NA,-88288000,33809000,-57286000,-91095000,-91095000,NA,-180000,7619000,98714000,64905000,2627000,NA,-88288000,-88288000,NA,income_statement,Biotechnology,"Voyager Therapeutics, Inc.","Voyager Therapeutics, Inc., a clinical-stage gene therapy company, focuses on the development of treatments for patients suffering from severe neurological diseases. The company's lead clinical candidate is the VY-AADC, which is in open-label Phase 1b clinical trial for the treatment of Parkinson's disease. Its preclinical programs comprise VY-SOD102 for the treatment of amyotrophic lateral sclerosis; VY-HTT01 for Huntington's disease; VY-FXN01 for Friedreich's ataxia; Tau program for the treatment of tauopathies, including Alzheimer's disease, progressive supranuclear palsy, and frontotemporal dementia; and alpha-synuclein program for synucleinopathies, Parkinson's disease, Lewy Body Dementia, and multiple system atrophy. The company has strategic collaboration agreements with the University of Massachusetts; and ClearPoint Neuro, Inc., as well as collaborations with Brammer Bio and Fujifilm Diosynth Biotechnologies to support the development of its gene therapy programs. It also has a collaboration and license agreement with Neurocrine Biosciences, Inc. for the research, development, and commercialization of adeno-associated virus-based gene therapy products. Voyager Therapeutics, Inc. was founded in 2013 and is headquartered in Cambridge, Massachusetts."
VYGR,2019-12-31,NA,-43597000,NA,-43597000,36335000,-15344000,-51679000,-51679000,NA,0,104391000,156070000,119735000,8082000,NA,-43597000,-43597000,NA,income_statement,Biotechnology,"Voyager Therapeutics, Inc.","Voyager Therapeutics, Inc., a clinical-stage gene therapy company, focuses on the development of treatments for patients suffering from severe neurological diseases. The company's lead clinical candidate is the VY-AADC, which is in open-label Phase 1b clinical trial for the treatment of Parkinson's disease. Its preclinical programs comprise VY-SOD102 for the treatment of amyotrophic lateral sclerosis; VY-HTT01 for Huntington's disease; VY-FXN01 for Friedreich's ataxia; Tau program for the treatment of tauopathies, including Alzheimer's disease, progressive supranuclear palsy, and frontotemporal dementia; and alpha-synuclein program for synucleinopathies, Parkinson's disease, Lewy Body Dementia, and multiple system atrophy. The company has strategic collaboration agreements with the University of Massachusetts; and ClearPoint Neuro, Inc., as well as collaborations with Brammer Bio and Fujifilm Diosynth Biotechnologies to support the development of its gene therapy programs. It also has a collaboration and license agreement with Neurocrine Biosciences, Inc. for the research, development, and commercialization of adeno-associated virus-based gene therapy products. Voyager Therapeutics, Inc. was founded in 2013 and is headquartered in Cambridge, Massachusetts."
VYNE,2016-12-31,25897000,-28949000,NA,-29336000,9221000,5468000,-29650000,-29650000,-243000,387000,5527000,35177000,59000,701000,NA,-29336000,-29336000,NA,income_statement,Biotechnology,VYNE Therapeutics Inc.,"VYNE Therapeutics Inc., a pharmaceutical company, focuses on developing and commercializing various therapeutics for dermatology. It offers AMZEEQ, a topical minocycline used for the treatment of inflammatory lesions of non-nodular moderate-to-severe acne vulgaris in patients 9 years of age and older. The company is also developing FMX103, which is in Phase III clinical trials for the treatment of moderate-to-severe papulopustular rosacea in adults; and FCD105, a topical combination foam that is in Phase II clinical trials for the treatment of moderate-to-severe acne vulgaris. In addition, it is developing Serlopitant, a once-daily oral NK1 receptor antagonist, used as a treatment option for pruritus associated with prurigo nodularis. The company was formerly known as Menlo Therapeutics Inc. and changed its name to VYNE Therapeutics Inc. in September 2020. VYNE Therapeutics Inc. was founded in 2003 and is headquartered in Bridgewater, New Jersey."
VYNE,2017-12-31,57779000,-64551000,NA,-65715000,11491000,3656000,-65614000,-65614000,-921000,1164000,3669000,69283000,13000,1063000,NA,-65715000,-65715000,NA,income_statement,Biotechnology,VYNE Therapeutics Inc.,"VYNE Therapeutics Inc., a pharmaceutical company, focuses on developing and commercializing various therapeutics for dermatology. It offers AMZEEQ, a topical minocycline used for the treatment of inflammatory lesions of non-nodular moderate-to-severe acne vulgaris in patients 9 years of age and older. The company is also developing FMX103, which is in Phase III clinical trials for the treatment of moderate-to-severe papulopustular rosacea in adults; and FCD105, a topical combination foam that is in Phase II clinical trials for the treatment of moderate-to-severe acne vulgaris. In addition, it is developing Serlopitant, a once-daily oral NK1 receptor antagonist, used as a treatment option for pruritus associated with prurigo nodularis. The company was formerly known as Menlo Therapeutics Inc. and changed its name to VYNE Therapeutics Inc. in September 2020. VYNE Therapeutics Inc. was founded in 2003 and is headquartered in Bridgewater, New Jersey."
VYNE,2018-12-31,64474000,-73951000,NA,-74163000,14013000,3595000,-74892000,-74892000,-921000,212000,3595000,78487000,0,941000,NA,-74163000,-74163000,NA,income_statement,Biotechnology,VYNE Therapeutics Inc.,"VYNE Therapeutics Inc., a pharmaceutical company, focuses on developing and commercializing various therapeutics for dermatology. It offers AMZEEQ, a topical minocycline used for the treatment of inflammatory lesions of non-nodular moderate-to-severe acne vulgaris in patients 9 years of age and older. The company is also developing FMX103, which is in Phase III clinical trials for the treatment of moderate-to-severe papulopustular rosacea in adults; and FCD105, a topical combination foam that is in Phase II clinical trials for the treatment of moderate-to-severe acne vulgaris. In addition, it is developing Serlopitant, a once-daily oral NK1 receptor antagonist, used as a treatment option for pruritus associated with prurigo nodularis. The company was formerly known as Menlo Therapeutics Inc. and changed its name to VYNE Therapeutics Inc. in September 2020. VYNE Therapeutics Inc. was founded in 2003 and is headquartered in Bridgewater, New Jersey."
VYNE,2019-12-31,50408000,-95354000,NA,-95178000,45908000,443000,-95873000,-95873000,-921000,-176000,443000,96316000,0,519000,NA,-95178000,-95178000,NA,income_statement,Biotechnology,VYNE Therapeutics Inc.,"VYNE Therapeutics Inc., a pharmaceutical company, focuses on developing and commercializing various therapeutics for dermatology. It offers AMZEEQ, a topical minocycline used for the treatment of inflammatory lesions of non-nodular moderate-to-severe acne vulgaris in patients 9 years of age and older. The company is also developing FMX103, which is in Phase III clinical trials for the treatment of moderate-to-severe papulopustular rosacea in adults; and FCD105, a topical combination foam that is in Phase II clinical trials for the treatment of moderate-to-severe acne vulgaris. In addition, it is developing Serlopitant, a once-daily oral NK1 receptor antagonist, used as a treatment option for pruritus associated with prurigo nodularis. The company was formerly known as Menlo Therapeutics Inc. and changed its name to VYNE Therapeutics Inc. in September 2020. VYNE Therapeutics Inc. was founded in 2003 and is headquartered in Bridgewater, New Jersey."
VZ,2017-12-31,NA,20594000000,1591000000,30101000000,27344000000,72971000000,28673000000,28673000000,-4733000000,-9956000000,126034000000,97361000000,53063000000,-8079000000,NA,30550000000,30101000000,NA,income_statement,NA,NA,NA
VZ,2018-12-31,NA,19623000000,1565000000,15528000000,27287000000,75658000000,30991000000,30991000000,-4833000000,3584000000,130863000000,99872000000,55205000000,-11368000000,NA,16039000000,15528000000,NA,income_statement,NA,NA,NA
VZ,2019-12-31,NA,22733000000,1440000000,19265000000,28939000000,77142000000,31521000000,31521000000,-4730000000,2945000000,131868000000,100347000000,54726000000,-8788000000,NA,19788000000,19265000000,NA,income_statement,NA,NA,NA
VZ,2020-12-31,NA,23967000000,1430000000,17801000000,31573000000,77091000000,28798000000,28798000000,-4247000000,5619000000,128292000000,99494000000,51201000000,-4831000000,NA,18348000000,17801000000,NA,income_statement,NA,NA,NA
WAB,2016-12-31,71375000,412837000,770848000,304887000,364068000,924239000,466098000,466098000,-50298000,99433000,2931188000,2465090000,2006949000,-53261000,NA,313404000,303973000,NA,income_statement,NA,NA,NA
WAB,2017-12-31,95200000,352100000,19664000,262300000,472700000,1077300000,472900000,472900000,-79900000,89800000,3881700000,3408800000,2804400000,-120800000,NA,262300000,261600000,NA,income_statement,NA,NA,NA
WAB,2018-12-31,87500000,367600000,3900000,294900000,583200000,1251900000,541400000,541400000,-112200000,75900000,4363500000,3822100000,3111600000,-173800000,NA,291700000,294200000,NA,income_statement,NA,NA,NA
WAB,2019-12-31,209900000,446800000,37100000,326700000,1093700000,2501000000,959000000,959000000,-219100000,120300000,8200000000,7241000000,5699000000,-512200000,NA,326500000,325300000,NA,income_statement,NA,NA,NA
WABC,2017-12-31,NA,87172000,NA,50025000,83877000,194315000,0,95791000,NA,37147000,194315000,98524000,0,-8619000,NA,50025000,50025000,14647000,income_statement,Banks—Regional,Westamerica Bancorporation,"Westamerica Bancorporation operates as a bank holding company for Westamerica Bank that provides various banking products and services to individual and commercial customers. The company accepts various deposit products, including retail savings and checking accounts, as well as certificates of deposit. Its loan portfolio includes commercial, commercial and residential real estate, real estate construction, and consumer installment loans, as well as other loans primarily consisting of indirect automobile loans. Westamerica Bancorporation operates through 80 branch offices in 21 counties in Northern and Central California. The company was formerly known as Independent Bankshares Corporation and changed its name to Westamerica Bancorporation in 1983. Westamerica Bancorporation was founded in 1972 and is headquartered in San Rafael, California."
WABC,2018-12-31,NA,90997000,NA,71564000,86536000,197328000,0,95833000,NA,19433000,197328000,101495000,0,-4836000,NA,71564000,71564000,14959000,income_statement,Banks—Regional,Westamerica Bancorporation,"Westamerica Bancorporation operates as a bank holding company for Westamerica Bank that provides various banking products and services to individual and commercial customers. The company accepts various deposit products, including retail savings and checking accounts, as well as certificates of deposit. Its loan portfolio includes commercial, commercial and residential real estate, real estate construction, and consumer installment loans, as well as other loans primarily consisting of indirect automobile loans. Westamerica Bancorporation operates through 80 branch offices in 21 counties in Northern and Central California. The company was formerly known as Independent Bankshares Corporation and changed its name to Westamerica Bancorporation in 1983. Westamerica Bancorporation was founded in 1972 and is headquartered in San Rafael, California."
WABC,2019-12-31,NA,105216000,NA,80389000,85108000,203769000,0,105874000,NA,24827000,203769000,97895000,0,-658000,NA,80389000,80389000,12787000,income_statement,Banks—Regional,Westamerica Bancorporation,"Westamerica Bancorporation operates as a bank holding company for Westamerica Bank that provides various banking products and services to individual and commercial customers. The company accepts various deposit products, including retail savings and checking accounts, as well as certificates of deposit. Its loan portfolio includes commercial, commercial and residential real estate, real estate construction, and consumer installment loans, as well as other loans primarily consisting of indirect automobile loans. Westamerica Bancorporation operates through 80 branch offices in 21 counties in Northern and Central California. The company was formerly known as Independent Bankshares Corporation and changed its name to Westamerica Bancorporation in 1983. Westamerica Bancorporation was founded in 1972 and is headquartered in San Rafael, California."
WABC,2020-12-31,NA,106803000,NA,80413000,84236000,205369000,0,107090000,NA,26390000,205369000,98279000,0,-287000,NA,80413000,80413000,14043000,income_statement,Banks—Regional,Westamerica Bancorporation,"Westamerica Bancorporation operates as a bank holding company for Westamerica Bank that provides various banking products and services to individual and commercial customers. The company accepts various deposit products, including retail savings and checking accounts, as well as certificates of deposit. Its loan portfolio includes commercial, commercial and residential real estate, real estate construction, and consumer installment loans, as well as other loans primarily consisting of indirect automobile loans. Westamerica Bancorporation operates through 80 branch offices in 21 counties in Northern and Central California. The company was formerly known as Independent Bankshares Corporation and changed its name to Westamerica Bancorporation in 1983. Westamerica Bancorporation was founded in 1972 and is headquartered in San Rafael, California."
WAFD,2017-09-30,NA,256216000,NA,173532000,176376000,486241000,0,266132000,NA,82684000,486241000,220109000,0,-9916000,NA,173532000,173532000,43733000,income_statement,Banks—Regional,"Washington Federal, Inc.","Washington Federal, Inc. operates as the bank holding company for Washington Federal Bank, National Association that provides lending, depository, insurance, and other banking services in the United States. The company accepts deposit products, including business and personal checking accounts, and term certificates of deposit, as well as money market accounts and passbook savings accounts. It also provides single-family residential, construction, land acquisition and development, consumer lot, multi-family residential, commercial and industrial, commercial real estate, home equity, and consumer loans. In addition, the company offers insurance brokerage services, such as individual and business insurance policies to customers and general public; holds and markets real estate properties; mobile and internet banking services; debit and credit cards; and acts as trustee. It serves consumers, mid-sized and large businesses, and owners and developers of commercial real estate. As of September 30, 2020, the company had 234 branches located in Washington, Oregon, Idaho, Arizona, Utah, Nevada, New Mexico, and Texas. Washington Federal, Inc. was founded in 1917 and is headquartered in Seattle, Washington."
WAFD,2018-09-30,NA,257243000,NA,203850000,194650000,521667000,0,268937000,NA,53393000,521667000,252730000,0,-11694000,NA,203850000,203850000,58080000,income_statement,Banks—Regional,"Washington Federal, Inc.","Washington Federal, Inc. operates as the bank holding company for Washington Federal Bank, National Association that provides lending, depository, insurance, and other banking services in the United States. The company accepts deposit products, including business and personal checking accounts, and term certificates of deposit, as well as money market accounts and passbook savings accounts. It also provides single-family residential, construction, land acquisition and development, consumer lot, multi-family residential, commercial and industrial, commercial real estate, home equity, and consumer loans. In addition, the company offers insurance brokerage services, such as individual and business insurance policies to customers and general public; holds and markets real estate properties; mobile and internet banking services; debit and credit cards; and acts as trustee. It serves consumers, mid-sized and large businesses, and owners and developers of commercial real estate. As of September 30, 2020, the company had 234 branches located in Washington, Oregon, Idaho, Arizona, Utah, Nevada, New Mexico, and Texas. Washington Federal, Inc. was founded in 1917 and is headquartered in Seattle, Washington."
WAFD,2019-09-30,NA,262775000,NA,210256000,211122000,545028000,0,271773000,NA,52519000,545028000,273255000,0,-8998000,NA,210256000,210256000,62133000,income_statement,Banks—Regional,"Washington Federal, Inc.","Washington Federal, Inc. operates as the bank holding company for Washington Federal Bank, National Association that provides lending, depository, insurance, and other banking services in the United States. The company accepts deposit products, including business and personal checking accounts, and term certificates of deposit, as well as money market accounts and passbook savings accounts. It also provides single-family residential, construction, land acquisition and development, consumer lot, multi-family residential, commercial and industrial, commercial real estate, home equity, and consumer loans. In addition, the company offers insurance brokerage services, such as individual and business insurance policies to customers and general public; holds and markets real estate properties; mobile and internet banking services; debit and credit cards; and acts as trustee. It serves consumers, mid-sized and large businesses, and owners and developers of commercial real estate. As of September 30, 2020, the company had 234 branches located in Washington, Oregon, Idaho, Arizona, Utah, Nevada, New Mexico, and Texas. Washington Federal, Inc. was founded in 1917 and is headquartered in Seattle, Washington."
WAFD,2020-09-30,NA,219186000,NA,173438000,234168000,548527000,0,249808000,NA,45748000,548527000,298719000,0,-30622000,NA,173438000,173438000,64551000,income_statement,Banks—Regional,"Washington Federal, Inc.","Washington Federal, Inc. operates as the bank holding company for Washington Federal Bank, National Association that provides lending, depository, insurance, and other banking services in the United States. The company accepts deposit products, including business and personal checking accounts, and term certificates of deposit, as well as money market accounts and passbook savings accounts. It also provides single-family residential, construction, land acquisition and development, consumer lot, multi-family residential, commercial and industrial, commercial real estate, home equity, and consumer loans. In addition, the company offers insurance brokerage services, such as individual and business insurance policies to customers and general public; holds and markets real estate properties; mobile and internet banking services; debit and credit cards; and acts as trustee. It serves consumers, mid-sized and large businesses, and owners and developers of commercial real estate. As of September 30, 2020, the company had 234 branches located in Washington, Oregon, Idaho, Arizona, Utah, Nevada, New Mexico, and Texas. Washington Federal, Inc. was founded in 1917 and is headquartered in Seattle, Washington."
WAFU,2017-03-31,NA,723183,101797,572701,2362477,3054737,658812,658812,NA,105952,5172688,4513876,2117951,64371,NA,617231,572701,33448,income_statement,Education & Training Services,Wah Fu Education Group Limited,"Wah Fu Education Group Limited, through its subsidiaries, provides online exam preparation services and related technology solutions in the People's Republic of China. The company operates in two segments, Online Education Services; and Technological Development and Operation Services. The Online Education Services segment offers online education platforms to institutions, such as universities and training institutions, and online course development service companies. This segment provides self-study examination, continuing education, and non-diploma training platforms that allow students to enroll in courses for college credit; vocational education 1+X and higher vocational enrollment expansion teaching and educational administration platform; Huafu e-school system and paperless examination platform; and online training and examination preparation services directly to students. The Technological Development and Operation Services segment develops and maintains online education platforms and online courses for its clients, including universities and government agencies, as well as private clients, such as publishers; and provides consulting, maintenance, and updating services related to online education programs. Wah Fu Education Group Limited was founded in 1999 and is headquartered in Beijing, the People's Republic of China."
WAFU,2018-03-31,NA,1295500,217596,1144603,2665906,3765528,1072494,1072494,NA,92023,5967896,4895402,2202368,223006,NA,1203477,1144603,27128,income_statement,Education & Training Services,Wah Fu Education Group Limited,"Wah Fu Education Group Limited, through its subsidiaries, provides online exam preparation services and related technology solutions in the People's Republic of China. The company operates in two segments, Online Education Services; and Technological Development and Operation Services. The Online Education Services segment offers online education platforms to institutions, such as universities and training institutions, and online course development service companies. This segment provides self-study examination, continuing education, and non-diploma training platforms that allow students to enroll in courses for college credit; vocational education 1+X and higher vocational enrollment expansion teaching and educational administration platform; Huafu e-school system and paperless examination platform; and online training and examination preparation services directly to students. The Technological Development and Operation Services segment develops and maintains online education platforms and online courses for its clients, including universities and government agencies, as well as private clients, such as publishers; and provides consulting, maintenance, and updating services related to online education programs. Wah Fu Education Group Limited was founded in 1999 and is headquartered in Beijing, the People's Republic of China."
WAFU,2019-03-31,NA,-1115331,211353,-946183,3742235,2541692,-1238591,-1238591,NA,-96804,5358023,6596614,2816331,123260,NA,-1018527,-946183,38048,income_statement,Education & Training Services,Wah Fu Education Group Limited,"Wah Fu Education Group Limited, through its subsidiaries, provides online exam preparation services and related technology solutions in the People's Republic of China. The company operates in two segments, Online Education Services; and Technological Development and Operation Services. The Online Education Services segment offers online education platforms to institutions, such as universities and training institutions, and online course development service companies. This segment provides self-study examination, continuing education, and non-diploma training platforms that allow students to enroll in courses for college credit; vocational education 1+X and higher vocational enrollment expansion teaching and educational administration platform; Huafu e-school system and paperless examination platform; and online training and examination preparation services directly to students. The Technological Development and Operation Services segment develops and maintains online education platforms and online courses for its clients, including universities and government agencies, as well as private clients, such as publishers; and provides consulting, maintenance, and updating services related to online education programs. Wah Fu Education Group Limited was founded in 1999 and is headquartered in Beijing, the People's Republic of China."
WAFU,2020-03-31,NA,-1428589,234540,-1688701,3821589,2290782,-1571184,-1571184,NA,212498,5637370,7208554,3346588,142595,NA,-1641087,-1688701,40377,income_statement,Education & Training Services,Wah Fu Education Group Limited,"Wah Fu Education Group Limited, through its subsidiaries, provides online exam preparation services and related technology solutions in the People's Republic of China. The company operates in two segments, Online Education Services; and Technological Development and Operation Services. The Online Education Services segment offers online education platforms to institutions, such as universities and training institutions, and online course development service companies. This segment provides self-study examination, continuing education, and non-diploma training platforms that allow students to enroll in courses for college credit; vocational education 1+X and higher vocational enrollment expansion teaching and educational administration platform; Huafu e-school system and paperless examination platform; and online training and examination preparation services directly to students. The Technological Development and Operation Services segment develops and maintains online education platforms and online courses for its clients, including universities and government agencies, as well as private clients, such as publishers; and provides consulting, maintenance, and updating services related to online education programs. Wah Fu Education Group Limited was founded in 1999 and is headquartered in Beijing, the People's Republic of China."
WASH,2017-12-31,NA,77640000,NA,45925000,92465000,181740000,0,79679000,NA,31715000,181740000,102061000,0,-2039000,NA,45925000,45817000,9596000,income_statement,Banks—Regional,"Washington Trust Bancorp, Inc.","Washington Trust Bancorp, Inc. operates as the bank holding company for The Washington Trust Company, of Westerly that offers various financial services to individuals and businesses. The company operates in two segments, Commercial Banking and Wealth Management Services. The Commercial Banking segment provides various commercial and retail lending products, which include commercial real estate loans consisting of commercial mortgages and construction loans; commercial and industrial loans; residential real estate loans consists of mortgage and homeowner construction loans; and consumer loans comprising home equity loans and lines of credit, personal installment loans, and loans to individuals secured by general aviation aircraft. This segment also offers deposit accounts, including interest-bearing and noninterest-bearing demand deposits, NOW and savings accounts, money market and retirement deposit accounts, and time deposits, as well as debit card, automated teller machines, telephone, internet, mobile banking, remote deposit capture, and other cash management services. The Wealth Management Services segment provides investment management; financial planning; personal trust and estate services, such as trustee, personal representative, custodian, and guardian; and settlement of decedents' estates, as well as institutional trust services comprising custody and fiduciary services. This segment serves personal and institutional clients. The company also operates as a licensed broker-dealer that offers variable annuities and college savings plans. As of December 31, 2019, it had 10 branch offices located in southern Rhode Island; 12 branch offices located in the greater Providence area in Rhode Island; and one branch office located in southeastern Connecticut. Washington Trust Bancorp, Inc. was founded in 1800 and is headquartered in Westerly, Rhode Island."
WASH,2018-12-31,NA,86692000,NA,68432000,94297000,192854000,0,88796000,NA,18260000,192854000,104058000,0,-2104000,NA,68432000,68288000,9761000,income_statement,Banks—Regional,"Washington Trust Bancorp, Inc.","Washington Trust Bancorp, Inc. operates as the bank holding company for The Washington Trust Company, of Westerly that offers various financial services to individuals and businesses. The company operates in two segments, Commercial Banking and Wealth Management Services. The Commercial Banking segment provides various commercial and retail lending products, which include commercial real estate loans consisting of commercial mortgages and construction loans; commercial and industrial loans; residential real estate loans consists of mortgage and homeowner construction loans; and consumer loans comprising home equity loans and lines of credit, personal installment loans, and loans to individuals secured by general aviation aircraft. This segment also offers deposit accounts, including interest-bearing and noninterest-bearing demand deposits, NOW and savings accounts, money market and retirement deposit accounts, and time deposits, as well as debit card, automated teller machines, telephone, internet, mobile banking, remote deposit capture, and other cash management services. The Wealth Management Services segment provides investment management; financial planning; personal trust and estate services, such as trustee, personal representative, custodian, and guardian; and settlement of decedents' estates, as well as institutional trust services comprising custody and fiduciary services. This segment serves personal and institutional clients. The company also operates as a licensed broker-dealer that offers variable annuities and college savings plans. As of December 31, 2019, it had 10 branch offices located in southern Rhode Island; 12 branch offices located in the greater Providence area in Rhode Island; and one branch office located in southeastern Connecticut. Washington Trust Bancorp, Inc. was founded in 1800 and is headquartered in Westerly, Rhode Island."
WASH,2019-12-31,NA,88179000,NA,69118000,99330000,198919000,0,89740000,NA,19061000,198919000,109179000,0,-1561000,NA,69118000,68979000,9849000,income_statement,Banks—Regional,"Washington Trust Bancorp, Inc.","Washington Trust Bancorp, Inc. operates as the bank holding company for The Washington Trust Company, of Westerly that offers various financial services to individuals and businesses. The company operates in two segments, Commercial Banking and Wealth Management Services. The Commercial Banking segment provides various commercial and retail lending products, which include commercial real estate loans consisting of commercial mortgages and construction loans; commercial and industrial loans; residential real estate loans consists of mortgage and homeowner construction loans; and consumer loans comprising home equity loans and lines of credit, personal installment loans, and loans to individuals secured by general aviation aircraft. This segment also offers deposit accounts, including interest-bearing and noninterest-bearing demand deposits, NOW and savings accounts, money market and retirement deposit accounts, and time deposits, as well as debit card, automated teller machines, telephone, internet, mobile banking, remote deposit capture, and other cash management services. The Wealth Management Services segment provides investment management; financial planning; personal trust and estate services, such as trustee, personal representative, custodian, and guardian; and settlement of decedents' estates, as well as institutional trust services comprising custody and fiduciary services. This segment serves personal and institutional clients. The company also operates as a licensed broker-dealer that offers variable annuities and college savings plans. As of December 31, 2019, it had 10 branch offices located in southern Rhode Island; 12 branch offices located in the greater Providence area in Rhode Island; and one branch office located in southeastern Connecticut. Washington Trust Bancorp, Inc. was founded in 1800 and is headquartered in Westerly, Rhode Island."
WASH,2020-12-31,NA,89160000,NA,69829000,111863000,214544000,0,93305000,NA,19331000,214544000,121239000,0,-4145000,NA,69829000,69678000,9376000,income_statement,Banks—Regional,"Washington Trust Bancorp, Inc.","Washington Trust Bancorp, Inc. operates as the bank holding company for The Washington Trust Company, of Westerly that offers various financial services to individuals and businesses. The company operates in two segments, Commercial Banking and Wealth Management Services. The Commercial Banking segment provides various commercial and retail lending products, which include commercial real estate loans consisting of commercial mortgages and construction loans; commercial and industrial loans; residential real estate loans consists of mortgage and homeowner construction loans; and consumer loans comprising home equity loans and lines of credit, personal installment loans, and loans to individuals secured by general aviation aircraft. This segment also offers deposit accounts, including interest-bearing and noninterest-bearing demand deposits, NOW and savings accounts, money market and retirement deposit accounts, and time deposits, as well as debit card, automated teller machines, telephone, internet, mobile banking, remote deposit capture, and other cash management services. The Wealth Management Services segment provides investment management; financial planning; personal trust and estate services, such as trustee, personal representative, custodian, and guardian; and settlement of decedents' estates, as well as institutional trust services comprising custody and fiduciary services. This segment serves personal and institutional clients. The company also operates as a licensed broker-dealer that offers variable annuities and college savings plans. As of December 31, 2019, it had 10 branch offices located in southern Rhode Island; 12 branch offices located in the greater Providence area in Rhode Island; and one branch office located in southeastern Connecticut. Washington Trust Bancorp, Inc. was founded in 1800 and is headquartered in Westerly, Rhode Island."
WAT,2017-12-31,132593000,641097000,NA,20311000,544703000,1362011000,677972000,677972000,-56839000,620786000,2309078000,1631106000,947067000,-36875000,NA,20311000,20311000,NA,income_statement,NA,NA,NA
WAT,2018-12-31,143403000,682146000,NA,593794000,585015000,1427365000,691235000,691235000,-48641000,88352000,2419929000,1728694000,992564000,-9089000,NA,593794000,593794000,NA,income_statement,NA,NA,NA
WAT,2019-12-31,142955000,678239000,NA,592198000,526451000,1395896000,716797000,716797000,-48690000,86041000,2406596000,1689799000,1010700000,-38558000,NA,592198000,592198000,NA,income_statement,NA,NA,NA
WAT,2020-12-31,140777000,610914000,NA,521571000,518737000,1358676000,688575000,688575000,-32800000,89343000,2365365000,1676790000,1006689000,-77661000,NA,521571000,521571000,NA,income_statement,NA,NA,NA
WATT,2016-12-31,32832677,-45817394,NA,-45817394,14449984,1451941,-45830720,-45830720,NA,0,1451941,47282661,0,13326,NA,-45817394,-45817394,NA,income_statement,Scientific & Technical Instruments,Energous Corporation,"Energous Corporation develops wire-free charging solutions. The company develops WattUp wireless power technology that consists of semiconductor chipsets, software controls, hardware designs, and antennas that enables radio frequency based wire-free charging for electronic devices. It has a strategic partnership with Xentris Wireless to develop ruggedized products for military applications using the company's radio frequency based charging technology. The company was formerly known as DvineWave Inc. and changed its name to Energous Corporation in January 2014. Energous Corporation was founded in 2012 and is headquartered in San Jose, California."
WATT,2017-12-31,33230668,-49376875,NA,-49376875,17311169,1154009,-49387828,-49387828,NA,0,1154009,50541837,0,10953,NA,-49376875,-49376875,NA,income_statement,Scientific & Technical Instruments,Energous Corporation,"Energous Corporation develops wire-free charging solutions. The company develops WattUp wireless power technology that consists of semiconductor chipsets, software controls, hardware designs, and antennas that enables radio frequency based wire-free charging for electronic devices. It has a strategic partnership with Xentris Wireless to develop ruggedized products for military applications using the company's radio frequency based charging technology. The company was formerly known as DvineWave Inc. and changed its name to Energous Corporation in January 2014. Energous Corporation was founded in 2012 and is headquartered in San Jose, California."
WATT,2018-12-31,32871685,-50840122,NA,-50840122,18572548,514823,-50929410,-50929410,NA,0,514823,51444233,0,89288,NA,-50840122,-50840122,NA,income_statement,Scientific & Technical Instruments,Energous Corporation,"Energous Corporation develops wire-free charging solutions. The company develops WattUp wireless power technology that consists of semiconductor chipsets, software controls, hardware designs, and antennas that enables radio frequency based wire-free charging for electronic devices. It has a strategic partnership with Xentris Wireless to develop ruggedized products for military applications using the company's radio frequency based charging technology. The company was formerly known as DvineWave Inc. and changed its name to Energous Corporation in January 2014. Energous Corporation was founded in 2012 and is headquartered in San Jose, California."
WATT,2019-12-31,23228810,-38399089,NA,-38399089,15779233,200143,-38807900,-38807900,NA,0,200143,39008043,0,408811,NA,-38399089,-38399089,NA,income_statement,Scientific & Technical Instruments,Energous Corporation,"Energous Corporation develops wire-free charging solutions. The company develops WattUp wireless power technology that consists of semiconductor chipsets, software controls, hardware designs, and antennas that enables radio frequency based wire-free charging for electronic devices. It has a strategic partnership with Xentris Wireless to develop ruggedized products for military applications using the company's radio frequency based charging technology. The company was formerly known as DvineWave Inc. and changed its name to Energous Corporation in January 2014. Energous Corporation was founded in 2012 and is headquartered in San Jose, California."
WBA,2017-08-31,NA,4861000000,808000000,4078000000,23618000000,29162000000,5544000000,5544000000,-643000000,760000000,118214000000,112670000000,89052000000,-683000000,NA,4101000000,4078000000,NA,income_statement,NA,NA,NA
WBA,2018-08-31,NA,6029000000,682000000,5024000000,24638000000,30792000000,6154000000,6154000000,-577000000,998000000,131537000000,125383000000,100745000000,-125000000,NA,5031000000,5024000000,NA,income_statement,NA,NA,NA
WBA,2019-08-31,NA,4550000000,641000000,3982000000,24998000000,30076000000,5078000000,5078000000,-676000000,588000000,136866000000,131788000000,106790000000,-528000000,NA,3962000000,3982000000,NA,income_statement,NA,NA,NA
WBA,2020-08-31,NA,784000000,498000000,456000000,25026000000,28017000000,2991000000,2991000000,-584000000,360000000,139537000000,136546000000,111520000000,-2207000000,NA,424000000,456000000,NA,income_statement,NA,NA,NA
WDAY,2017-01-31,680531000,-385513000,NA,-384699000,763450000,1090895000,-353086000,-353086000,-30103000,-814000,1574440000,1927526000,483545000,-32427000,NA,-384699000,-384699000,NA,income_statement,Software—Application,"Workday, Inc.","Workday, Inc. provides enterprise cloud applications worldwide. Its applications help its customers to manage critical business functions and optimize their financial and human capital resources. The company offers Workday Financial Management application that provides functions of general ledger, accounting, accounts payable and receivable, cash and asset management, revenue management, and grants management, as well as project and resource management, time and expense tracking, project billing, revenue recognition, financial reporting, and analytics. It also provides Workday Human Capital Management (HCM) application, which includes human resources management, such as workforce lifecycle and organization management, compensation, absence, and employee benefits administration; and global talent management comprising goal and performance management, succession planning, and career and development planning, as well as Skills cloud, a machine-learning-powered universal skills language to help source, utilize, develop, and retain talent. In addition, the company offers business planning, analytics, and other solutions, including Insights Business Planning Cloud, a solution for finance, human resource, and sales planning; Workday Prism Analytics that enables customers to bring together various data with analytics tools for financial and people analytics to make business decisions; Workday Student, a student and faculty lifecycle information system to help colleges and universities; and Workday Data-as-a-Service that provides data to customers to enable informed decision-making. It serves technology, financial services, business and professional services, healthcare and life sciences, manufacturing, retail and hospitality, education, and government and non-profit industries. The company was formerly known as North Tahoe Power Tools, Inc. and changed its name to Workday, Inc. in July 2005. Workday, Inc. was founded in 2005 and is headquartered in Pleasanton, California."
WDAY,2018-01-31,910584000,-314786000,NA,-321222000,906276000,1513637000,-303223000,-303223000,-44549000,6436000,2143050000,2446273000,629413000,-11563000,NA,-321222000,-321222000,NA,income_statement,Software—Application,"Workday, Inc.","Workday, Inc. provides enterprise cloud applications worldwide. Its applications help its customers to manage critical business functions and optimize their financial and human capital resources. The company offers Workday Financial Management application that provides functions of general ledger, accounting, accounts payable and receivable, cash and asset management, revenue management, and grants management, as well as project and resource management, time and expense tracking, project billing, revenue recognition, financial reporting, and analytics. It also provides Workday Human Capital Management (HCM) application, which includes human resources management, such as workforce lifecycle and organization management, compensation, absence, and employee benefits administration; and global talent management comprising goal and performance management, succession planning, and career and development planning, as well as Skills cloud, a machine-learning-powered universal skills language to help source, utilize, develop, and retain talent. In addition, the company offers business planning, analytics, and other solutions, including Insights Business Planning Cloud, a solution for finance, human resource, and sales planning; Workday Prism Analytics that enables customers to bring together various data with analytics tools for financial and people analytics to make business decisions; Workday Student, a student and faculty lifecycle information system to help colleges and universities; and Workday Data-as-a-Service that provides data to customers to enable informed decision-making. It serves technology, financial services, business and professional services, healthcare and life sciences, manufacturing, retail and hospitality, education, and government and non-profit industries. The company was formerly known as North Tahoe Power Tools, Inc. and changed its name to Workday, Inc. in July 2005. Workday, Inc. was founded in 2005 and is headquartered in Pleasanton, California."
WDAY,2019-01-31,1211832000,-423752000,NA,-418258000,1213682000,1987230000,-438284000,-438284000,-60209000,-5494000,2822180000,3260464000,834950000,14532000,NA,-418258000,-418258000,NA,income_statement,Software—Application,"Workday, Inc.","Workday, Inc. provides enterprise cloud applications worldwide. Its applications help its customers to manage critical business functions and optimize their financial and human capital resources. The company offers Workday Financial Management application that provides functions of general ledger, accounting, accounts payable and receivable, cash and asset management, revenue management, and grants management, as well as project and resource management, time and expense tracking, project billing, revenue recognition, financial reporting, and analytics. It also provides Workday Human Capital Management (HCM) application, which includes human resources management, such as workforce lifecycle and organization management, compensation, absence, and employee benefits administration; and global talent management comprising goal and performance management, succession planning, and career and development planning, as well as Skills cloud, a machine-learning-powered universal skills language to help source, utilize, develop, and retain talent. In addition, the company offers business planning, analytics, and other solutions, including Insights Business Planning Cloud, a solution for finance, human resource, and sales planning; Workday Prism Analytics that enables customers to bring together various data with analytics tools for financial and people analytics to make business decisions; Workday Student, a student and faculty lifecycle information system to help colleges and universities; and Workday Data-as-a-Service that provides data to customers to enable informed decision-making. It serves technology, financial services, business and professional services, healthcare and life sciences, manufacturing, retail and hospitality, education, and government and non-profit industries. The company was formerly known as North Tahoe Power Tools, Inc. and changed its name to Workday, Inc. in July 2005. Workday, Inc. was founded in 2005 and is headquartered in Pleasanton, California."
WDAY,2020-01-31,1549906000,-482447000,NA,-480674000,1514272000,2561948000,-502230000,-502230000,-58685000,-1773000,3627206000,4129436000,1065258000,19783000,NA,-480674000,-480674000,NA,income_statement,Software—Application,"Workday, Inc.","Workday, Inc. provides enterprise cloud applications worldwide. Its applications help its customers to manage critical business functions and optimize their financial and human capital resources. The company offers Workday Financial Management application that provides functions of general ledger, accounting, accounts payable and receivable, cash and asset management, revenue management, and grants management, as well as project and resource management, time and expense tracking, project billing, revenue recognition, financial reporting, and analytics. It also provides Workday Human Capital Management (HCM) application, which includes human resources management, such as workforce lifecycle and organization management, compensation, absence, and employee benefits administration; and global talent management comprising goal and performance management, succession planning, and career and development planning, as well as Skills cloud, a machine-learning-powered universal skills language to help source, utilize, develop, and retain talent. In addition, the company offers business planning, analytics, and other solutions, including Insights Business Planning Cloud, a solution for finance, human resource, and sales planning; Workday Prism Analytics that enables customers to bring together various data with analytics tools for financial and people analytics to make business decisions; Workday Student, a student and faculty lifecycle information system to help colleges and universities; and Workday Data-as-a-Service that provides data to customers to enable informed decision-making. It serves technology, financial services, business and professional services, healthcare and life sciences, manufacturing, retail and hospitality, education, and government and non-profit industries. The company was formerly known as North Tahoe Power Tools, Inc. and changed its name to Workday, Inc. in July 2005. Workday, Inc. was founded in 2005 and is headquartered in Pleasanton, California."
WDC,2017-06-30,2441000000,769000000,NA,397000000,1445000000,6072000000,2186000000,2186000000,-847000000,372000000,19093000000,16907000000,13021000000,-1417000000,NA,397000000,397000000,NA,income_statement,NA,NA,NA
WDC,2018-06-29,2400000000,2085000000,NA,675000000,1475000000,7705000000,3830000000,3830000000,-676000000,1410000000,20647000000,16817000000,12942000000,-1745000000,NA,675000000,675000000,NA,income_statement,NA,NA,NA
WDC,2019-06-28,2182000000,-287000000,NA,-754000000,1348000000,3752000000,222000000,222000000,-469000000,467000000,16569000000,16347000000,12817000000,-509000000,NA,-754000000,-754000000,NA,income_statement,NA,NA,NA
WDC,2020-07-03,2261000000,-46000000,NA,-250000000,1152000000,3781000000,368000000,368000000,-413000000,204000000,16736000000,16368000000,12955000000,-414000000,NA,-250000000,-250000000,NA,income_statement,NA,NA,NA
WDFC,2017-08-31,NA,74622000,NA,52930000,135097000,213885000,75909000,75909000,-2582000,21692000,380506000,304597000,166621000,-1287000,NA,52930000,52607000,NA,income_statement,Specialty Chemicals,WD-40 Company,"WD-40 Company develops and sells maintenance products, and homecare and cleaning products in the Americas, Europe, the Middle East, Africa, and the Asia-Pacific. The company offers multi-purpose maintenance products, including aerosol sprays, non-aerosol trigger sprays, and in liquid-bulk form products under the WD-40 Multi-Use brand name for various consumer uses and industrial applications; and specialty maintenance products, such as penetrants, degreasers, corrosion inhibitors, greases, lubricants, and rust removers under the WD-40 Specialist brand, as well as various products under the WD-40 Bike brand name. It also provides multi-purpose and specialty drip oils, and spray lubricant products, as well as other specialty maintenance products under the 3-IN-ONE brand name; and professional spray maintenance products and lubricants for the bike market under the GT85 brand name. In addition, the company offers automatic toilet bowl cleaners under the 2000 Flushes brand name; aerosol and liquid trigger carpet stain and odor eliminators under the Spot Shot brand; room and rug deodorizers under the Carpet Fresh brand name; carpet and household cleaners, and rug and room deodorizers under the 1001 brand; heavy-duty hand cleaner products under the Lava brand name in the United States, as well as under the Solvol brand name in Australia; and liquid mildew stain removers and automatic toilet bowl cleaners under the X-14 brand name. It sells its products primarily through warehouse club stores, hardware stores, automotive parts outlets, industrial distributors and suppliers, mass retail and home center stores, value retailers, grocery stores, online retailers, farm supply, sport retailers, and independent bike dealers. WD-40 Company was founded in 1953 and is headquartered in San Diego, California."
WDFC,2018-08-31,NA,75178000,NA,65215000,143708000,225263000,78604000,78604000,-4219000,9963000,408518000,329914000,183255000,-3426000,NA,65215000,64792000,NA,income_statement,Specialty Chemicals,WD-40 Company,"WD-40 Company develops and sells maintenance products, and homecare and cleaning products in the Americas, Europe, the Middle East, Africa, and the Asia-Pacific. The company offers multi-purpose maintenance products, including aerosol sprays, non-aerosol trigger sprays, and in liquid-bulk form products under the WD-40 Multi-Use brand name for various consumer uses and industrial applications; and specialty maintenance products, such as penetrants, degreasers, corrosion inhibitors, greases, lubricants, and rust removers under the WD-40 Specialist brand, as well as various products under the WD-40 Bike brand name. It also provides multi-purpose and specialty drip oils, and spray lubricant products, as well as other specialty maintenance products under the 3-IN-ONE brand name; and professional spray maintenance products and lubricants for the bike market under the GT85 brand name. In addition, the company offers automatic toilet bowl cleaners under the 2000 Flushes brand name; aerosol and liquid trigger carpet stain and odor eliminators under the Spot Shot brand; room and rug deodorizers under the Carpet Fresh brand name; carpet and household cleaners, and rug and room deodorizers under the 1001 brand; heavy-duty hand cleaner products under the Lava brand name in the United States, as well as under the Solvol brand name in Australia; and liquid mildew stain removers and automatic toilet bowl cleaners under the X-14 brand name. It sells its products primarily through warehouse club stores, hardware stores, automotive parts outlets, industrial distributors and suppliers, mass retail and home center stores, value retailers, grocery stores, online retailers, farm supply, sport retailers, and independent bike dealers. WD-40 Company was founded in 1953 and is headquartered in San Diego, California."
WDFC,2019-08-31,NA,80770000,NA,55908000,147252000,232340000,82382000,82382000,-2541000,24862000,423350000,340968000,191010000,-1612000,NA,55908000,55575000,NA,income_statement,Specialty Chemicals,WD-40 Company,"WD-40 Company develops and sells maintenance products, and homecare and cleaning products in the Americas, Europe, the Middle East, Africa, and the Asia-Pacific. The company offers multi-purpose maintenance products, including aerosol sprays, non-aerosol trigger sprays, and in liquid-bulk form products under the WD-40 Multi-Use brand name for various consumer uses and industrial applications; and specialty maintenance products, such as penetrants, degreasers, corrosion inhibitors, greases, lubricants, and rust removers under the WD-40 Specialist brand, as well as various products under the WD-40 Bike brand name. It also provides multi-purpose and specialty drip oils, and spray lubricant products, as well as other specialty maintenance products under the 3-IN-ONE brand name; and professional spray maintenance products and lubricants for the bike market under the GT85 brand name. In addition, the company offers automatic toilet bowl cleaners under the 2000 Flushes brand name; aerosol and liquid trigger carpet stain and odor eliminators under the Spot Shot brand; room and rug deodorizers under the Carpet Fresh brand name; carpet and household cleaners, and rug and room deodorizers under the 1001 brand; heavy-duty hand cleaner products under the Lava brand name in the United States, as well as under the Solvol brand name in Australia; and liquid mildew stain removers and automatic toilet bowl cleaners under the X-14 brand name. It sells its products primarily through warehouse club stores, hardware stores, automotive parts outlets, industrial distributors and suppliers, mass retail and home center stores, value retailers, grocery stores, online retailers, farm supply, sport retailers, and independent bike dealers. WD-40 Company was founded in 1953 and is headquartered in San Diego, California."
WDFC,2020-08-31,NA,75515000,NA,60710000,143586000,223017000,77220000,77220000,-2439000,14805000,408498000,331278000,185481000,-1705000,NA,60710000,60416000,NA,income_statement,Specialty Chemicals,WD-40 Company,"WD-40 Company develops and sells maintenance products, and homecare and cleaning products in the Americas, Europe, the Middle East, Africa, and the Asia-Pacific. The company offers multi-purpose maintenance products, including aerosol sprays, non-aerosol trigger sprays, and in liquid-bulk form products under the WD-40 Multi-Use brand name for various consumer uses and industrial applications; and specialty maintenance products, such as penetrants, degreasers, corrosion inhibitors, greases, lubricants, and rust removers under the WD-40 Specialist brand, as well as various products under the WD-40 Bike brand name. It also provides multi-purpose and specialty drip oils, and spray lubricant products, as well as other specialty maintenance products under the 3-IN-ONE brand name; and professional spray maintenance products and lubricants for the bike market under the GT85 brand name. In addition, the company offers automatic toilet bowl cleaners under the 2000 Flushes brand name; aerosol and liquid trigger carpet stain and odor eliminators under the Spot Shot brand; room and rug deodorizers under the Carpet Fresh brand name; carpet and household cleaners, and rug and room deodorizers under the 1001 brand; heavy-duty hand cleaner products under the Lava brand name in the United States, as well as under the Solvol brand name in Australia; and liquid mildew stain removers and automatic toilet bowl cleaners under the X-14 brand name. It sells its products primarily through warehouse club stores, hardware stores, automotive parts outlets, industrial distributors and suppliers, mass retail and home center stores, value retailers, grocery stores, online retailers, farm supply, sport retailers, and independent bike dealers. WD-40 Company was founded in 1953 and is headquartered in San Diego, California."
WEC,2017-12-31,NA,1587200000,30400000,1203700000,-1900000,2776800000,1785200000,1785200000,-416900000,383500000,7648500000,5863300000,4871700000,-198000000,NA,1203700000,1203700000,194900000,income_statement,NA,NA,NA
WEC,2018-12-31,NA,1229100000,53800000,1059300000,-18900000,2518200000,1494400000,1494400000,-446300000,169800000,7679500000,6185100000,5161300000,-265300000,NA,1059300000,1059300000,196900000,income_statement,NA,NA,NA
WEC,2019-12-31,NA,1258500000,141200000,1134000000,-30100000,2665600000,1567600000,1567600000,-502700000,125000000,7523100000,5955500000,4857500000,-309100000,NA,1133500000,1134000000,201800000,income_statement,NA,NA,NA
WEC,2020-12-31,NA,1428100000,192800000,1199900000,NA,2890000000,1706100000,1706100000,-494900000,227900000,7241700000,5535600000,4351700000,-278000000,NA,1200200000,1199900000,208000000,income_statement,NA,NA,NA
WELL,2017-12-31,NA,560741000,877499000,522774000,122008000,2169750000,1126022000,1126022000,-484622000,20128000,4316641000,3190619000,2146891000,-565281000,NA,540613000,463595000,NA,income_statement,NA,NA,NA
WELL,2018-12-31,NA,838424000,1378311000,804954000,126383000,2267482000,1190640000,1190640000,-526592000,8674000,4700499000,3509859000,2433017000,-352216000,NA,829750000,758250000,NA,income_statement,NA,NA,NA
WELL,2019-12-31,NA,1333367000,1442060000,1232432000,126549000,2412574000,1258952000,1258952000,-555559000,2957000,5121306000,3862354000,2708732000,74415000,NA,1330410000,1232432000,NA,income_statement,NA,NA,NA
WELL,2020-12-31,NA,1048820000,1252343000,978844000,128394000,1983500000,816669000,816669000,-514388000,9968000,4605967000,3789298000,2622467000,232151000,NA,1038852000,978844000,NA,income_statement,NA,NA,NA
WEN,2017-01-01,NA,201690000,NA,129624000,236786000,608694000,260822000,260822000,-129432000,72066000,1435418000,1174596000,826724000,-59132000,NA,129624000,129624000,-11618000,income_statement,Restaurants,Wendy's Company (The),"The Wendy's Company, together with its subsidiaries, operates as a quick-service restaurant company. It operates through three segments: Wendy's U.S., Wendy's International, and Global Real Estate & Development. The company is involved in operating, developing, and franchising a system of quick-service restaurants specializing in hamburger sandwiches. As of December 29, 2019, it operated approximately 357 company owned restaurants; 5,495 franchised restaurants in the United States; and 936 franchised restaurants internationally. The company also owns and leases real estate properties. As of December 29, 2019, it owns 512 and leases 1,248 properties, which are leased or subleased primarily to franchisees. The company was formerly known as Wendy's/Arby's Group, Inc. and changed its name to The Wendy's Company in July 2011. The Wendy's Company was founded in 1969 and is headquartered in Dublin, Ohio."
WEN,2017-12-31,NA,101019000,NA,194029000,202893000,601133000,273632000,273632000,-140928000,-93010000,1223408000,949776000,622275000,-172613000,NA,194029000,194029000,-1079000,income_statement,Restaurants,Wendy's Company (The),"The Wendy's Company, together with its subsidiaries, operates as a quick-service restaurant company. It operates through three segments: Wendy's U.S., Wendy's International, and Global Real Estate & Development. The company is involved in operating, developing, and franchising a system of quick-service restaurants specializing in hamburger sandwiches. As of December 29, 2019, it operated approximately 357 company owned restaurants; 5,495 franchised restaurants in the United States; and 936 franchised restaurants internationally. The company also owns and leases real estate properties. As of December 29, 2019, it owns 512 and leases 1,248 properties, which are leased or subleased primarily to franchisees. The company was formerly known as Wendy's/Arby's Group, Inc. and changed its name to The Wendy's Company in July 2011. The Wendy's Company was founded in 1969 and is headquartered in Dublin, Ohio."
WEN,2018-12-30,NA,574916000,NA,460115000,189889000,599022000,282718000,282718000,-147256000,114801000,1263917000,981199000,664895000,292198000,NA,460115000,460115000,-2464000,income_statement,Restaurants,Wendy's Company (The),"The Wendy's Company, together with its subsidiaries, operates as a quick-service restaurant company. It operates through three segments: Wendy's U.S., Wendy's International, and Global Real Estate & Development. The company is involved in operating, developing, and franchising a system of quick-service restaurants specializing in hamburger sandwiches. As of December 29, 2019, it operated approximately 357 company owned restaurants; 5,495 franchised restaurants in the United States; and 936 franchised restaurants internationally. The company also owns and leases real estate properties. As of December 29, 2019, it owns 512 and leases 1,248 properties, which are leased or subleased primarily to franchisees. The company was formerly known as Wendy's/Arby's Group, Inc. and changed its name to The Wendy's Company in July 2011. The Wendy's Company was founded in 1969 and is headquartered in Dublin, Ohio."
WEN,2019-12-29,NA,171481000,NA,136940000,202706000,604404000,274087000,274087000,-142304000,34541000,1369549000,1095462000,765145000,-102606000,NA,136940000,136940000,-4082000,income_statement,Restaurants,Wendy's Company (The),"The Wendy's Company, together with its subsidiaries, operates as a quick-service restaurant company. It operates through three segments: Wendy's U.S., Wendy's International, and Global Real Estate & Development. The company is involved in operating, developing, and franchising a system of quick-service restaurants specializing in hamburger sandwiches. As of December 29, 2019, it operated approximately 357 company owned restaurants; 5,495 franchised restaurants in the United States; and 936 franchised restaurants internationally. The company also owns and leases real estate properties. As of December 29, 2019, it owns 512 and leases 1,248 properties, which are leased or subleased primarily to franchisees. The company was formerly known as Wendy's/Arby's Group, Inc. and changed its name to The Wendy's Company in July 2011. The Wendy's Company was founded in 1969 and is headquartered in Dublin, Ohio."
WERN,2017-12-31,NA,144557000,NA,202889000,79927000,546442000,137022000,137022000,-2243000,-58332000,2116737000,1979715000,1570295000,7535000,NA,202889000,202889000,111854000,income_statement,Trucking,"Werner Enterprises, Inc.","Werner Enterprises, Inc., a transportation and logistics company, engages in transporting truckload shipments of general commodities in interstate and intrastate commerce in the United States, Mexico, Canada, China, and internationally. It operates in two segments, Truckload Transportation Services and Werner Logistics. The Truckload Transportation Services segment operates medium-to-long-haul van fleet, which transports various consumer nondurable products and other commodities in truckload quantities using dry van trailers; the expedited fleet that offers time-sensitive truckload services using driver teams; regional short-haul fleet, which provides comparable truckload van service in the United States; and temperature controlled fleet that offers truckload services for temperature sensitive products using temperature-controlled trailers. It transports retail store merchandise, consumer products, grocery products, and manufactured products. The Werner Logistics segment provides non-asset-based transportation and logistics services, including truck brokerage; logistics management services and solutions; rail transportation through alliances with rail and drayage providers; management of shipments from origin to destination using a combination of air, ocean, truck, and rail transportation modes; and home and business deliveries of heavy items using liftgate straight truck. As of December 31, 2019, the company had a fleet of 8,000 trucks, which included 7,460 company-operated, as well as 540 owned and operated by independent contractors; 24,145 company-owned trailers that comprised dry vans, flatbeds, and temperature-controlled and other specialized trailers; and 33 intermodal drayage trucks. Werner Enterprises, Inc. was founded in 1956 and is headquartered in Omaha, Nebraska."
WERN,2018-12-31,NA,223881000,NA,168148000,82933000,632147000,214517000,214517000,-2695000,55733000,2457914000,2243397000,1825767000,9364000,NA,168148000,168148000,104546000,income_statement,Trucking,"Werner Enterprises, Inc.","Werner Enterprises, Inc., a transportation and logistics company, engages in transporting truckload shipments of general commodities in interstate and intrastate commerce in the United States, Mexico, Canada, China, and internationally. It operates in two segments, Truckload Transportation Services and Werner Logistics. The Truckload Transportation Services segment operates medium-to-long-haul van fleet, which transports various consumer nondurable products and other commodities in truckload quantities using dry van trailers; the expedited fleet that offers time-sensitive truckload services using driver teams; regional short-haul fleet, which provides comparable truckload van service in the United States; and temperature controlled fleet that offers truckload services for temperature sensitive products using temperature-controlled trailers. It transports retail store merchandise, consumer products, grocery products, and manufactured products. The Werner Logistics segment provides non-asset-based transportation and logistics services, including truck brokerage; logistics management services and solutions; rail transportation through alliances with rail and drayage providers; management of shipments from origin to destination using a combination of air, ocean, truck, and rail transportation modes; and home and business deliveries of heavy items using liftgate straight truck. As of December 31, 2019, the company had a fleet of 8,000 trucks, which included 7,460 company-operated, as well as 540 owned and operated by independent contractors; 24,145 company-owned trailers that comprised dry vans, flatbeds, and temperature-controlled and other specialized trailers; and 33 intermodal drayage trucks. Werner Enterprises, Inc. was founded in 1956 and is headquartered in Omaha, Nebraska."
WERN,2019-12-31,NA,221906000,NA,166944000,88913000,661636000,203915000,203915000,-6854000,54962000,2463701000,2259786000,1802065000,17991000,NA,166944000,166944000,119281000,income_statement,Trucking,"Werner Enterprises, Inc.","Werner Enterprises, Inc., a transportation and logistics company, engages in transporting truckload shipments of general commodities in interstate and intrastate commerce in the United States, Mexico, Canada, China, and internationally. It operates in two segments, Truckload Transportation Services and Werner Logistics. The Truckload Transportation Services segment operates medium-to-long-haul van fleet, which transports various consumer nondurable products and other commodities in truckload quantities using dry van trailers; the expedited fleet that offers time-sensitive truckload services using driver teams; regional short-haul fleet, which provides comparable truckload van service in the United States; and temperature controlled fleet that offers truckload services for temperature sensitive products using temperature-controlled trailers. It transports retail store merchandise, consumer products, grocery products, and manufactured products. The Werner Logistics segment provides non-asset-based transportation and logistics services, including truck brokerage; logistics management services and solutions; rail transportation through alliances with rail and drayage providers; management of shipments from origin to destination using a combination of air, ocean, truck, and rail transportation modes; and home and business deliveries of heavy items using liftgate straight truck. As of December 31, 2019, the company had a fleet of 8,000 trucks, which included 7,460 company-operated, as well as 540 owned and operated by independent contractors; 24,145 company-owned trailers that comprised dry vans, flatbeds, and temperature-controlled and other specialized trailers; and 33 intermodal drayage trucks. Werner Enterprises, Inc. was founded in 1956 and is headquartered in Omaha, Nebraska."
WERN,2020-12-31,NA,224694000,NA,169078000,109816000,709707000,227438000,227438000,-4215000,55616000,2372178000,2144740000,1662471000,-2744000,NA,169078000,169078000,109167000,income_statement,Trucking,"Werner Enterprises, Inc.","Werner Enterprises, Inc., a transportation and logistics company, engages in transporting truckload shipments of general commodities in interstate and intrastate commerce in the United States, Mexico, Canada, China, and internationally. It operates in two segments, Truckload Transportation Services and Werner Logistics. The Truckload Transportation Services segment operates medium-to-long-haul van fleet, which transports various consumer nondurable products and other commodities in truckload quantities using dry van trailers; the expedited fleet that offers time-sensitive truckload services using driver teams; regional short-haul fleet, which provides comparable truckload van service in the United States; and temperature controlled fleet that offers truckload services for temperature sensitive products using temperature-controlled trailers. It transports retail store merchandise, consumer products, grocery products, and manufactured products. The Werner Logistics segment provides non-asset-based transportation and logistics services, including truck brokerage; logistics management services and solutions; rail transportation through alliances with rail and drayage providers; management of shipments from origin to destination using a combination of air, ocean, truck, and rail transportation modes; and home and business deliveries of heavy items using liftgate straight truck. As of December 31, 2019, the company had a fleet of 8,000 trucks, which included 7,460 company-operated, as well as 540 owned and operated by independent contractors; 24,145 company-owned trailers that comprised dry vans, flatbeds, and temperature-controlled and other specialized trailers; and 33 intermodal drayage trucks. Werner Enterprises, Inc. was founded in 1956 and is headquartered in Omaha, Nebraska."
WETF,2017-12-31,NA,58192000,NA,27199000,38882000,101265000,53920000,53920000,-7962000,30993000,228295000,174375000,127030000,4272000,NA,27199000,26503000,7068000,income_statement,Asset Management,"WisdomTree Investments, Inc.","WisdomTree Investments, Inc., through its subsidiaries, operates as an exchange-traded funds (ETFs) sponsor and asset manager. It offers ETFs in equities, currency, fixed income, and alternatives asset classes. The company also licenses its indexes to third parties for proprietary products, as well as offers a platform to promote the use of WisdomTree ETFs in 401(k) plans. It develops index using its fundamentally weighted index methodology. In addition, the company provides investment advisory services. The company was founded in 1985 and is based in New York, New York."
WETF,2018-12-31,NA,51039000,NA,36633000,45224000,136304000,72733000,72733000,-7962000,14406000,274116000,201383000,137812000,-21694000,NA,36633000,33629000,17046000,income_statement,Asset Management,"WisdomTree Investments, Inc.","WisdomTree Investments, Inc., through its subsidiaries, operates as an exchange-traded funds (ETFs) sponsor and asset manager. It offers ETFs in equities, currency, fixed income, and alternatives asset classes. The company also licenses its indexes to third parties for proprietary products, as well as offers a platform to promote the use of WisdomTree ETFs in 401(k) plans. It develops index using its fundamentally weighted index methodology. In addition, the company provides investment advisory services. The company was founded in 1985 and is based in New York, New York."
WETF,2019-12-31,NA,121000,NA,-10425000,42382000,119172000,54436000,54436000,-11240000,10546000,268403000,213967000,149231000,-54315000,NA,-10425000,-12588000,21309000,income_statement,Asset Management,"WisdomTree Investments, Inc.","WisdomTree Investments, Inc., through its subsidiaries, operates as an exchange-traded funds (ETFs) sponsor and asset manager. It offers ETFs in equities, currency, fixed income, and alternatives asset classes. The company also licenses its indexes to third parties for proprietary products, as well as offers a platform to promote the use of WisdomTree ETFs in 401(k) plans. It develops index using its fundamentally weighted index methodology. In addition, the company provides investment advisory services. The company was founded in 1985 and is based in New York, New York."
WETF,2020-12-31,NA,-35222000,NA,-35655000,33036000,113290000,55498000,55498000,-9668000,433000,253699000,198201000,140409000,-90720000,NA,-35655000,-35655000,23735000,income_statement,Asset Management,"WisdomTree Investments, Inc.","WisdomTree Investments, Inc., through its subsidiaries, operates as an exchange-traded funds (ETFs) sponsor and asset manager. It offers ETFs in equities, currency, fixed income, and alternatives asset classes. The company also licenses its indexes to third parties for proprietary products, as well as offers a platform to promote the use of WisdomTree ETFs in 401(k) plans. It develops index using its fundamentally weighted index methodology. In addition, the company provides investment advisory services. The company was founded in 1985 and is based in New York, New York."
WEYS,2016-12-31,NA,22077000,6692000,16472000,87378000,112043000,24665000,24665000,-436000,5084000,296933000,272268000,184890000,-2588000,NA,16993000,16472000,NA,income_statement,Footwear & Accessories,"Weyco Group, Inc.","Weyco Group, Inc., together with its subsidiaries, designs and distributes footwear for men, women, and children. It operates through two segments, North American Wholesale and North American Retail. The company offers mid-priced leather dress shoes and casual footwear of man-made materials or leather; and outdoor boots, shoes, and sandals under the Florsheim, Nunn Bush, Stacy Adams, BOGS, and Rafters brand names. It is also involved in the wholesale of its products to 10,000 footwear, department, and specialty stores, as well as e-commerce retailers. As of December 31, 2019, the company had eight brick and mortar retail stores in the United States. In addition, it has licensing agreements with third parties, who sell its branded apparel, accessories, and specialty footwear. Weyco Group, Inc. serves in the United States, Canada, Europe, Australia, Asia, and South Africa. The company was formerly known as Weyenberg Shoe Manufacturing Company and changed its name to Weyco Group, Inc. in April 1990. Weyco Group, Inc. was incorporated in 1906 and is based in Milwaukee, Wisconsin."
WEYS,2017-12-31,NA,23922000,7122000,16491000,87713000,110693000,22980000,22980000,-15000,7223000,283749000,260769000,173056000,942000,NA,16699000,16491000,NA,income_statement,Footwear & Accessories,"Weyco Group, Inc.","Weyco Group, Inc., together with its subsidiaries, designs and distributes footwear for men, women, and children. It operates through two segments, North American Wholesale and North American Retail. The company offers mid-priced leather dress shoes and casual footwear of man-made materials or leather; and outdoor boots, shoes, and sandals under the Florsheim, Nunn Bush, Stacy Adams, BOGS, and Rafters brand names. It is also involved in the wholesale of its products to 10,000 footwear, department, and specialty stores, as well as e-commerce retailers. As of December 31, 2019, the company had eight brick and mortar retail stores in the United States. In addition, it has licensing agreements with third parties, who sell its branded apparel, accessories, and specialty footwear. Weyco Group, Inc. serves in the United States, Canada, Europe, Australia, Asia, and South Africa. The company was formerly known as Weyenberg Shoe Manufacturing Company and changed its name to Weyco Group, Inc. in April 1990. Weyco Group, Inc. was incorporated in 1906 and is based in Milwaukee, Wisconsin."
WEYS,2018-12-31,NA,25757000,NA,20484000,94502000,120080000,25578000,25578000,-45000,5798000,298375000,272797000,178295000,179000,NA,19959000,20484000,NA,income_statement,Footwear & Accessories,"Weyco Group, Inc.","Weyco Group, Inc., together with its subsidiaries, designs and distributes footwear for men, women, and children. It operates through two segments, North American Wholesale and North American Retail. The company offers mid-priced leather dress shoes and casual footwear of man-made materials or leather; and outdoor boots, shoes, and sandals under the Florsheim, Nunn Bush, Stacy Adams, BOGS, and Rafters brand names. It is also involved in the wholesale of its products to 10,000 footwear, department, and specialty stores, as well as e-commerce retailers. As of December 31, 2019, the company had eight brick and mortar retail stores in the United States. In addition, it has licensing agreements with third parties, who sell its branded apparel, accessories, and specialty footwear. Weyco Group, Inc. serves in the United States, Canada, Europe, Australia, Asia, and South Africa. The company was formerly known as Weyenberg Shoe Manufacturing Company and changed its name to Weyco Group, Inc. in April 1990. Weyco Group, Inc. was incorporated in 1906 and is based in Milwaukee, Wisconsin."
WEYS,2019-12-31,NA,27084000,NA,20882000,97247000,123962000,26715000,26715000,-244000,6202000,304011000,277296000,180049000,369000,NA,20882000,20882000,NA,income_statement,Footwear & Accessories,"Weyco Group, Inc.","Weyco Group, Inc., together with its subsidiaries, designs and distributes footwear for men, women, and children. It operates through two segments, North American Wholesale and North American Retail. The company offers mid-priced leather dress shoes and casual footwear of man-made materials or leather; and outdoor boots, shoes, and sandals under the Florsheim, Nunn Bush, Stacy Adams, BOGS, and Rafters brand names. It is also involved in the wholesale of its products to 10,000 footwear, department, and specialty stores, as well as e-commerce retailers. As of December 31, 2019, the company had eight brick and mortar retail stores in the United States. In addition, it has licensing agreements with third parties, who sell its branded apparel, accessories, and specialty footwear. Weyco Group, Inc. serves in the United States, Canada, Europe, Australia, Asia, and South Africa. The company was formerly known as Weyenberg Shoe Manufacturing Company and changed its name to Weyco Group, Inc. in April 1990. Weyco Group, Inc. was incorporated in 1906 and is based in Milwaukee, Wisconsin."
WFC,2017-12-31,NA,27377000000,1143000000,22183000000,40422000000,85989000000,0,29816000000,NA,4917000000,85989000000,56173000000,0,-2439000000,NA,22460000000,20554000000,15751000000,income_statement,NA,NA,NA
WFC,2018-12-31,NA,28538000000,900000000,22393000000,40547000000,84696000000,0,30706000000,NA,5662000000,84696000000,53990000000,0,-2168000000,NA,22876000000,20689000000,13443000000,income_statement,NA,NA,NA
WFC,2019-12-31,NA,24198000000,838000000,19549000000,42758000000,82458000000,0,25097000000,NA,4157000000,82458000000,57361000000,0,-899000000,NA,20041000000,17938000000,14603000000,income_statement,NA,NA,NA
WFC,2020-12-31,NA,581000000,1033000000,3301000000,49501000000,58211000000,0,2080000000,NA,-3005000000,58211000000,56131000000,0,-1499000000,NA,3586000000,1710000000,6630000000,income_statement,NA,NA,NA
WHF,2016-12-31,NA,31329000,NA,31329000,18650000,53849000,35199000,35199000,-8188000,0,53849000,18650000,0,-3870000,NA,31329000,31329000,NA,income_statement,Asset Management,"WhiteHorse Finance, Inc.","WhiteHorse Finance, LLC is a business development company."
WHF,2017-12-31,NA,34448000,NA,34448000,18781000,54804000,36023000,36023000,-9811000,0,54804000,18781000,0,-1575000,NA,34448000,34448000,NA,income_statement,Asset Management,"WhiteHorse Finance, Inc.","WhiteHorse Finance, LLC is a business development company."
WHF,2018-12-31,NA,58243000,NA,57301000,25705000,63246000,37541000,37541000,-11599000,942000,63246000,25705000,0,20702000,NA,57301000,57301000,NA,income_statement,Asset Management,"WhiteHorse Finance, Inc.","WhiteHorse Finance, LLC is a business development company."
WHF,2019-12-31,NA,31654000,NA,30841000,21596000,67073000,45477000,45477000,-13468000,813000,67073000,21596000,0,-13823000,NA,30841000,30841000,NA,income_statement,Asset Management,"WhiteHorse Finance, Inc.","WhiteHorse Finance, LLC is a business development company."
WHLM,2016-12-31,NA,910000,NA,95000,21935000,23546000,1017000,1017000,-81000,815000,82228000,81211000,58682000,-107000,NA,95000,95000,NA,income_statement,Specialty Business Services,"Wilhelmina International, Inc.","Wilhelmina International, Inc. primarily engages in the fashion model management business. It specializes in the representation and management of models, entertainers, artists, athletes, and other talent to various clients, including retailers, designers, advertising agencies, print and electronic media and catalog companies. The company offers fashion modeling talent and social media influencer services to clients, such as advertising agencies, branded consumer goods companies, fashion designers, Internet sites, retailers, department stores, product catalogs, and magazine publications; and represents artists in the hair, makeup, photography, and stylist arenas to various companies in the media, advertising, retail, pharmaceutical, and music industries. It is also involved in the licensing of the Wilhelmina name to third-parties, such as fashion model agencies; television syndication royalties and production series contracts; and celebrity management activities. The company has operations in Los Angeles, Miami, Chicago, and London, as well as a network of licensees in various local markets in the United States and internationally. Wilhelmina International, Inc. was founded in 1967 and is headquartered in Dallas, Texas."
WHLM,2017-12-31,NA,-521000,NA,163000,20314000,20921000,-299000,-299000,-128000,-684000,73196000,73495000,52275000,-222000,NA,163000,163000,NA,income_statement,Specialty Business Services,"Wilhelmina International, Inc.","Wilhelmina International, Inc. primarily engages in the fashion model management business. It specializes in the representation and management of models, entertainers, artists, athletes, and other talent to various clients, including retailers, designers, advertising agencies, print and electronic media and catalog companies. The company offers fashion modeling talent and social media influencer services to clients, such as advertising agencies, branded consumer goods companies, fashion designers, Internet sites, retailers, department stores, product catalogs, and magazine publications; and represents artists in the hair, makeup, photography, and stylist arenas to various companies in the media, advertising, retail, pharmaceutical, and music industries. It is also involved in the licensing of the Wilhelmina name to third-parties, such as fashion model agencies; television syndication royalties and production series contracts; and celebrity management activities. The company has operations in Los Angeles, Miami, Chicago, and London, as well as a network of licensees in various local markets in the United States and internationally. Wilhelmina International, Inc. was founded in 1967 and is headquartered in Dallas, Texas."
WHLM,2018-12-31,NA,1189000,NA,856000,19888000,22251000,1373000,1373000,-101000,333000,77851000,76478000,55600000,-184000,NA,856000,856000,NA,income_statement,Specialty Business Services,"Wilhelmina International, Inc.","Wilhelmina International, Inc. primarily engages in the fashion model management business. It specializes in the representation and management of models, entertainers, artists, athletes, and other talent to various clients, including retailers, designers, advertising agencies, print and electronic media and catalog companies. The company offers fashion modeling talent and social media influencer services to clients, such as advertising agencies, branded consumer goods companies, fashion designers, Internet sites, retailers, department stores, product catalogs, and magazine publications; and represents artists in the hair, makeup, photography, and stylist arenas to various companies in the media, advertising, retail, pharmaceutical, and music industries. It is also involved in the licensing of the Wilhelmina name to third-parties, such as fashion model agencies; television syndication royalties and production series contracts; and celebrity management activities. The company has operations in Los Angeles, Miami, Chicago, and London, as well as a network of licensees in various local markets in the United States and internationally. Wilhelmina International, Inc. was founded in 1967 and is headquartered in Dallas, Texas."
WHLM,2019-12-31,NA,-4386000,NA,-4786000,19390000,21255000,673000,673000,-117000,400000,75504000,74831000,54249000,-5059000,NA,-4786000,-4786000,NA,income_statement,Specialty Business Services,"Wilhelmina International, Inc.","Wilhelmina International, Inc. primarily engages in the fashion model management business. It specializes in the representation and management of models, entertainers, artists, athletes, and other talent to various clients, including retailers, designers, advertising agencies, print and electronic media and catalog companies. The company offers fashion modeling talent and social media influencer services to clients, such as advertising agencies, branded consumer goods companies, fashion designers, Internet sites, retailers, department stores, product catalogs, and magazine publications; and represents artists in the hair, makeup, photography, and stylist arenas to various companies in the media, advertising, retail, pharmaceutical, and music industries. It is also involved in the licensing of the Wilhelmina name to third-parties, such as fashion model agencies; television syndication royalties and production series contracts; and celebrity management activities. The company has operations in Los Angeles, Miami, Chicago, and London, as well as a network of licensees in various local markets in the United States and internationally. Wilhelmina International, Inc. was founded in 1967 and is headquartered in Dallas, Texas."
WHLR,2016-12-31,NA,-12955000,10359000,-11203000,11491000,31837000,-291000,-291000,-13356000,107000,44160000,44451000,12323000,-12664000,824000,-13062000,-15916000,250000,income_statement,REIT—Retail,Wheeler Real Estate Investment,"Headquartered in Virginia Beach, VA, Wheeler Real Estate Investment Trust, Inc. (NASDAQ: WHLR ) is a fully integrated, self-managed commercial real estate investment company focused on owning and operating income-producing retail properties with a primary focus on grocery-anchored centers."
WHLR,2017-12-31,NA,-14159000,7088000,-12094000,6251000,40325000,9583000,9583000,-17165000,137000,58535000,48952000,18210000,-23742000,1518000,-14296000,-22063000,250000,income_statement,REIT—Retail,Wheeler Real Estate Investment,"Headquartered in Virginia Beach, VA, Wheeler Real Estate Investment Trust, Inc. (NASDAQ: WHLR ) is a fully integrated, self-managed commercial real estate investment company focused on owning and operating income-producing retail properties with a primary focus on grocery-anchored centers."
WHLR,2018-12-31,NA,-17769000,2194000,-16500000,8303000,46802000,12535000,12535000,-20228000,40000,65275000,52740000,18473000,-30304000,903000,-17809000,-29327000,250000,income_statement,REIT—Retail,Wheeler Real Estate Investment,"Headquartered in Virginia Beach, VA, Wheeler Real Estate Investment Trust, Inc. (NASDAQ: WHLR ) is a fully integrated, self-managed commercial real estate investment company focused on owning and operating income-producing retail properties with a primary focus on grocery-anchored centers."
WHLR,2019-12-31,NA,-8129000,2080000,-8039000,6658000,44035000,16058000,16058000,-18985000,15000,63162000,47104000,19127000,-24187000,NA,-8144000,-22668000,NA,income_statement,REIT—Retail,Wheeler Real Estate Investment,"Headquartered in Virginia Beach, VA, Wheeler Real Estate Investment Trust, Inc. (NASDAQ: WHLR ) is a fully integrated, self-managed commercial real estate investment company focused on owning and operating income-producing retail properties with a primary focus on grocery-anchored centers."
WHLRD,2016-12-31,NA,-12955000,10359000,-11203000,11491000,31837000,-291000,-291000,-13356000,107000,44160000,44451000,12323000,-12664000,824000,-13062000,-15916000,250000,income_statement,REIT—Retail,Wheeler Real Estate Investment,"Headquartered in Virginia Beach, VA, Wheeler Real Estate Investment Trust, Inc. (NASDAQ: WHLR ) is a fully integrated, self-managed commercial real estate investment company focused on owning and operating income-producing retail properties with a primary focus on grocery-anchored centers."
WHLRD,2017-12-31,NA,-14159000,7088000,-12094000,6251000,40325000,9583000,9583000,-17165000,137000,58535000,48952000,18210000,-23742000,1518000,-14296000,-22063000,250000,income_statement,REIT—Retail,Wheeler Real Estate Investment,"Headquartered in Virginia Beach, VA, Wheeler Real Estate Investment Trust, Inc. (NASDAQ: WHLR ) is a fully integrated, self-managed commercial real estate investment company focused on owning and operating income-producing retail properties with a primary focus on grocery-anchored centers."
WHLRD,2018-12-31,NA,-17769000,2194000,-16500000,8303000,46802000,12535000,12535000,-20228000,40000,65275000,52740000,18473000,-30304000,903000,-17809000,-29327000,250000,income_statement,REIT—Retail,Wheeler Real Estate Investment,"Headquartered in Virginia Beach, VA, Wheeler Real Estate Investment Trust, Inc. (NASDAQ: WHLR ) is a fully integrated, self-managed commercial real estate investment company focused on owning and operating income-producing retail properties with a primary focus on grocery-anchored centers."
WHLRD,2019-12-31,NA,-8129000,2080000,-8039000,6658000,44035000,16058000,16058000,-18985000,15000,63162000,47104000,19127000,-24187000,NA,-8144000,-22668000,NA,income_statement,REIT—Retail,Wheeler Real Estate Investment,"Headquartered in Virginia Beach, VA, Wheeler Real Estate Investment Trust, Inc. (NASDAQ: WHLR ) is a fully integrated, self-managed commercial real estate investment company focused on owning and operating income-producing retail properties with a primary focus on grocery-anchored centers."
WHLRP,2016-12-31,NA,-12955000,10359000,-11203000,11491000,31837000,-291000,-291000,-13356000,107000,44160000,44451000,12323000,-12664000,824000,-13062000,-15916000,250000,income_statement,REIT—Retail,Wheeler Real Estate Investment,"Headquartered in Virginia Beach, VA, Wheeler Real Estate Investment Trust, Inc. (NASDAQ: WHLR ) is a fully integrated, self-managed commercial real estate investment company focused on owning and operating income-producing retail properties with a primary focus on grocery-anchored centers."
WHLRP,2017-12-31,NA,-14159000,7088000,-12094000,6251000,40325000,9583000,9583000,-17165000,137000,58535000,48952000,18210000,-23742000,1518000,-14296000,-22063000,250000,income_statement,REIT—Retail,Wheeler Real Estate Investment,"Headquartered in Virginia Beach, VA, Wheeler Real Estate Investment Trust, Inc. (NASDAQ: WHLR ) is a fully integrated, self-managed commercial real estate investment company focused on owning and operating income-producing retail properties with a primary focus on grocery-anchored centers."
WHLRP,2018-12-31,NA,-17769000,2194000,-16500000,8303000,46802000,12535000,12535000,-20228000,40000,65275000,52740000,18473000,-30304000,903000,-17809000,-29327000,250000,income_statement,REIT—Retail,Wheeler Real Estate Investment,"Headquartered in Virginia Beach, VA, Wheeler Real Estate Investment Trust, Inc. (NASDAQ: WHLR ) is a fully integrated, self-managed commercial real estate investment company focused on owning and operating income-producing retail properties with a primary focus on grocery-anchored centers."
WHLRP,2019-12-31,NA,-8129000,2080000,-8039000,6658000,44035000,16058000,16058000,-18985000,15000,63162000,47104000,19127000,-24187000,NA,-8144000,-22668000,NA,income_statement,REIT—Retail,Wheeler Real Estate Investment,"Headquartered in Virginia Beach, VA, Wheeler Real Estate Investment Trust, Inc. (NASDAQ: WHLR ) is a fully integrated, self-managed commercial real estate investment company focused on owning and operating income-producing retail properties with a primary focus on grocery-anchored centers."
WHR,2017-12-31,NA,887000000,930000000,350000000,2135000000,3602000000,1388000000,1388000000,-162000000,550000000,21253000000,19865000000,17651000000,-501000000,NA,337000000,350000000,NA,income_statement,NA,NA,NA
WHR,2018-12-31,NA,-21000000,914000000,-183000000,2201000000,3537000000,1261000000,1261000000,-192000000,138000000,21037000000,19776000000,17500000000,-1282000000,NA,-159000000,-183000000,NA,income_statement,NA,NA,NA
WHR,2019-12-31,NA,1552000000,923000000,1184000000,2147000000,3533000000,1317000000,1317000000,-187000000,354000000,20419000000,19102000000,16886000000,235000000,NA,1198000000,1184000000,NA,income_statement,NA,NA,NA
WHR,2020-12-31,NA,1455000000,910000000,1081000000,1894000000,3850000000,1894000000,1894000000,-189000000,384000000,19456000000,17562000000,15606000000,-439000000,NA,1071000000,1081000000,NA,income_statement,NA,NA,NA
WIFI,2016-12-31,22126000,-26556000,738000,-27331000,48448000,47979000,-26043000,-26043000,-467000,427000,159344000,185387000,111365000,-513000,NA,-26983000,-27331000,NA,income_statement,Telecom Services,"Boingo Wireless, Inc.","Boingo Wireless, Inc., together with its subsidiaries, provides wireless connectivity solutions for smartphones, tablets, laptops, wearables, and other wireless-enabled consumer devices worldwide. It offers distributed antenna systems and small cell networks at managed and operated locations; high-speed Wi-Fi services for residential consumers on military bases and at multifamily properties; and wholesale Wi-Fi services to network operators, device manufacturers, technology companies, enterprise software and services companies, venue operators, and financial services companies, as well as retail Internet access services. The company also provides advertising services for advertisers to reach consumers with sponsored Wi-Fi access, promotional programs, and display advertising. It serves the carriers, telecommunications service providers, global consumer brands, and property owners, as well as troops stationed at military bases and Internet savvy consumers. The company was formerly known as Project Mammoth, Inc. and changed its name to Boingo Wireless, Inc. in October 2001. Boingo Wireless, Inc. was founded in 2001 and is headquartered in Los Angeles, California."
WIFI,2017-12-31,26754000,-20854000,1212000,-19366000,56501000,66052000,-20701000,-20701000,-187000,-2078000,204369000,225070000,138317000,-153000,NA,-18776000,-19366000,NA,income_statement,Telecom Services,"Boingo Wireless, Inc.","Boingo Wireless, Inc., together with its subsidiaries, provides wireless connectivity solutions for smartphones, tablets, laptops, wearables, and other wireless-enabled consumer devices worldwide. It offers distributed antenna systems and small cell networks at managed and operated locations; high-speed Wi-Fi services for residential consumers on military bases and at multifamily properties; and wholesale Wi-Fi services to network operators, device manufacturers, technology companies, enterprise software and services companies, venue operators, and financial services companies, as well as retail Internet access services. The company also provides advertising services for advertisers to reach consumers with sponsored Wi-Fi access, promotional programs, and display advertising. It serves the carriers, telecommunications service providers, global consumer brands, and property owners, as well as troops stationed at military bases and Internet savvy consumers. The company was formerly known as Project Mammoth, Inc. and changed its name to Boingo Wireless, Inc. in October 2001. Boingo Wireless, Inc. was founded in 2001 and is headquartered in Los Angeles, California."
WIFI,2018-12-31,31372000,-4884000,2211000,-1220000,52949000,85034000,-2997000,-2997000,-2400000,-5153000,250821000,253818000,165787000,-1887000,NA,269000,-1220000,NA,income_statement,Telecom Services,"Boingo Wireless, Inc.","Boingo Wireless, Inc., together with its subsidiaries, provides wireless connectivity solutions for smartphones, tablets, laptops, wearables, and other wireless-enabled consumer devices worldwide. It offers distributed antenna systems and small cell networks at managed and operated locations; high-speed Wi-Fi services for residential consumers on military bases and at multifamily properties; and wholesale Wi-Fi services to network operators, device manufacturers, technology companies, enterprise software and services companies, venue operators, and financial services companies, as well as retail Internet access services. The company also provides advertising services for advertisers to reach consumers with sponsored Wi-Fi access, promotional programs, and display advertising. It serves the carriers, telecommunications service providers, global consumer brands, and property owners, as well as troops stationed at military bases and Internet savvy consumers. The company was formerly known as Project Mammoth, Inc. and changed its name to Boingo Wireless, Inc. in October 2001. Boingo Wireless, Inc. was founded in 2001 and is headquartered in Los Angeles, California."
WIFI,2019-12-31,33665000,-10305000,1238000,-10296000,52212000,88081000,-2367000,-2367000,-8618000,-28000,263790000,266157000,175709000,-7938000,NA,-10277000,-10296000,NA,income_statement,Telecom Services,"Boingo Wireless, Inc.","Boingo Wireless, Inc., together with its subsidiaries, provides wireless connectivity solutions for smartphones, tablets, laptops, wearables, and other wireless-enabled consumer devices worldwide. It offers distributed antenna systems and small cell networks at managed and operated locations; high-speed Wi-Fi services for residential consumers on military bases and at multifamily properties; and wholesale Wi-Fi services to network operators, device manufacturers, technology companies, enterprise software and services companies, venue operators, and financial services companies, as well as retail Internet access services. The company also provides advertising services for advertisers to reach consumers with sponsored Wi-Fi access, promotional programs, and display advertising. It serves the carriers, telecommunications service providers, global consumer brands, and property owners, as well as troops stationed at military bases and Internet savvy consumers. The company was formerly known as Project Mammoth, Inc. and changed its name to Boingo Wireless, Inc. in October 2001. Boingo Wireless, Inc. was founded in 2001 and is headquartered in Los Angeles, California."
WILC,2016-12-31,NA,16179000,NA,10852000,53982000,76617000,22635000,22635000,-172000,5327000,294202000,271567000,217585000,-6456000,NA,10852000,10852000,NA,income_statement,Food Distribution,"G. Willi-Food International,  L","G. Willi-Food International Ltd. develops, imports, exports, markets, and distributes food products worldwide. It offers mushroom, artichoke, bean, asparagu, caper, corn kernel, baby corn, palm heart, vine leave, sour pickle, mixed pickled vegetable, pickled pepper, olives, garlic, roasted eggplant sun, and dried tomato products; and canned fish comprising tuna, sardine, anchovies, smoked and pressed cod liver, herring, fish paste, and salmon products. The company also provides pineapple, peach, apricot, pear, mango, cherry, litchi, and fruit cocktail products; edible oils comprising olive, sunflower, soybean, corn, and rapeseed oils; dairy and dairy substitutes consisting of cheese, feta, Bulgarian cubes, goat cheese, fetina, butter, butter spread, margarine, melted cheese, cheese alternative, condensed milk, whipped cream, yogurt, frozen pizza, and other products; and dried fruits, nuts, and beans, such as figs, apricots, organic chestnuts, sunflower seeds, walnuts, pine nuts, cashews, banana chips, pistachios, and peanuts. In addition, it offers instant noodle soup, frozen edamame soybean, freeze dried instant coffee, bagel, breadstick, coffee creamer, lemon juice, halva, Turkish delight, cookie, vinegar, sweet pastry and cracker, sauce, corn flour, rice, rice stick, pasta, organic pasta, spaghetti and noodle, breakfast cereal, corn flake, rusk, tortilla, dried apples snack, desert, ice cream, and light and alcoholic beverage products. It markets its products under the Willi-Food, Donna Rozza, Manchow, Gold Frost, Tifeeret, the Chef Dish, Art Coffe, Mr Chang, Muchi, Euro Butter, Euro Spread, Euro Cheese, Euro Cream, Euro Dessert, Euro Veg, Ha-Bulgaria, Gelato, and Emma brand names. The company was formerly known as G. Willi-Food Ltd. and changed its name to G. Willi-Food International Ltd. in June 1996. The company was founded in 1994 and is headquartered in Yavne, Israel. G. Willi-Food International Ltd. is a subsidiary of Willi-Food Investments Ltd."
WILC,2017-12-31,NA,30933000,NA,25023000,57929000,74333000,16404000,16404000,NA,5910000,311978000,295574000,237645000,14529000,NA,25023000,25023000,NA,income_statement,Food Distribution,"G. Willi-Food International,  L","G. Willi-Food International Ltd. develops, imports, exports, markets, and distributes food products worldwide. It offers mushroom, artichoke, bean, asparagu, caper, corn kernel, baby corn, palm heart, vine leave, sour pickle, mixed pickled vegetable, pickled pepper, olives, garlic, roasted eggplant sun, and dried tomato products; and canned fish comprising tuna, sardine, anchovies, smoked and pressed cod liver, herring, fish paste, and salmon products. The company also provides pineapple, peach, apricot, pear, mango, cherry, litchi, and fruit cocktail products; edible oils comprising olive, sunflower, soybean, corn, and rapeseed oils; dairy and dairy substitutes consisting of cheese, feta, Bulgarian cubes, goat cheese, fetina, butter, butter spread, margarine, melted cheese, cheese alternative, condensed milk, whipped cream, yogurt, frozen pizza, and other products; and dried fruits, nuts, and beans, such as figs, apricots, organic chestnuts, sunflower seeds, walnuts, pine nuts, cashews, banana chips, pistachios, and peanuts. In addition, it offers instant noodle soup, frozen edamame soybean, freeze dried instant coffee, bagel, breadstick, coffee creamer, lemon juice, halva, Turkish delight, cookie, vinegar, sweet pastry and cracker, sauce, corn flour, rice, rice stick, pasta, organic pasta, spaghetti and noodle, breakfast cereal, corn flake, rusk, tortilla, dried apples snack, desert, ice cream, and light and alcoholic beverage products. It markets its products under the Willi-Food, Donna Rozza, Manchow, Gold Frost, Tifeeret, the Chef Dish, Art Coffe, Mr Chang, Muchi, Euro Butter, Euro Spread, Euro Cheese, Euro Cream, Euro Dessert, Euro Veg, Ha-Bulgaria, Gelato, and Emma brand names. The company was formerly known as G. Willi-Food Ltd. and changed its name to G. Willi-Food International Ltd. in June 1996. The company was founded in 1994 and is headquartered in Yavne, Israel. G. Willi-Food International Ltd. is a subsidiary of Willi-Food Investments Ltd."
WILC,2018-12-31,NA,32817000,NA,24967000,60509000,98213000,37704000,37704000,NA,7850000,338245000,300541000,240032000,-4887000,NA,24967000,24967000,NA,income_statement,Food Distribution,"G. Willi-Food International,  L","G. Willi-Food International Ltd. develops, imports, exports, markets, and distributes food products worldwide. It offers mushroom, artichoke, bean, asparagu, caper, corn kernel, baby corn, palm heart, vine leave, sour pickle, mixed pickled vegetable, pickled pepper, olives, garlic, roasted eggplant sun, and dried tomato products; and canned fish comprising tuna, sardine, anchovies, smoked and pressed cod liver, herring, fish paste, and salmon products. The company also provides pineapple, peach, apricot, pear, mango, cherry, litchi, and fruit cocktail products; edible oils comprising olive, sunflower, soybean, corn, and rapeseed oils; dairy and dairy substitutes consisting of cheese, feta, Bulgarian cubes, goat cheese, fetina, butter, butter spread, margarine, melted cheese, cheese alternative, condensed milk, whipped cream, yogurt, frozen pizza, and other products; and dried fruits, nuts, and beans, such as figs, apricots, organic chestnuts, sunflower seeds, walnuts, pine nuts, cashews, banana chips, pistachios, and peanuts. In addition, it offers instant noodle soup, frozen edamame soybean, freeze dried instant coffee, bagel, breadstick, coffee creamer, lemon juice, halva, Turkish delight, cookie, vinegar, sweet pastry and cracker, sauce, corn flour, rice, rice stick, pasta, organic pasta, spaghetti and noodle, breakfast cereal, corn flake, rusk, tortilla, dried apples snack, desert, ice cream, and light and alcoholic beverage products. It markets its products under the Willi-Food, Donna Rozza, Manchow, Gold Frost, Tifeeret, the Chef Dish, Art Coffe, Mr Chang, Muchi, Euro Butter, Euro Spread, Euro Cheese, Euro Cream, Euro Dessert, Euro Veg, Ha-Bulgaria, Gelato, and Emma brand names. The company was formerly known as G. Willi-Food Ltd. and changed its name to G. Willi-Food International Ltd. in June 1996. The company was founded in 1994 and is headquartered in Yavne, Israel. G. Willi-Food International Ltd. is a subsidiary of Willi-Food Investments Ltd."
WILC,2019-12-31,NA,65246000,NA,51511000,76557000,123853000,47296000,47296000,NA,13735000,395637000,348341000,271784000,17950000,NA,51511000,51511000,NA,income_statement,Food Distribution,"G. Willi-Food International,  L","G. Willi-Food International Ltd. develops, imports, exports, markets, and distributes food products worldwide. It offers mushroom, artichoke, bean, asparagu, caper, corn kernel, baby corn, palm heart, vine leave, sour pickle, mixed pickled vegetable, pickled pepper, olives, garlic, roasted eggplant sun, and dried tomato products; and canned fish comprising tuna, sardine, anchovies, smoked and pressed cod liver, herring, fish paste, and salmon products. The company also provides pineapple, peach, apricot, pear, mango, cherry, litchi, and fruit cocktail products; edible oils comprising olive, sunflower, soybean, corn, and rapeseed oils; dairy and dairy substitutes consisting of cheese, feta, Bulgarian cubes, goat cheese, fetina, butter, butter spread, margarine, melted cheese, cheese alternative, condensed milk, whipped cream, yogurt, frozen pizza, and other products; and dried fruits, nuts, and beans, such as figs, apricots, organic chestnuts, sunflower seeds, walnuts, pine nuts, cashews, banana chips, pistachios, and peanuts. In addition, it offers instant noodle soup, frozen edamame soybean, freeze dried instant coffee, bagel, breadstick, coffee creamer, lemon juice, halva, Turkish delight, cookie, vinegar, sweet pastry and cracker, sauce, corn flour, rice, rice stick, pasta, organic pasta, spaghetti and noodle, breakfast cereal, corn flake, rusk, tortilla, dried apples snack, desert, ice cream, and light and alcoholic beverage products. It markets its products under the Willi-Food, Donna Rozza, Manchow, Gold Frost, Tifeeret, the Chef Dish, Art Coffe, Mr Chang, Muchi, Euro Butter, Euro Spread, Euro Cheese, Euro Cream, Euro Dessert, Euro Veg, Ha-Bulgaria, Gelato, and Emma brand names. The company was formerly known as G. Willi-Food Ltd. and changed its name to G. Willi-Food International Ltd. in June 1996. The company was founded in 1994 and is headquartered in Yavne, Israel. G. Willi-Food International Ltd. is a subsidiary of Willi-Food Investments Ltd."
WIMI,2017-12-31,9696322,73865982,NA,73337971,25854671,112849337,77298344,77298344,-4228995,528011,192029524,114731180,79180187,-3432362,NA,73337971,73337971,NA,income_statement,Advertising Agencies,WiMi Hologram Cloud Inc.,"WiMi Hologram Cloud Inc. provides augmented reality (AR) based holographic services and products in China. It operates in two segments, Augmented Reality, and AR Entertainment. The company primarily offers holographic AR advertising services and holographic AR entertainment products. Its holographic AR advertising software enables users to insert into video footages real or animated three dimensional objects; and online holographic AR advertising solution embeds holographic AR ads into films. The company's holographic AR entertainment products consist primarily of payment middleware software, game distribution platform, and holographic mixed reality software. WiMi Hologram Cloud Inc. was founded in 2015 and is headquartered in Beijing, the People's Republic of China."
WIMI,2018-12-31,8020082,97293388,NA,89217792,31034826,139857503,100802595,100802595,-5171453,8075596,225271564,124468969,85414061,-3509207,NA,89217792,89217792,NA,income_statement,Advertising Agencies,WiMi Hologram Cloud Inc.,"WiMi Hologram Cloud Inc. provides augmented reality (AR) based holographic services and products in China. It operates in two segments, Augmented Reality, and AR Entertainment. The company primarily offers holographic AR advertising services and holographic AR entertainment products. Its holographic AR advertising software enables users to insert into video footages real or animated three dimensional objects; and online holographic AR advertising solution embeds holographic AR ads into films. The company's holographic AR entertainment products consist primarily of payment middleware software, game distribution platform, and holographic mixed reality software. WiMi Hologram Cloud Inc. was founded in 2015 and is headquartered in Beijing, the People's Republic of China."
WIMI,2019-12-31,18355403,105333552,NA,102204472,41806638,173013581,112851540,112851540,-11940346,3129080,319181424,206329884,146167843,-7517988,NA,102204472,102204472,NA,income_statement,Advertising Agencies,WiMi Hologram Cloud Inc.,"WiMi Hologram Cloud Inc. provides augmented reality (AR) based holographic services and products in China. It operates in two segments, Augmented Reality, and AR Entertainment. The company primarily offers holographic AR advertising services and holographic AR entertainment products. Its holographic AR advertising software enables users to insert into video footages real or animated three dimensional objects; and online holographic AR advertising solution embeds holographic AR ads into films. The company's holographic AR entertainment products consist primarily of payment middleware software, game distribution platform, and holographic mixed reality software. WiMi Hologram Cloud Inc. was founded in 2015 and is headquartered in Beijing, the People's Republic of China."
WINA,2016-12-31,NA,35854300,NA,22148400,23866900,62076200,38209300,38209300,-2342800,13705900,66519900,28310600,4443700,-2367600,NA,22148400,22148400,NA,income_statement,Specialty Retail,Winmark Corporation,"Winmark Corporation operates as a franchisor of five retail store concepts that buy, sell, trade, and consign merchandise primarily in the United States and Canada. The company operates in two segments, Franchising and Leasing. Its franchises retail stores operate under the Plato's Closet, Once Upon A Child, Play It Again Sports, Style Encore, and Music Go Round brand names. The company's Plato's Closet brand stores buy and sell used clothing and accessories for the teenage and young adult market; and Once Upon A Child brand stores buy and sell used and new children's clothing, toys, furniture, equipment, and accessories primarily targeting parents of children ages infant to 12 years. Its Play It Again Sports brand stores buy, sell, trade, and consign used and new sporting goods, equipment, and accessories for various athletic activities, such as team sports, fitness, ski/snowboard, golf, and others; Style Encore brand stores buy and sell used women's apparel, shoes, and accessories; and Music Go Round brand stores buy, sell, trade, and consign used and new musical instruments, speakers, amplifiers, music-related electronics, and related accessories. In addition, the company is also involved in middle-market equipment leasing business focusing on technology and business-essential equipment for large and medium-sized businesses; and small-ticket financing business. As of March 28, 2020, it had 1,256 franchised stores. Winmark Corporation was founded in 1988 and is headquartered in Minneapolis, Minnesota."
WINA,2017-12-30,NA,36451500,NA,24580500,25241600,64046600,38805000,38805000,-2366400,11871000,69757300,30952300,5710700,-2352100,NA,24580500,24580500,NA,income_statement,Specialty Retail,Winmark Corporation,"Winmark Corporation operates as a franchisor of five retail store concepts that buy, sell, trade, and consign merchandise primarily in the United States and Canada. The company operates in two segments, Franchising and Leasing. Its franchises retail stores operate under the Plato's Closet, Once Upon A Child, Play It Again Sports, Style Encore, and Music Go Round brand names. The company's Plato's Closet brand stores buy and sell used clothing and accessories for the teenage and young adult market; and Once Upon A Child brand stores buy and sell used and new children's clothing, toys, furniture, equipment, and accessories primarily targeting parents of children ages infant to 12 years. Its Play It Again Sports brand stores buy, sell, trade, and consign used and new sporting goods, equipment, and accessories for various athletic activities, such as team sports, fitness, ski/snowboard, golf, and others; Style Encore brand stores buy and sell used women's apparel, shoes, and accessories; and Music Go Round brand stores buy, sell, trade, and consign used and new musical instruments, speakers, amplifiers, music-related electronics, and related accessories. In addition, the company is also involved in middle-market equipment leasing business focusing on technology and business-essential equipment for large and medium-sized businesses; and small-ticket financing business. As of March 28, 2020, it had 1,256 franchised stores. Winmark Corporation was founded in 1988 and is headquartered in Minneapolis, Minnesota."
WINA,2018-12-29,NA,39283100,NA,30125500,26038300,67802100,41763800,41763800,-2447500,9157600,72511100,30747300,4709000,-2480700,NA,30125500,30125500,NA,income_statement,Specialty Retail,Winmark Corporation,"Winmark Corporation operates as a franchisor of five retail store concepts that buy, sell, trade, and consign merchandise primarily in the United States and Canada. The company operates in two segments, Franchising and Leasing. Its franchises retail stores operate under the Plato's Closet, Once Upon A Child, Play It Again Sports, Style Encore, and Music Go Round brand names. The company's Plato's Closet brand stores buy and sell used clothing and accessories for the teenage and young adult market; and Once Upon A Child brand stores buy and sell used and new children's clothing, toys, furniture, equipment, and accessories primarily targeting parents of children ages infant to 12 years. Its Play It Again Sports brand stores buy, sell, trade, and consign used and new sporting goods, equipment, and accessories for various athletic activities, such as team sports, fitness, ski/snowboard, golf, and others; Style Encore brand stores buy and sell used women's apparel, shoes, and accessories; and Music Go Round brand stores buy, sell, trade, and consign used and new musical instruments, speakers, amplifiers, music-related electronics, and related accessories. In addition, the company is also involved in middle-market equipment leasing business focusing on technology and business-essential equipment for large and medium-sized businesses; and small-ticket financing business. As of March 28, 2020, it had 1,256 franchised stores. Winmark Corporation was founded in 1988 and is headquartered in Minneapolis, Minnesota."
WINA,2019-12-28,NA,41467400,NA,32149300,25745300,68876400,43131100,43131100,-1731100,9318100,73298900,30167800,4422500,-1663700,NA,32149300,32149300,NA,income_statement,Specialty Retail,Winmark Corporation,"Winmark Corporation operates as a franchisor of five retail store concepts that buy, sell, trade, and consign merchandise primarily in the United States and Canada. The company operates in two segments, Franchising and Leasing. Its franchises retail stores operate under the Plato's Closet, Once Upon A Child, Play It Again Sports, Style Encore, and Music Go Round brand names. The company's Plato's Closet brand stores buy and sell used clothing and accessories for the teenage and young adult market; and Once Upon A Child brand stores buy and sell used and new children's clothing, toys, furniture, equipment, and accessories primarily targeting parents of children ages infant to 12 years. Its Play It Again Sports brand stores buy, sell, trade, and consign used and new sporting goods, equipment, and accessories for various athletic activities, such as team sports, fitness, ski/snowboard, golf, and others; Style Encore brand stores buy and sell used women's apparel, shoes, and accessories; and Music Go Round brand stores buy, sell, trade, and consign used and new musical instruments, speakers, amplifiers, music-related electronics, and related accessories. In addition, the company is also involved in middle-market equipment leasing business focusing on technology and business-essential equipment for large and medium-sized businesses; and small-ticket financing business. As of March 28, 2020, it had 1,256 franchised stores. Winmark Corporation was founded in 1988 and is headquartered in Minneapolis, Minnesota."
WING,2017-12-30,NA,28742000,NA,23940000,34898000,72147000,33873000,33873000,-5131000,4802000,133319000,99446000,61172000,-5131000,NA,23940000,23940000,NA,income_statement,Restaurants,Wingstop Inc.,"Wingstop Inc., together with its subsidiaries, franchises and operates restaurants under the Wingstop brand name. Its restaurants offer classic wings, boneless wings, and tenders that are cooked-to-order, and hand-sauced-and-tossed in various flavors. As of December 26, 2020, the company had 1,506 franchised restaurants and 32 company-owned restaurants in 44 states and 10 countries worldwide. Wingstop Inc. was founded in 1994 and is based in Dallas, Texas."
WING,2018-12-29,NA,26927000,NA,21719000,44579000,87419000,38527000,38527000,-10123000,5208000,153181000,114654000,65762000,-11600000,NA,21719000,21719000,NA,income_statement,Restaurants,Wingstop Inc.,"Wingstop Inc., together with its subsidiaries, franchises and operates restaurants under the Wingstop brand name. Its restaurants offer classic wings, boneless wings, and tenders that are cooked-to-order, and hand-sauced-and-tossed in various flavors. As of December 26, 2020, the company had 1,506 franchised restaurants and 32 company-owned restaurants in 44 states and 10 countries worldwide. Wingstop Inc. was founded in 1994 and is based in Dallas, Texas."
WING,2019-12-28,NA,25765000,NA,20476000,57295000,105680000,42901000,42901000,-17136000,5289000,199676000,156775000,93996000,-17136000,NA,20476000,20476000,NA,income_statement,Restaurants,Wingstop Inc.,"Wingstop Inc., together with its subsidiaries, franchises and operates restaurants under the Wingstop brand name. Its restaurants offer classic wings, boneless wings, and tenders that are cooked-to-order, and hand-sauced-and-tossed in various flavors. As of December 26, 2020, the company had 1,506 franchised restaurants and 32 company-owned restaurants in 44 states and 10 countries worldwide. Wingstop Inc. was founded in 1994 and is based in Dallas, Texas."
WING,2020-12-26,NA,26943000,NA,23306000,68982200,130800000,54299800,54299800,-16782000,3637000,248811000,194511200,118011000,-27356800,NA,23306000,23306000,NA,income_statement,Restaurants,Wingstop Inc.,"Wingstop Inc., together with its subsidiaries, franchises and operates restaurants under the Wingstop brand name. Its restaurants offer classic wings, boneless wings, and tenders that are cooked-to-order, and hand-sauced-and-tossed in various flavors. As of December 26, 2020, the company had 1,506 franchised restaurants and 32 company-owned restaurants in 44 states and 10 countries worldwide. Wingstop Inc. was founded in 1994 and is based in Dallas, Texas."
WINT,2016-12-31,NA,-39490000,NA,-39490000,7173000,-29663000,-36836000,-36836000,-2518000,0,2042000,38878000,31705000,-2654000,NA,-39490000,-39490000,NA,income_statement,Biotechnology,"Windtree Therapeutics, Inc.","Windtree Therapeutics, Inc., a biotechnology and medical device company, engages in the research and development of products that focus on acute pulmonary and cardiovascular diseases. Its four lead development programs include istaroxime, which is in Phase 2b clinical trial for the treatment of acute decompensated heart failure, as well as in Phase 2a clinical trial for the treatment of early cardiogenic shock; AEROSURF, an aerosolized KL4 surfactant, which is in Phase 2b clinical trial to treat respiratory distress syndrome (RDS) in premature infants; lyophilized KL4 surfactant for the treatment of lung injury resulting from COVID-19; and Rostafuroxin that is in Phase 2b clinical trial for the treatment of genetically associated hypertension. The company was formerly known as Discovery Laboratories, Inc. and changed its name to Windtree Therapeutics, Inc. in April 2016. Windtree Therapeutics, Inc. was incorporated in 1992 and is headquartered in Warrington, Pennsylvania."
WINT,2017-12-31,NA,-18446000,NA,-18446000,6657000,-15891000,-22548000,-22548000,-1863000,0,1485000,24033000,17376000,4102000,NA,-18446000,-24816000,NA,income_statement,Biotechnology,"Windtree Therapeutics, Inc.","Windtree Therapeutics, Inc., a biotechnology and medical device company, engages in the research and development of products that focus on acute pulmonary and cardiovascular diseases. Its four lead development programs include istaroxime, which is in Phase 2b clinical trial for the treatment of acute decompensated heart failure, as well as in Phase 2a clinical trial for the treatment of early cardiogenic shock; AEROSURF, an aerosolized KL4 surfactant, which is in Phase 2b clinical trial to treat respiratory distress syndrome (RDS) in premature infants; lyophilized KL4 surfactant for the treatment of lung injury resulting from COVID-19; and Rostafuroxin that is in Phase 2b clinical trial for the treatment of genetically associated hypertension. The company was formerly known as Discovery Laboratories, Inc. and changed its name to Windtree Therapeutics, Inc. in April 2016. Windtree Therapeutics, Inc. was incorporated in 1992 and is headquartered in Warrington, Pennsylvania."
WINT,2018-12-31,NA,-20533000,NA,-20533000,7421000,-8774000,-16195000,-16195000,-1409000,0,1788000,17983000,10562000,-4338000,NA,-20533000,-34756000,NA,income_statement,Biotechnology,"Windtree Therapeutics, Inc.","Windtree Therapeutics, Inc., a biotechnology and medical device company, engages in the research and development of products that focus on acute pulmonary and cardiovascular diseases. Its four lead development programs include istaroxime, which is in Phase 2b clinical trial for the treatment of acute decompensated heart failure, as well as in Phase 2a clinical trial for the treatment of early cardiogenic shock; AEROSURF, an aerosolized KL4 surfactant, which is in Phase 2b clinical trial to treat respiratory distress syndrome (RDS) in premature infants; lyophilized KL4 surfactant for the treatment of lung injury resulting from COVID-19; and Rostafuroxin that is in Phase 2b clinical trial for the treatment of genetically associated hypertension. The company was formerly known as Discovery Laboratories, Inc. and changed its name to Windtree Therapeutics, Inc. in April 2016. Windtree Therapeutics, Inc. was incorporated in 1992 and is headquartered in Warrington, Pennsylvania."
WINT,2019-12-31,NA,-27475000,NA,-27475000,12404000,-12489000,-24893000,-24893000,-495000,0,198000,25091000,12687000,-2582000,NA,-27475000,-27475000,NA,income_statement,Biotechnology,"Windtree Therapeutics, Inc.","Windtree Therapeutics, Inc., a biotechnology and medical device company, engages in the research and development of products that focus on acute pulmonary and cardiovascular diseases. Its four lead development programs include istaroxime, which is in Phase 2b clinical trial for the treatment of acute decompensated heart failure, as well as in Phase 2a clinical trial for the treatment of early cardiogenic shock; AEROSURF, an aerosolized KL4 surfactant, which is in Phase 2b clinical trial to treat respiratory distress syndrome (RDS) in premature infants; lyophilized KL4 surfactant for the treatment of lung injury resulting from COVID-19; and Rostafuroxin that is in Phase 2b clinical trial for the treatment of genetically associated hypertension. The company was formerly known as Discovery Laboratories, Inc. and changed its name to Windtree Therapeutics, Inc. in April 2016. Windtree Therapeutics, Inc. was incorporated in 1992 and is headquartered in Warrington, Pennsylvania."
WIRE,2017-12-31,NA,79876000,NA,67017000,76715000,156175000,79449000,79449000,-200000,12859000,1164248000,1084799000,1008073000,427000,NA,67017000,67017000,NA,income_statement,Electrical Equipment & Parts,Encore Wire Corporation,"Encore Wire Corporation manufactures and sells electrical building wires and cables for interior electrical wiring in the United States. Its products include NM-B cables for use as interior wiring in homes, apartments, and manufactured housing; THHN/THWN-2 cables that are metal-clad and armored cables for use as wiring in commercial and industrial buildings; UF-B cables; XHHW-2 cables; RHH/RHW-2 cables; and other types of wire products. The company sells its products to wholesale electrical distributors primarily through independent manufacturers' representatives. Encore Wire Corporation was founded in 1989 and is headquartered in McKinney, Texas."
WIRE,2018-12-31,NA,101684000,NA,78150000,90212000,189722000,99510000,99510000,-300000,23534000,1288683000,1189173000,1098961000,4348000,NA,78150000,78150000,NA,income_statement,Electrical Equipment & Parts,Encore Wire Corporation,"Encore Wire Corporation manufactures and sells electrical building wires and cables for interior electrical wiring in the United States. Its products include NM-B cables for use as interior wiring in homes, apartments, and manufactured housing; THHN/THWN-2 cables that are metal-clad and armored cables for use as wiring in commercial and industrial buildings; UF-B cables; XHHW-2 cables; RHH/RHW-2 cables; and other types of wire products. The company sells its products to wholesale electrical distributors primarily through independent manufacturers' representatives. Encore Wire Corporation was founded in 1989 and is headquartered in McKinney, Texas."
WIRE,2019-12-31,NA,75728000,NA,58129000,94212000,165971000,71529000,71529000,-200000,17599000,1274994000,1203465000,1109023000,4199000,NA,58129000,58129000,NA,income_statement,Electrical Equipment & Parts,Encore Wire Corporation,"Encore Wire Corporation manufactures and sells electrical building wires and cables for interior electrical wiring in the United States. Its products include NM-B cables for use as interior wiring in homes, apartments, and manufactured housing; THHN/THWN-2 cables that are metal-clad and armored cables for use as wiring in commercial and industrial buildings; UF-B cables; XHHW-2 cables; RHH/RHW-2 cables; and other types of wire products. The company sells its products to wholesale electrical distributors primarily through independent manufacturers' representatives. Encore Wire Corporation was founded in 1989 and is headquartered in McKinney, Texas."
WIRE,2020-12-31,NA,98796000,NA,76067000,97008000,194535000,97527000,97527000,-239000,22729000,1276948000,1179421000,1082413000,1269000,NA,76067000,76067000,NA,income_statement,Electrical Equipment & Parts,Encore Wire Corporation,"Encore Wire Corporation manufactures and sells electrical building wires and cables for interior electrical wiring in the United States. Its products include NM-B cables for use as interior wiring in homes, apartments, and manufactured housing; THHN/THWN-2 cables that are metal-clad and armored cables for use as wiring in commercial and industrial buildings; UF-B cables; XHHW-2 cables; RHH/RHW-2 cables; and other types of wire products. The company sells its products to wholesale electrical distributors primarily through independent manufacturers' representatives. Encore Wire Corporation was founded in 1989 and is headquartered in McKinney, Texas."
WISA,2016-12-31,5218958,-9698834,NA,-9708269,3016955,-260677,-8496590,-8496590,-1863746,9435,1273113,9769703,1533790,-1202244,NA,-9708269,-9708269,NA,income_statement,Semiconductors,"Summit Wireless Technologies, I","Summit Wireless Technologies, Inc. develops wireless audio integrated circuits for home entertainment and professional audio markets in the United States, Europe, and the Asia Pacific. It offers TX modules for integration into televisions, audio-visual receivers, media hubs, and USB or HDMI dongles; and speaker systems. The company sells its products directly to original equipment manufacturers. The company was formerly known as Summit Semiconductor, Inc. and changed its name to Summit Wireless Technologies, Inc. in September 2018. Summit Semiconductor, Inc. was founded in 2010 and is headquartered in San Jose, California."
WISA,2017-12-31,3664629,-25646603,NA,-25652213,3018084,-158808,-6841521,-6841521,-14696283,5610,1112726,7954247,1271534,-18805082,NA,-25652213,-25652213,NA,income_statement,Semiconductors,"Summit Wireless Technologies, I","Summit Wireless Technologies, Inc. develops wireless audio integrated circuits for home entertainment and professional audio markets in the United States, Europe, and the Asia Pacific. It offers TX modules for integration into televisions, audio-visual receivers, media hubs, and USB or HDMI dongles; and speaker systems. The company sells its products directly to original equipment manufacturers. The company was formerly known as Summit Semiconductor, Inc. and changed its name to Summit Wireless Technologies, Inc. in September 2018. Summit Semiconductor, Inc. was founded in 2010 and is headquartered in San Jose, California."
WISA,2018-12-31,4873000,-67349000,NA,-67357000,6460000,-238000,-11571000,-11571000,-33502000,8000,1374000,12945000,1612000,-55778000,NA,-67357000,-67357000,NA,income_statement,Semiconductors,"Summit Wireless Technologies, I","Summit Wireless Technologies, Inc. develops wireless audio integrated circuits for home entertainment and professional audio markets in the United States, Europe, and the Asia Pacific. It offers TX modules for integration into televisions, audio-visual receivers, media hubs, and USB or HDMI dongles; and speaker systems. The company sells its products directly to original equipment manufacturers. The company was formerly known as Summit Semiconductor, Inc. and changed its name to Summit Wireless Technologies, Inc. in September 2018. Summit Semiconductor, Inc. was founded in 2010 and is headquartered in San Jose, California."
WISA,2019-12-31,5427000,-12030000,NA,-12038000,5663000,-71000,-12053000,-12053000,NA,8000,1666000,13719000,1737000,23000,NA,-12038000,-12094000,NA,income_statement,Semiconductors,"Summit Wireless Technologies, I","Summit Wireless Technologies, Inc. develops wireless audio integrated circuits for home entertainment and professional audio markets in the United States, Europe, and the Asia Pacific. It offers TX modules for integration into televisions, audio-visual receivers, media hubs, and USB or HDMI dongles; and speaker systems. The company sells its products directly to original equipment manufacturers. The company was formerly known as Summit Semiconductor, Inc. and changed its name to Summit Wireless Technologies, Inc. in September 2018. Summit Semiconductor, Inc. was founded in 2010 and is headquartered in San Jose, California."
WISH,2017-12-31,28000000,-207000000,NA,-207000000,1015000000,896000000,-147000000,-147000000,NA,0,1101000000,1248000000,205000000,-60000000,NA,-207000000,-247000000,NA,income_statement,Internet Retail,ContextLogic Inc.,"ContextLogic Inc. operates as a mobile ecommerce company in Europe, North America, South America, and internationally. It operates Wish, an ecommerce platform that connects merchants and consumers. The company was founded in 2010 and is headquartered in San Francisco, California."
WISH,2018-12-31,45000000,-208000000,NA,-208000000,1628000000,1450000000,-223000000,-223000000,NA,0,1728000000,1951000000,278000000,15000000,NA,-208000000,-208000000,NA,income_statement,Internet Retail,ContextLogic Inc.,"ContextLogic Inc. operates as a mobile ecommerce company in Europe, North America, South America, and internationally. It operates Wish, an ecommerce platform that connects merchants and consumers. The company was founded in 2010 and is headquartered in San Francisco, California."
WISH,2019-12-31,74000000,-128000000,NA,-129000000,1528000000,1458000000,-144000000,-144000000,NA,1000000,1901000000,2045000000,443000000,16000000,NA,-129000000,-136000000,NA,income_statement,Internet Retail,ContextLogic Inc.,"ContextLogic Inc. operates as a mobile ecommerce company in Europe, North America, South America, and internationally. It operates Wish, an ecommerce platform that connects merchants and consumers. The company was founded in 2010 and is headquartered in San Francisco, California."
WIX,2017-12-31,153635000,-54950000,NA,-56273000,252621000,356245000,-50011000,-50011000,-10004000,1323000,425636000,475647000,69391000,-4939000,NA,-56273000,-56273000,NA,income_statement,Software—Infrastructure,Wix.com Ltd.,"Wix.com Ltd, together with its subsidiaries, develops and markets a cloud-based platform that enables anyone to create a website or web application in North America, Europe, Latin America, Asia, and internationally. The company offers Wix Editor, a drag-and-drop visual development and website editing environment platform; Wix ADI that enables users to create a website for their specific needs; and Corvid by Wix to create websites and web applications. It also provides Ascend by Wix, which offers its users access to a suite of approximately 20 products or features enabling them to connect with their customers, automate their work, and grow their business; Wix Logo Maker that allows users to generate a logo using artificial intelligence; Wix Answers, a support infrastructure enabling its users to help their users across various channels; and Wix Payments, a payment platform, which helps its users receive payments from their users through their Wix Website. In addition, the company offers various vertical-specific applications that business owners use to operate various aspects of their business online. Further, it provides a range of complementary services, including App Market that offers its registered users the ability to install and uninstall a range of free and paid web applications; Wix Arena, an online marketplace that brings users seeking help in creating and managing a website, together with Web experts; and Wix App, a native mobile application, which enables users to manage their Websites and Wix operating systems. As of December 31, 2019, the company had approximately 165 million registered users and 4.5 million premium subscriptions. The company was formerly known as Wixpress Ltd. Wix.com Ltd. was founded in 2006 and is headquartered in Tel Aviv, Israel."
WIX,2018-12-31,198912000,-33913000,NA,-37120000,308475000,476757000,-30630000,-30630000,-10004000,3207000,603704000,634334000,126947000,-3283000,NA,-37120000,-37120000,NA,income_statement,Software—Infrastructure,Wix.com Ltd.,"Wix.com Ltd, together with its subsidiaries, develops and markets a cloud-based platform that enables anyone to create a website or web application in North America, Europe, Latin America, Asia, and internationally. The company offers Wix Editor, a drag-and-drop visual development and website editing environment platform; Wix ADI that enables users to create a website for their specific needs; and Corvid by Wix to create websites and web applications. It also provides Ascend by Wix, which offers its users access to a suite of approximately 20 products or features enabling them to connect with their customers, automate their work, and grow their business; Wix Logo Maker that allows users to generate a logo using artificial intelligence; Wix Answers, a support infrastructure enabling its users to help their users across various channels; and Wix Payments, a payment platform, which helps its users receive payments from their users through their Wix Website. In addition, the company offers various vertical-specific applications that business owners use to operate various aspects of their business online. Further, it provides a range of complementary services, including App Market that offers its registered users the ability to install and uninstall a range of free and paid web applications; Wix Arena, an online marketplace that brings users seeking help in creating and managing a website, together with Web experts; and Wix App, a native mobile application, which enables users to manage their Websites and Wix operating systems. As of December 31, 2019, the company had approximately 165 million registered users and 4.5 million premium subscriptions. The company was formerly known as Wixpress Ltd. Wix.com Ltd. was founded in 2006 and is headquartered in Tel Aviv, Israel."
WIX,2019-12-31,250791000,-83816000,NA,-86414000,393640000,564181000,-80250000,-80250000,-20938000,2598000,761088000,841338000,196907000,-3566000,NA,-86414000,-86414000,NA,income_statement,Software—Infrastructure,Wix.com Ltd.,"Wix.com Ltd, together with its subsidiaries, develops and markets a cloud-based platform that enables anyone to create a website or web application in North America, Europe, Latin America, Asia, and internationally. The company offers Wix Editor, a drag-and-drop visual development and website editing environment platform; Wix ADI that enables users to create a website for their specific needs; and Corvid by Wix to create websites and web applications. It also provides Ascend by Wix, which offers its users access to a suite of approximately 20 products or features enabling them to connect with their customers, automate their work, and grow their business; Wix Logo Maker that allows users to generate a logo using artificial intelligence; Wix Answers, a support infrastructure enabling its users to help their users across various channels; and Wix Payments, a payment platform, which helps its users receive payments from their users through their Wix Website. In addition, the company offers various vertical-specific applications that business owners use to operate various aspects of their business online. Further, it provides a range of complementary services, including App Market that offers its registered users the ability to install and uninstall a range of free and paid web applications; Wix Arena, an online marketplace that brings users seeking help in creating and managing a website, together with Web experts; and Wix App, a native mobile application, which enables users to manage their Websites and Wix operating systems. As of December 31, 2019, the company had approximately 165 million registered users and 4.5 million premium subscriptions. The company was formerly known as Wixpress Ltd. Wix.com Ltd. was founded in 2006 and is headquartered in Tel Aviv, Israel."
WIX,2020-12-31,320278000,-216874000,NA,-216520000,550125000,673826000,-196577000,-196577000,-19650000,-354000,988760000,1185337000,314934000,-20297000,NA,-216520000,-216520000,NA,income_statement,Software—Infrastructure,Wix.com Ltd.,"Wix.com Ltd, together with its subsidiaries, develops and markets a cloud-based platform that enables anyone to create a website or web application in North America, Europe, Latin America, Asia, and internationally. The company offers Wix Editor, a drag-and-drop visual development and website editing environment platform; Wix ADI that enables users to create a website for their specific needs; and Corvid by Wix to create websites and web applications. It also provides Ascend by Wix, which offers its users access to a suite of approximately 20 products or features enabling them to connect with their customers, automate their work, and grow their business; Wix Logo Maker that allows users to generate a logo using artificial intelligence; Wix Answers, a support infrastructure enabling its users to help their users across various channels; and Wix Payments, a payment platform, which helps its users receive payments from their users through their Wix Website. In addition, the company offers various vertical-specific applications that business owners use to operate various aspects of their business online. Further, it provides a range of complementary services, including App Market that offers its registered users the ability to install and uninstall a range of free and paid web applications; Wix Arena, an online marketplace that brings users seeking help in creating and managing a website, together with Web experts; and Wix App, a native mobile application, which enables users to manage their Websites and Wix operating systems. As of December 31, 2019, the company had approximately 165 million registered users and 4.5 million premium subscriptions. The company was formerly known as Wixpress Ltd. Wix.com Ltd. was founded in 2006 and is headquartered in Tel Aviv, Israel."
WKEY,2016-12-31,1438000,-36501000,-1083000,-35926000,39283000,4426000,-36183000,-36183000,-947000,-16000,10962000,47145000,6536000,-318000,-14624000,-36485000,-35926000,-112000,income_statement,Semiconductors,WISeKey International Holding A,"WISeKey International Holding AG, a cybersecurity company, provides integrated security solutions for the Internet of Things (IoT) and digital identity ecosystems in Switzerland, rest of Europe, North America, the Asia Pacific, and Latin America. The company operates through two segments, IoT and mPKI. It offers microcontrollers and microchips that provides identity to various connected devices; and managed public key infrastructure, which include digital identity, certificate management and signing solutions, and trust services, as well as offers digital certificates, software as a service (SaaS), software license, and post-contract customer support for cybersecurity applications. The company also develops, markets, hosts, and supports a range of solutions that enable secure digital identification of people, content, and objects by generating digital identities through its products and services in cybersecurity services, IoT, digital brand management, and mobile security, which enable clients to monetize their existing user bases, as well as expand its eco-system. In addition, the company operates ISTANA platform that uses cybersecurity SaaS business and semiconductor chips for securing the IoT market, as well as uses artificial intelligence to analyze data; and engages in financing, sales, and distribution activities. WISeKey International Holding AG has a strategic partnership agreement with Turing Crypto GmbH to offer a suite of SSL/TLS services in the Asia-Pacific region. The company was founded in 1999 and is headquartered in Zug, Switzerland."
WKEY,2017-12-31,5339000,-10055000,-883000,-24267000,20003000,15804000,-8012000,-8012000,-543000,71000,33674000,41686000,17870000,-2043000,-14624000,-10126000,-24267000,-1526000,income_statement,Semiconductors,WISeKey International Holding A,"WISeKey International Holding AG, a cybersecurity company, provides integrated security solutions for the Internet of Things (IoT) and digital identity ecosystems in Switzerland, rest of Europe, North America, the Asia Pacific, and Latin America. The company operates through two segments, IoT and mPKI. It offers microcontrollers and microchips that provides identity to various connected devices; and managed public key infrastructure, which include digital identity, certificate management and signing solutions, and trust services, as well as offers digital certificates, software as a service (SaaS), software license, and post-contract customer support for cybersecurity applications. The company also develops, markets, hosts, and supports a range of solutions that enable secure digital identification of people, content, and objects by generating digital identities through its products and services in cybersecurity services, IoT, digital brand management, and mobile security, which enable clients to monetize their existing user bases, as well as expand its eco-system. In addition, the company operates ISTANA platform that uses cybersecurity SaaS business and semiconductor chips for securing the IoT market, as well as uses artificial intelligence to analyze data; and engages in financing, sales, and distribution activities. WISeKey International Holding AG has a strategic partnership agreement with Turing Crypto GmbH to offer a suite of SSL/TLS services in the Asia-Pacific region. The company was founded in 1999 and is headquartered in Zug, Switzerland."
WKEY,2018-12-31,5306000,-9855000,-883000,-16278000,19844000,15961000,-9489000,-9489000,-394000,53000,34280000,43769000,18319000,-366000,-6357000,-9908000,-16278000,300000,income_statement,Semiconductors,WISeKey International Holding A,"WISeKey International Holding AG, a cybersecurity company, provides integrated security solutions for the Internet of Things (IoT) and digital identity ecosystems in Switzerland, rest of Europe, North America, the Asia Pacific, and Latin America. The company operates through two segments, IoT and mPKI. It offers microcontrollers and microchips that provides identity to various connected devices; and managed public key infrastructure, which include digital identity, certificate management and signing solutions, and trust services, as well as offers digital certificates, software as a service (SaaS), software license, and post-contract customer support for cybersecurity applications. The company also develops, markets, hosts, and supports a range of solutions that enable secure digital identification of people, content, and objects by generating digital identities through its products and services in cybersecurity services, IoT, digital brand management, and mobile security, which enable clients to monetize their existing user bases, as well as expand its eco-system. In addition, the company operates ISTANA platform that uses cybersecurity SaaS business and semiconductor chips for securing the IoT market, as well as uses artificial intelligence to analyze data; and engages in financing, sales, and distribution activities. WISeKey International Holding AG has a strategic partnership agreement with Turing Crypto GmbH to offer a suite of SSL/TLS services in the Asia-Pacific region. The company was founded in 1999 and is headquartered in Zug, Switzerland."
WKEY,2019-12-31,6422000,-23017000,-1571000,8187000,23550000,9456000,-20675925,-20675925,-1385000,13000,22652000,43327925,13196000,-2341075,30484000,-23030000,8187000,159925,income_statement,Semiconductors,WISeKey International Holding A,"WISeKey International Holding AG, a cybersecurity company, provides integrated security solutions for the Internet of Things (IoT) and digital identity ecosystems in Switzerland, rest of Europe, North America, the Asia Pacific, and Latin America. The company operates through two segments, IoT and mPKI. It offers microcontrollers and microchips that provides identity to various connected devices; and managed public key infrastructure, which include digital identity, certificate management and signing solutions, and trust services, as well as offers digital certificates, software as a service (SaaS), software license, and post-contract customer support for cybersecurity applications. The company also develops, markets, hosts, and supports a range of solutions that enable secure digital identification of people, content, and objects by generating digital identities through its products and services in cybersecurity services, IoT, digital brand management, and mobile security, which enable clients to monetize their existing user bases, as well as expand its eco-system. In addition, the company operates ISTANA platform that uses cybersecurity SaaS business and semiconductor chips for securing the IoT market, as well as uses artificial intelligence to analyze data; and engages in financing, sales, and distribution activities. WISeKey International Holding AG has a strategic partnership agreement with Turing Crypto GmbH to offer a suite of SSL/TLS services in the Asia-Pacific region. The company was founded in 1999 and is headquartered in Zug, Switzerland."
WKHS,2016-12-31,6145801,-19555868,NA,-19555868,6202569,-7163462,-19511832,-19511832,-44036,0,6414800,25926632,13578262,-44036,NA,-19555868,-19555868,-12194800,income_statement,Auto Manufacturers,"Workhorse Group, Inc.","Workhorse Group Inc., a technology company, designs, manufactures, builds, and sells battery-electric vehicles and aircraft in the United States. The company also develops cloud-based and real-time telematics performance monitoring systems that enable fleet operators to optimize energy and route efficiency. Its products medium-duty trucks under the Workhorse brand; and HorseFly delivery drones systems. The company was formerly known as AMP Holding Inc. and changed its name to Workhorse Group Inc. in April 2015. Workhorse Group Inc. was founded in 2007 and is headquartered in Loveland, Ohio."
WKHS,2017-12-31,17737737,-41216788,NA,-41216788,8820211,-14478403,-41036351,-41036351,-180437,0,10038460,51074811,24516863,-180437,NA,-41216788,-41216788,-12194800,income_statement,Auto Manufacturers,"Workhorse Group, Inc.","Workhorse Group Inc., a technology company, designs, manufactures, builds, and sells battery-electric vehicles and aircraft in the United States. The company also develops cloud-based and real-time telematics performance monitoring systems that enable fleet operators to optimize energy and route efficiency. Its products medium-duty trucks under the Workhorse brand; and HorseFly delivery drones systems. The company was formerly known as AMP Holding Inc. and changed its name to Workhorse Group Inc. in April 2015. Workhorse Group Inc. was founded in 2007 and is headquartered in Loveland, Ohio."
WKHS,2018-12-31,7391693,-36502316,NA,-36502316,11485482,-15190392,-34067567,-34067567,-2868419,0,763173,34830740,15953565,-2434749,NA,-36502316,-37267495,-12194800,income_statement,Auto Manufacturers,"Workhorse Group, Inc.","Workhorse Group Inc., a technology company, designs, manufactures, builds, and sells battery-electric vehicles and aircraft in the United States. The company also develops cloud-based and real-time telematics performance monitoring systems that enable fleet operators to optimize energy and route efficiency. Its products medium-duty trucks under the Workhorse brand; and HorseFly delivery drones systems. The company was formerly known as AMP Holding Inc. and changed its name to Workhorse Group Inc. in April 2015. Workhorse Group Inc. was founded in 2007 and is headquartered in Loveland, Ohio."
WKHS,2019-12-31,8199074,-37162827,NA,-37162827,10199534,-5468329,-11672137,-11672137,-6596143,0,376562,12048699,5844891,-25490690,NA,-37162827,-37249034,-12194800,income_statement,Auto Manufacturers,"Workhorse Group, Inc.","Workhorse Group Inc., a technology company, designs, manufactures, builds, and sells battery-electric vehicles and aircraft in the United States. The company also develops cloud-based and real-time telematics performance monitoring systems that enable fleet operators to optimize energy and route efficiency. Its products medium-duty trucks under the Workhorse brand; and HorseFly delivery drones systems. The company was formerly known as AMP Holding Inc. and changed its name to Workhorse Group Inc. in April 2015. Workhorse Group Inc. was founded in 2007 and is headquartered in Loveland, Ohio."
WLDN,2016-12-30,NA,11367000,NA,8299000,50862000,65681000,11615000,11615000,-179000,3068000,208941000,197326000,143260000,-248000,NA,8299000,8299000,NA,income_statement,Engineering & Construction,"Willdan Group, Inc.","Willdan Group, Inc., together with its subsidiaries, provides professional, technical and consulting services primarily in the United States. It operates in two segments, Energy, and Engineering and Consulting. The Energy segment offers comprehensive audit and surveys, program design, master planning, demand reduction, grid optimization, benchmarking analyses, design engineering, construction management, performance contracting, installation, alternative financing, and measurement and verification services, as well as software and data analytics. The Engineering and Consulting segment provides building and safety, city engineering, code enforcement, development plan review and inspection, disaster recovery, geotechnical and earthquake engineering, planning and surveying, contract staff support, program and construction management, structural engineering, transportation and traffic engineering, and water resources services. This segment also offers district administration, financial consulting, and federal compliance services; emergency preparedness, planning, training, and exercise services; and communications and technology services. The company serves public and governmental agencies, including cities, counties, redevelopment agencies, water districts, school districts, and universities; investor and municipal owned energy utilities; state and federal agencies; commercial and industrial firms; and tribal governments, as well as various other special districts and agencies. Willdan Group, Inc. was founded in 1964 and is headquartered in Anaheim, California."
WLDN,2017-12-29,NA,13691000,NA,12129000,58859000,76690000,13882000,13882000,-111000,1562000,273352000,259470000,196662000,-191000,NA,12129000,12129000,NA,income_statement,Engineering & Construction,"Willdan Group, Inc.","Willdan Group, Inc., together with its subsidiaries, provides professional, technical and consulting services primarily in the United States. It operates in two segments, Energy, and Engineering and Consulting. The Energy segment offers comprehensive audit and surveys, program design, master planning, demand reduction, grid optimization, benchmarking analyses, design engineering, construction management, performance contracting, installation, alternative financing, and measurement and verification services, as well as software and data analytics. The Engineering and Consulting segment provides building and safety, city engineering, code enforcement, development plan review and inspection, disaster recovery, geotechnical and earthquake engineering, planning and surveying, contract staff support, program and construction management, structural engineering, transportation and traffic engineering, and water resources services. This segment also offers district administration, financial consulting, and federal compliance services; emergency preparedness, planning, training, and exercise services; and communications and technology services. The company serves public and governmental agencies, including cities, counties, redevelopment agencies, water districts, school districts, and universities; investor and municipal owned energy utilities; state and federal agencies; commercial and industrial firms; and tribal governments, as well as various other special districts and agencies. Willdan Group, Inc. was founded in 1964 and is headquartered in Anaheim, California."
WLDN,2018-12-28,NA,12161000,NA,10030000,72613000,92971000,14298000,14298000,-700000,2131000,272252000,257954000,179281000,-2137000,NA,10030000,10030000,NA,income_statement,Engineering & Construction,"Willdan Group, Inc.","Willdan Group, Inc., together with its subsidiaries, provides professional, technical and consulting services primarily in the United States. It operates in two segments, Energy, and Engineering and Consulting. The Energy segment offers comprehensive audit and surveys, program design, master planning, demand reduction, grid optimization, benchmarking analyses, design engineering, construction management, performance contracting, installation, alternative financing, and measurement and verification services, as well as software and data analytics. The Engineering and Consulting segment provides building and safety, city engineering, code enforcement, development plan review and inspection, disaster recovery, geotechnical and earthquake engineering, planning and surveying, contract staff support, program and construction management, structural engineering, transportation and traffic engineering, and water resources services. This segment also offers district administration, financial consulting, and federal compliance services; emergency preparedness, planning, training, and exercise services; and communications and technology services. The company serves public and governmental agencies, including cities, counties, redevelopment agencies, water districts, school districts, and universities; investor and municipal owned energy utilities; state and federal agencies; commercial and industrial firms; and tribal governments, as well as various other special districts and agencies. Willdan Group, Inc. was founded in 1964 and is headquartered in Anaheim, California."
WLDN,2019-12-27,NA,4656000,NA,4841000,109583000,134973000,10363000,10363000,-4900000,-185000,443099000,432736000,308126000,-5707000,NA,4841000,4841000,NA,income_statement,Engineering & Construction,"Willdan Group, Inc.","Willdan Group, Inc., together with its subsidiaries, provides professional, technical and consulting services primarily in the United States. It operates in two segments, Energy, and Engineering and Consulting. The Energy segment offers comprehensive audit and surveys, program design, master planning, demand reduction, grid optimization, benchmarking analyses, design engineering, construction management, performance contracting, installation, alternative financing, and measurement and verification services, as well as software and data analytics. The Engineering and Consulting segment provides building and safety, city engineering, code enforcement, development plan review and inspection, disaster recovery, geotechnical and earthquake engineering, planning and surveying, contract staff support, program and construction management, structural engineering, transportation and traffic engineering, and water resources services. This segment also offers district administration, financial consulting, and federal compliance services; emergency preparedness, planning, training, and exercise services; and communications and technology services. The company serves public and governmental agencies, including cities, counties, redevelopment agencies, water districts, school districts, and universities; investor and municipal owned energy utilities; state and federal agencies; commercial and industrial firms; and tribal governments, as well as various other special districts and agencies. Willdan Group, Inc. was founded in 1964 and is headquartered in Anaheim, California."
WLFC,2016-12-31,NA,23946000,NA,14069000,54773000,189381000,68928000,68928000,-41144000,9877000,202674000,133746000,13293000,-44982000,NA,14069000,13780000,-600000,income_statement,Rental & Leasing Services,Willis Lease Finance Corporatio,"Willis Lease Finance Corporation engages in acquiring and leasing commercial aircraft, aircraft engines, and related aircraft equipment for air carriers, manufacturers, and overhaul/repair facilities worldwide. The company operates through two segments, Leasing and Related Operations, and Spare Parts Sales. It is also involved in the purchase and resale of commercial aircraft engines and other aircraft equipment; and after-market engine parts, whole engines, engine modules, and portable aircraft components, as well as in the engine management and consulting business. As of March 31, 2020, the company had an operating lease portfolio of 260 engines, 10 aircraft, 10 other leased parts and equipment, and one marine vessel; and managed 451 engines, aircraft, and related equipment on behalf of other parties. Willis Lease Finance Corporation was founded in 1985 and is headquartered in Coconut Creek, Florida."
WLFC,2017-12-31,NA,36011000,NA,62158000,65466000,232704000,101215000,101215000,-48720000,-26147000,273552000,172337000,40848000,-65204000,NA,62158000,60299000,NA,income_statement,Rental & Leasing Services,Willis Lease Finance Corporatio,"Willis Lease Finance Corporation engages in acquiring and leasing commercial aircraft, aircraft engines, and related aircraft equipment for air carriers, manufacturers, and overhaul/repair facilities worldwide. The company operates through two segments, Leasing and Related Operations, and Spare Parts Sales. It is also involved in the purchase and resale of commercial aircraft engines and other aircraft equipment; and after-market engine parts, whole engines, engine modules, and portable aircraft components, as well as in the engine management and consulting business. As of March 31, 2020, the company had an operating lease portfolio of 260 engines, 10 aircraft, 10 other leased parts and equipment, and one marine vessel; and managed 451 engines, aircraft, and related equipment on behalf of other parties. Willis Lease Finance Corporation was founded in 1985 and is headquartered in Coconut Creek, Florida."
WLFC,2018-12-31,NA,56274000,NA,43231000,83163000,287322000,127345000,127345000,-64220000,13043000,348347000,221002000,61025000,-71071000,NA,43231000,39898000,NA,income_statement,Rental & Leasing Services,Willis Lease Finance Corporatio,"Willis Lease Finance Corporation engages in acquiring and leasing commercial aircraft, aircraft engines, and related aircraft equipment for air carriers, manufacturers, and overhaul/repair facilities worldwide. The company operates through two segments, Leasing and Related Operations, and Spare Parts Sales. It is also involved in the purchase and resale of commercial aircraft engines and other aircraft equipment; and after-market engine parts, whole engines, engine modules, and portable aircraft components, as well as in the engine management and consulting business. As of March 31, 2020, the company had an operating lease portfolio of 260 engines, 10 aircraft, 10 other leased parts and equipment, and one marine vessel; and managed 451 engines, aircraft, and related equipment on behalf of other parties. Willis Lease Finance Corporation was founded in 1985 and is headquartered in Coconut Creek, Florida."
WLFC,2019-12-31,NA,88881000,NA,66922000,94645000,346513000,165632000,165632000,-66889000,21959000,409160000,243528000,62647000,-76751000,NA,66922000,63588000,NA,income_statement,Rental & Leasing Services,Willis Lease Finance Corporatio,"Willis Lease Finance Corporation engages in acquiring and leasing commercial aircraft, aircraft engines, and related aircraft equipment for air carriers, manufacturers, and overhaul/repair facilities worldwide. The company operates through two segments, Leasing and Related Operations, and Spare Parts Sales. It is also involved in the purchase and resale of commercial aircraft engines and other aircraft equipment; and after-market engine parts, whole engines, engine modules, and portable aircraft components, as well as in the engine management and consulting business. As of March 31, 2020, the company had an operating lease portfolio of 260 engines, 10 aircraft, 10 other leased parts and equipment, and one marine vessel; and managed 451 engines, aircraft, and related equipment on behalf of other parties. Willis Lease Finance Corporation was founded in 1985 and is headquartered in Coconut Creek, Florida."
WLTW,2017-12-31,NA,492000000,151000000,568000000,261000000,3457000000,1139000000,1139000000,-188000000,-100000000,8202000000,7063000000,4745000000,-647000000,NA,592000000,568000000,1273000000,income_statement,NA,NA,NA
WLTW,2018-12-31,NA,851000000,145000000,695000000,243000000,3670000000,1291000000,1291000000,-208000000,136000000,8513000000,7222000000,4843000000,-440000000,NA,715000000,695000000,1394000000,income_statement,NA,NA,NA
WLTW,2019-12-31,NA,1322000000,120000000,1044000000,244000000,4024000000,1576000000,1576000000,-234000000,249000000,9039000000,7463000000,5015000000,-254000000,NA,1073000000,1044000000,1475000000,income_statement,NA,NA,NA
WLTW,2020-12-31,NA,1338000000,112000000,996000000,NA,3845000000,1352000000,1352000000,-244000000,318000000,9352000000,8000000000,5507000000,-14000000,NA,1020000000,996000000,1758000000,income_statement,NA,NA,NA
WM,2016-12-31,NA,1822000000,23000000,1182000000,1410000000,5123000000,2412000000,2412000000,-385000000,642000000,13609000000,11197000000,8486000000,-590000000,NA,1180000000,1182000000,NA,income_statement,NA,NA,NA
WM,2017-12-31,NA,2191000000,23000000,1949000000,1468000000,5464000000,2620000000,2620000000,-368000000,242000000,14485000000,11865000000,9021000000,-429000000,NA,1949000000,1949000000,NA,income_statement,NA,NA,NA
WM,2018-12-31,NA,2376000000,1000000,1925000000,1453000000,5665000000,2735000000,2735000000,-384000000,453000000,14914000000,12179000000,9249000000,-359000000,NA,1923000000,1925000000,NA,income_statement,NA,NA,NA
WM,2019-12-31,NA,2105000000,2000000,1670000000,1631000000,5975000000,2770000000,2770000000,-464000000,434000000,15455000000,12685000000,9480000000,-665000000,NA,1671000000,1670000000,NA,income_statement,NA,NA,NA
WMB,2016-12-31,NA,-375000000,9403000000,-424000000,716000000,4182000000,1623000000,1623000000,-1179000000,-25000000,7499000000,5876000000,3317000000,-1998000000,-15000000,-350000000,-424000000,80000000,income_statement,NA,NA,NA
WMB,2017-12-31,NA,535000000,6519000000,2174000000,656000000,4155000000,1680000000,1680000000,-1083000000,-1974000000,8031000000,6351000000,3876000000,-1145000000,-15000000,2509000000,2174000000,83000000,income_statement,NA,NA,NA
WMB,2018-12-31,NA,331000000,1337000000,-155000000,574000000,4335000000,1932000000,1932000000,-1112000000,138000000,8686000000,6754000000,4351000000,-1601000000,-15000000,193000000,-156000000,104000000,income_statement,NA,NA,NA
WMB,2019-12-31,NA,1064000000,3001000000,850000000,533000000,4699000000,2432000000,2432000000,-1186000000,335000000,8201000000,5769000000,3502000000,-1368000000,-15000000,729000000,847000000,20000000,income_statement,NA,NA,NA
WMG,2017-09-30,NA,-2000000,15000000,143000000,1222000000,1645000000,222000000,222000000,-149000000,-151000000,3576000000,3354000000,1931000000,-224000000,NA,149000000,143000000,NA,income_statement,Entertainment,Warner Music Group Corp.,"Warner Music Group Corp. operates as a music entertainment company in the United States, the United Kingdom, and internationally. The company operates through Recorded Music and Music Publishing segments. The Recorded Music segment is involved in the discovery and development of recording artists, as well as the related marketing, promotion, distribution, sale, and licensing of music created by such artists. This segment also specializes in marketing its music catalog through compilations and reissuances of previously released music and video titles, as well as previously unreleased materials. It conducts its operation primarily through a collection of record labels, such as Warner Records and Atlantic Records, as well as Asylum, Big Beat, Canvasback, East West, Elektra, Erato, FFRR, Fueled by Ramen, Nonesuch, Parlophone, Reprise, Roadrunner, Sire, Spinnin', Warner Classics, and Warner Music Nashville. This segment markets, distributes, and sells music and video products to retailers and wholesale distributors; independent labels to retail and wholesale distributors; and various distribution centers and ventures, as well as online physical retailers, streaming services, and download services. The Music Publishing segment owns and acquires rights to approximately one million musical compositions comprising pop hits, American standards, folk songs, and motion picture and theatrical compositions. Its catalog includes approximately 80,000 songwriters and composers; and a range of genres, including pop, rock, jazz, classical, country, R&B, hip-hop, rap, reggae, Latin, folk, blues, symphonic, soul, Broadway, techno, alternative, and gospel. This segment also administers the music and soundtracks of various third-party television and film producers and studios. The company was founded in 1929 and is headquartered in New York, New York. Warner Music Group Corp. is a subsidiary of AI Entertainment Holdings LLC."
WMG,2018-09-30,NA,442000000,14000000,307000000,1411000000,1834000000,217000000,217000000,-138000000,130000000,4005000000,3788000000,2171000000,225000000,NA,312000000,307000000,NA,income_statement,Entertainment,Warner Music Group Corp.,"Warner Music Group Corp. operates as a music entertainment company in the United States, the United Kingdom, and internationally. The company operates through Recorded Music and Music Publishing segments. The Recorded Music segment is involved in the discovery and development of recording artists, as well as the related marketing, promotion, distribution, sale, and licensing of music created by such artists. This segment also specializes in marketing its music catalog through compilations and reissuances of previously released music and video titles, as well as previously unreleased materials. It conducts its operation primarily through a collection of record labels, such as Warner Records and Atlantic Records, as well as Asylum, Big Beat, Canvasback, East West, Elektra, Erato, FFRR, Fueled by Ramen, Nonesuch, Parlophone, Reprise, Roadrunner, Sire, Spinnin', Warner Classics, and Warner Music Nashville. This segment markets, distributes, and sells music and video products to retailers and wholesale distributors; independent labels to retail and wholesale distributors; and various distribution centers and ventures, as well as online physical retailers, streaming services, and download services. The Music Publishing segment owns and acquires rights to approximately one million musical compositions comprising pop hits, American standards, folk songs, and motion picture and theatrical compositions. Its catalog includes approximately 80,000 songwriters and composers; and a range of genres, including pop, rock, jazz, classical, country, R&B, hip-hop, rap, reggae, Latin, folk, blues, symphonic, soul, Broadway, techno, alternative, and gospel. This segment also administers the music and soundtracks of various third-party television and film producers and studios. The company was founded in 1929 and is headquartered in New York, New York. Warner Music Group Corp. is a subsidiary of AI Entertainment Holdings LLC."
WMG,2019-09-30,NA,267000000,20000000,256000000,1483000000,2074000000,383000000,383000000,-142000000,9000000,4475000000,4092000000,2401000000,-116000000,NA,258000000,256000000,NA,income_statement,Entertainment,Warner Music Group Corp.,"Warner Music Group Corp. operates as a music entertainment company in the United States, the United Kingdom, and internationally. The company operates through Recorded Music and Music Publishing segments. The Recorded Music segment is involved in the discovery and development of recording artists, as well as the related marketing, promotion, distribution, sale, and licensing of music created by such artists. This segment also specializes in marketing its music catalog through compilations and reissuances of previously released music and video titles, as well as previously unreleased materials. It conducts its operation primarily through a collection of record labels, such as Warner Records and Atlantic Records, as well as Asylum, Big Beat, Canvasback, East West, Elektra, Erato, FFRR, Fueled by Ramen, Nonesuch, Parlophone, Reprise, Roadrunner, Sire, Spinnin', Warner Classics, and Warner Music Nashville. This segment markets, distributes, and sells music and video products to retailers and wholesale distributors; independent labels to retail and wholesale distributors; and various distribution centers and ventures, as well as online physical retailers, streaming services, and download services. The Music Publishing segment owns and acquires rights to approximately one million musical compositions comprising pop hits, American standards, folk songs, and motion picture and theatrical compositions. Its catalog includes approximately 80,000 songwriters and composers; and a range of genres, including pop, rock, jazz, classical, country, R&B, hip-hop, rap, reggae, Latin, folk, blues, symphonic, soul, Broadway, techno, alternative, and gospel. This segment also administers the music and soundtracks of various third-party television and film producers and studios. The company was founded in 1929 and is headquartered in New York, New York. Warner Music Group Corp. is a subsidiary of AI Entertainment Holdings LLC."
WMG,2020-09-30,NA,-447000000,18000000,-475000000,2034000000,2130000000,-94000000,-94000000,-127000000,23000000,4463000000,4557000000,2333000000,-353000000,NA,-470000000,-476000000,NA,income_statement,Entertainment,Warner Music Group Corp.,"Warner Music Group Corp. operates as a music entertainment company in the United States, the United Kingdom, and internationally. The company operates through Recorded Music and Music Publishing segments. The Recorded Music segment is involved in the discovery and development of recording artists, as well as the related marketing, promotion, distribution, sale, and licensing of music created by such artists. This segment also specializes in marketing its music catalog through compilations and reissuances of previously released music and video titles, as well as previously unreleased materials. It conducts its operation primarily through a collection of record labels, such as Warner Records and Atlantic Records, as well as Asylum, Big Beat, Canvasback, East West, Elektra, Erato, FFRR, Fueled by Ramen, Nonesuch, Parlophone, Reprise, Roadrunner, Sire, Spinnin', Warner Classics, and Warner Music Nashville. This segment markets, distributes, and sells music and video products to retailers and wholesale distributors; independent labels to retail and wholesale distributors; and various distribution centers and ventures, as well as online physical retailers, streaming services, and download services. The Music Publishing segment owns and acquires rights to approximately one million musical compositions comprising pop hits, American standards, folk songs, and motion picture and theatrical compositions. Its catalog includes approximately 80,000 songwriters and composers; and a range of genres, including pop, rock, jazz, classical, country, R&B, hip-hop, rap, reggae, Latin, folk, blues, symphonic, soul, Broadway, techno, alternative, and gospel. This segment also administers the music and soundtracks of various third-party television and film producers and studios. The company was founded in 1929 and is headquartered in New York, New York. Warner Music Group Corp. is a subsidiary of AI Entertainment Holdings LLC."
WMT,2017-01-31,NA,20497000000,2737000000,13643000000,101853000000,124617000000,22764000000,22764000000,-2367000000,6204000000,485873000000,463109000000,361256000000,-2267000000,NA,14293000000,13643000000,NA,income_statement,NA,NA,NA
WMT,2018-01-31,NA,15123000000,2953000000,9862000000,106010000000,126947000000,20937000000,20937000000,-2330000000,4600000000,500343000000,479406000000,373396000000,-5814000000,NA,10523000000,9862000000,NA,income_statement,NA,NA,NA
WMT,2019-01-31,NA,11460000000,7138000000,6670000000,106987000000,129104000000,22117000000,22117000000,-2346000000,4281000000,514405000000,492288000000,385301000000,-10657000000,NA,7179000000,6670000000,NA,income_statement,NA,NA,NA
WMT,2020-01-31,NA,20116000000,6883000000,14881000000,107891000000,129359000000,21468000000,21468000000,-2599000000,4915000000,523964000000,502496000000,394605000000,-1352000000,NA,15201000000,14881000000,NA,income_statement,NA,NA,NA
WNEB,2017-12-31,NA,21748000,NA,12320000,36965000,66535000,0,22894000,NA,9428000,66535000,43641000,0,-1146000,NA,12320000,12320000,6676000,income_statement,Banks—Regional,"Western New England Bancorp, In","Western New England Bancorp, Inc. operates as the holding company for Westfield Bank that provides commercial and retail banking products and services to individuals and businesses. The company accepts various deposit accounts, including checking, savings, business and municipal savings, money market and business sweep, and individual retirement accounts; time deposits; term certificates of deposit; and interest on lawyers trust accounts. It also offers commercial real estate loans; commercial construction loans; commercial and industrial loans, such as revolving lines of credit, working capital loans, equipment financing and term loans; residential real estate loans; home equity loans; and consumer loans. In addition, the company provides automated teller machines (ATM), telephone and online banking, remote deposit capture, cash management services, overdraft facilities, night deposit services, and safe deposit facilities. As of December 31, 2019, it operated a network of 22 banking offices, 25 free-standing ATMs, and 23 seasonal or temporary ATMS located in Agawam, Chicopee, Feeding Hills, East Longmeadow, Holyoke, Ludlow, South Hadley, Southwick, Springfield, Ware, West Springfield and Westfield, Massachusetts and Granby and Enfield, Connecticut. The company was formerly known as Westfield Financial, Inc. and changed its name to Western New England Bancorp, Inc. in October 2016. Western New England Bancorp, Inc. was founded in 1853 and is headquartered in Westfield, Massachusetts."
WNEB,2018-12-31,NA,21108000,NA,16408000,38360000,66630000,0,20996000,NA,4700000,66630000,45634000,0,112000,NA,16408000,16408000,7274000,income_statement,Banks—Regional,"Western New England Bancorp, In","Western New England Bancorp, Inc. operates as the holding company for Westfield Bank that provides commercial and retail banking products and services to individuals and businesses. The company accepts various deposit accounts, including checking, savings, business and municipal savings, money market and business sweep, and individual retirement accounts; time deposits; term certificates of deposit; and interest on lawyers trust accounts. It also offers commercial real estate loans; commercial construction loans; commercial and industrial loans, such as revolving lines of credit, working capital loans, equipment financing and term loans; residential real estate loans; home equity loans; and consumer loans. In addition, the company provides automated teller machines (ATM), telephone and online banking, remote deposit capture, cash management services, overdraft facilities, night deposit services, and safe deposit facilities. As of December 31, 2019, it operated a network of 22 banking offices, 25 free-standing ATMs, and 23 seasonal or temporary ATMS located in Agawam, Chicopee, Feeding Hills, East Longmeadow, Holyoke, Ludlow, South Hadley, Southwick, Springfield, Ware, West Springfield and Westfield, Massachusetts and Granby and Enfield, Connecticut. The company was formerly known as Westfield Financial, Inc. and changed its name to Western New England Bancorp, Inc. in October 2016. Western New England Bancorp, Inc. was founded in 1853 and is headquartered in Westfield, Massachusetts."
WNEB,2019-12-31,NA,17201000,NA,13349000,40052000,65009000,0,17631000,NA,3852000,65009000,47378000,0,-430000,NA,13349000,13349000,7326000,income_statement,Banks—Regional,"Western New England Bancorp, In","Western New England Bancorp, Inc. operates as the holding company for Westfield Bank that provides commercial and retail banking products and services to individuals and businesses. The company accepts various deposit accounts, including checking, savings, business and municipal savings, money market and business sweep, and individual retirement accounts; time deposits; term certificates of deposit; and interest on lawyers trust accounts. It also offers commercial real estate loans; commercial construction loans; commercial and industrial loans, such as revolving lines of credit, working capital loans, equipment financing and term loans; residential real estate loans; home equity loans; and consumer loans. In addition, the company provides automated teller machines (ATM), telephone and online banking, remote deposit capture, cash management services, overdraft facilities, night deposit services, and safe deposit facilities. As of December 31, 2019, it operated a network of 22 banking offices, 25 free-standing ATMs, and 23 seasonal or temporary ATMS located in Agawam, Chicopee, Feeding Hills, East Longmeadow, Holyoke, Ludlow, South Hadley, Southwick, Springfield, Ware, West Springfield and Westfield, Massachusetts and Granby and Enfield, Connecticut. The company was formerly known as Westfield Financial, Inc. and changed its name to Western New England Bancorp, Inc. in October 2016. Western New England Bancorp, Inc. was founded in 1853 and is headquartered in Westfield, Massachusetts."
WNEB,2020-12-31,NA,14156000,NA,11215000,41644000,65796000,0,16206000,NA,2941000,65796000,49590000,0,-2050000,NA,11215000,11215000,7946000,income_statement,Banks—Regional,"Western New England Bancorp, In","Western New England Bancorp, Inc. operates as the holding company for Westfield Bank that provides commercial and retail banking products and services to individuals and businesses. The company accepts various deposit accounts, including checking, savings, business and municipal savings, money market and business sweep, and individual retirement accounts; time deposits; term certificates of deposit; and interest on lawyers trust accounts. It also offers commercial real estate loans; commercial construction loans; commercial and industrial loans, such as revolving lines of credit, working capital loans, equipment financing and term loans; residential real estate loans; home equity loans; and consumer loans. In addition, the company provides automated teller machines (ATM), telephone and online banking, remote deposit capture, cash management services, overdraft facilities, night deposit services, and safe deposit facilities. As of December 31, 2019, it operated a network of 22 banking offices, 25 free-standing ATMs, and 23 seasonal or temporary ATMS located in Agawam, Chicopee, Feeding Hills, East Longmeadow, Holyoke, Ludlow, South Hadley, Southwick, Springfield, Ware, West Springfield and Westfield, Massachusetts and Granby and Enfield, Connecticut. The company was formerly known as Westfield Financial, Inc. and changed its name to Western New England Bancorp, Inc. in October 2016. Western New England Bancorp, Inc. was founded in 1853 and is headquartered in Westfield, Massachusetts."
WNW,2018-12-31,205609,-980098,NA,-980098,1005728,228050,-983287,-983287,NA,0,1076827,2060114,848777,3189,NA,-980098,-980098,NA,income_statement,Restaurants,Wunong Net Technology Company L,"Wunong Net Technology Company Limited, a holding company, through its subsidiary Wunong Technology (Shenzhen) Co., Ltd offers online retail of foods products in China. It primarily sells green food, organic food, intangible cultural heritage food, agricultural products, and pollution-free products. The company sells food products through its online retail store. It also operates a restaurant under the Wunong Food Hall name. Wunong Net Technology Company Limited was formerly known as Advancement International Limited and changed its name to Wunong Net Technology Company Limited in August 2019. Wunong Net Technology Company Limited was incorporated in 2018 and is headquartered in Shenzhen, the People's Republic of China."
WNW,2019-12-31,340534,-1755042,NA,-1755042,3322828,1904416,-1758946,-1758946,NA,0,7682583,9441529,5778167,3904,NA,-1755042,-1755042,NA,income_statement,Restaurants,Wunong Net Technology Company L,"Wunong Net Technology Company Limited, a holding company, through its subsidiary Wunong Technology (Shenzhen) Co., Ltd offers online retail of foods products in China. It primarily sells green food, organic food, intangible cultural heritage food, agricultural products, and pollution-free products. The company sells food products through its online retail store. It also operates a restaurant under the Wunong Food Hall name. Wunong Net Technology Company Limited was formerly known as Advancement International Limited and changed its name to Wunong Net Technology Company Limited in August 2019. Wunong Net Technology Company Limited was incorporated in 2018 and is headquartered in Shenzhen, the People's Republic of China."
WOOF,2019-02-02,NA,-459628000,-8330000,-413788000,1730887000,1904839000,158452000,158452000,-243744000,-45840000,4392173000,4233721000,2487334000,-618080000,NA,-413788000,-413788000,NA,income_statement,Specialty Retail,Petco Health and Wellness Compa,"Petco Health and Wellness Company, Inc. operates in the pet health and wellness business. It is involved in the retailing of pet consumables, supplies, and companion animals and services. The company also offers various services, such as outpatient veterinary care services through Vetco clinics; tele-veterinarian services; pet health insurance; grooming; and in-store and online training. The company also offers pet consumables, supplies, and services through its petco.com, petcoach.co, petinsurancequotes.com, and pupbox.com websites. As of January 13, 2021, it operated 1,500 pet care centers in the United States, Mexico, and Puerto Rico. The company was founded in 1965 and is headquartered in San Diego, California."
WOOF,2020-02-01,NA,-139642000,-8330000,-95873000,1775919000,1906519000,129600000,129600000,-253018000,-35658000,4434514000,4304914000,2527995000,-269242000,NA,-103984000,-95873000,NA,income_statement,Specialty Retail,Petco Health and Wellness Compa,"Petco Health and Wellness Company, Inc. operates in the pet health and wellness business. It is involved in the retailing of pet consumables, supplies, and companion animals and services. The company also offers various services, such as outpatient veterinary care services through Vetco clinics; tele-veterinarian services; pet health insurance; grooming; and in-store and online training. The company also offers pet consumables, supplies, and services through its petco.com, petcoach.co, petinsurancequotes.com, and pupbox.com websites. As of January 13, 2021, it operated 1,500 pet care centers in the United States, Mexico, and Puerto Rico. The company was founded in 1965 and is headquartered in San Diego, California."
WORX,2016-12-31,1120190,-348646,NA,-348646,551475,1329496,-342169,-342169,-6477,0,2160900,2503069,831404,-6477,NA,-348646,-348646,NA,income_statement,Health Information Services,SCWorx Corp.,"SCWorx Corp. provides software solutions for the management of health care providers' foundational business applications in the United States. The company provides services related to repair, normalization, and interoperability of information, as well as big data analytics model that provides Web portal for display, and reporting and analysis of the information contained within the data warehouse. It also offers various software solutions and services, such as virtualized item master file repair, expansion, and automation; electronic medical record management, a module that integrates the advanced data attributes created in the item master to the electronic medical records; charge description master management(CDM), a module, which assists healthcare providers by integrating the CDM data into the workflow of the hospitals purchasing systems; contract management, a module that assists healthcare providers to establish a contract management system and to provide care to patients; request for proposal automation solution; rebate management; ScanWorx, a mobile perioperative closed loop scanning solution; and data integration and warehousing, as well as solutions for integration of acquired businesses, which enable deployment of a virtual item master files. The company sells its solutions and services to hospitals and health systems through its distribution and reseller partnerships. In addition, it provides CageTix, a ticketing platform for mixed martial arts industry. Further, the company focuses on selling rapid test kits for COVID-19; and personal protective equipment. SCWorx Corp. is based in New York, New York."
WORX,2017-12-31,NA,-429196,NA,-429196,460216,163118,-297098,-297098,-132098,0,2514073,2811171,2350955,-132098,NA,-429196,-429196,NA,income_statement,Health Information Services,SCWorx Corp.,"SCWorx Corp. provides software solutions for the management of health care providers' foundational business applications in the United States. The company provides services related to repair, normalization, and interoperability of information, as well as big data analytics model that provides Web portal for display, and reporting and analysis of the information contained within the data warehouse. It also offers various software solutions and services, such as virtualized item master file repair, expansion, and automation; electronic medical record management, a module that integrates the advanced data attributes created in the item master to the electronic medical records; charge description master management(CDM), a module, which assists healthcare providers by integrating the CDM data into the workflow of the hospitals purchasing systems; contract management, a module that assists healthcare providers to establish a contract management system and to provide care to patients; request for proposal automation solution; rebate management; ScanWorx, a mobile perioperative closed loop scanning solution; and data integration and warehousing, as well as solutions for integration of acquired businesses, which enable deployment of a virtual item master files. The company sells its solutions and services to hospitals and health systems through its distribution and reseller partnerships. In addition, it provides CageTix, a ticketing platform for mixed martial arts industry. Further, the company focuses on selling rapid test kits for COVID-19; and personal protective equipment. SCWorx Corp. is based in New York, New York."
WORX,2018-12-31,NA,-380603,NA,-380603,658795,507616,-151179,-151179,-220091,0,3421937,3573116,2914321,-229424,NA,-380603,-380603,NA,income_statement,Health Information Services,SCWorx Corp.,"SCWorx Corp. provides software solutions for the management of health care providers' foundational business applications in the United States. The company provides services related to repair, normalization, and interoperability of information, as well as big data analytics model that provides Web portal for display, and reporting and analysis of the information contained within the data warehouse. It also offers various software solutions and services, such as virtualized item master file repair, expansion, and automation; electronic medical record management, a module that integrates the advanced data attributes created in the item master to the electronic medical records; charge description master management(CDM), a module, which assists healthcare providers by integrating the CDM data into the workflow of the hospitals purchasing systems; contract management, a module that assists healthcare providers to establish a contract management system and to provide care to patients; request for proposal automation solution; rebate management; ScanWorx, a mobile perioperative closed loop scanning solution; and data integration and warehousing, as well as solutions for integration of acquired businesses, which enable deployment of a virtual item master files. The company sells its solutions and services to hospitals and health systems through its distribution and reseller partnerships. In addition, it provides CageTix, a ticketing platform for mixed martial arts industry. Further, the company focuses on selling rapid test kits for COVID-19; and personal protective equipment. SCWorx Corp. is based in New York, New York."
WORX,2019-12-31,NA,-11312500,NA,-11312500,13063526,1166036,-11897490,-11897490,-23720,0,5548119,17445609,4382083,584990,NA,-11312500,-11312500,NA,income_statement,Health Information Services,SCWorx Corp.,"SCWorx Corp. provides software solutions for the management of health care providers' foundational business applications in the United States. The company provides services related to repair, normalization, and interoperability of information, as well as big data analytics model that provides Web portal for display, and reporting and analysis of the information contained within the data warehouse. It also offers various software solutions and services, such as virtualized item master file repair, expansion, and automation; electronic medical record management, a module that integrates the advanced data attributes created in the item master to the electronic medical records; charge description master management(CDM), a module, which assists healthcare providers by integrating the CDM data into the workflow of the hospitals purchasing systems; contract management, a module that assists healthcare providers to establish a contract management system and to provide care to patients; request for proposal automation solution; rebate management; ScanWorx, a mobile perioperative closed loop scanning solution; and data integration and warehousing, as well as solutions for integration of acquired businesses, which enable deployment of a virtual item master files. The company sells its solutions and services to hospitals and health systems through its distribution and reseller partnerships. In addition, it provides CageTix, a ticketing platform for mixed martial arts industry. Further, the company focuses on selling rapid test kits for COVID-19; and personal protective equipment. SCWorx Corp. is based in New York, New York."
WPRT,2016-12-31,55452000,-96722000,NA,-97573000,62961000,34126000,-95531000,-95531000,-10773000,3950000,167181000,262712000,133055000,-1191000,3099000,-100672000,-97573000,NA,income_statement,Auto Parts,Westport Fuel Systems Inc,"Westport Fuel Systems Inc. engineers, manufactures, and supplies alternative fuel systems and components for use in transportation applications worldwide. It operates through Transportation and Cummins Westport Inc. (CWI) Joint Venture segments. The company offers alternative fuel systems and components, which include a range of alternative fuels, such as liquefied petroleum gas, compressed natural gas, liquefied natural gas, renewable natural gas, and hydrogen; and independent aftermarket, original equipment manufacturers (OEMs) and delayed OEMs, electronics, current and advanced research and development programs, supply chain, and product planning activities. It also provides Westport High Pressure Direct Injection 2.0, a fully integrated system that powers compression ignition engines by natural gas, which reduces greenhouse gas emissions. In addition, the company develops, sells, and markets spark-ignited natural gas or propane engines; and CWI engines for transit, school and shuttle buses, conventional trucks and tractors, refuse collection trucks, and specialty vehicles, such as short-haul port drayage trucks and street sweepers. Its products and services are used for passenger cars; light-, medium-, and heavy-duty trucks; and horsepower, cryogenics, and hydrogen applications. Westport Fuel Systems Inc. markets its products primarily under the Cummins Westport, BRC, Westport, OMVL, Prins, GFi Control systems, Emer, Zavoli, TA Gas Technology, Valtek, and AFS brands. The company was formerly known as Westport Innovations Inc. and changed its name to Westport Fuel Systems Inc. in June 2016. Westport Fuel Systems Inc. was founded in 1995 and is headquartered in Vancouver, Canada."
WPRT,2017-12-31,50133000,-67284000,NA,-9979000,63216000,60281000,-62894000,-62894000,-14487000,-4424000,229833000,292727000,169552000,-4390000,52881000,-62860000,-9979000,NA,income_statement,Auto Parts,Westport Fuel Systems Inc,"Westport Fuel Systems Inc. engineers, manufactures, and supplies alternative fuel systems and components for use in transportation applications worldwide. It operates through Transportation and Cummins Westport Inc. (CWI) Joint Venture segments. The company offers alternative fuel systems and components, which include a range of alternative fuels, such as liquefied petroleum gas, compressed natural gas, liquefied natural gas, renewable natural gas, and hydrogen; and independent aftermarket, original equipment manufacturers (OEMs) and delayed OEMs, electronics, current and advanced research and development programs, supply chain, and product planning activities. It also provides Westport High Pressure Direct Injection 2.0, a fully integrated system that powers compression ignition engines by natural gas, which reduces greenhouse gas emissions. In addition, the company develops, sells, and markets spark-ignited natural gas or propane engines; and CWI engines for transit, school and shuttle buses, conventional trucks and tractors, refuse collection trucks, and specialty vehicles, such as short-haul port drayage trucks and street sweepers. Its products and services are used for passenger cars; light-, medium-, and heavy-duty trucks; and horsepower, cryogenics, and hydrogen applications. Westport Fuel Systems Inc. markets its products primarily under the Cummins Westport, BRC, Westport, OMVL, Prins, GFi Control systems, Emer, Zavoli, TA Gas Technology, Valtek, and AFS brands. The company was formerly known as Westport Innovations Inc. and changed its name to Westport Fuel Systems Inc. in June 2016. Westport Fuel Systems Inc. was founded in 1995 and is headquartered in Vancouver, Canada."
WPRT,2018-12-31,30619000,-38658000,NA,-31492000,66998000,64224000,-42217000,-42217000,-9133000,2112000,270283000,312500000,206059000,3559000,9278000,-40770000,-31492000,NA,income_statement,Auto Parts,Westport Fuel Systems Inc,"Westport Fuel Systems Inc. engineers, manufactures, and supplies alternative fuel systems and components for use in transportation applications worldwide. It operates through Transportation and Cummins Westport Inc. (CWI) Joint Venture segments. The company offers alternative fuel systems and components, which include a range of alternative fuels, such as liquefied petroleum gas, compressed natural gas, liquefied natural gas, renewable natural gas, and hydrogen; and independent aftermarket, original equipment manufacturers (OEMs) and delayed OEMs, electronics, current and advanced research and development programs, supply chain, and product planning activities. It also provides Westport High Pressure Direct Injection 2.0, a fully integrated system that powers compression ignition engines by natural gas, which reduces greenhouse gas emissions. In addition, the company develops, sells, and markets spark-ignited natural gas or propane engines; and CWI engines for transit, school and shuttle buses, conventional trucks and tractors, refuse collection trucks, and specialty vehicles, such as short-haul port drayage trucks and street sweepers. Its products and services are used for passenger cars; light-, medium-, and heavy-duty trucks; and horsepower, cryogenics, and hydrogen applications. Westport Fuel Systems Inc. markets its products primarily under the Cummins Westport, BRC, Westport, OMVL, Prins, GFi Control systems, Emer, Zavoli, TA Gas Technology, Valtek, and AFS brands. The company was formerly known as Westport Innovations Inc. and changed its name to Westport Fuel Systems Inc. in June 2016. Westport Fuel Systems Inc. was founded in 1995 and is headquartered in Vancouver, Canada."
WPRT,2019-12-31,25172000,2148000,NA,41000,57719000,68252000,-22417000,-22417000,-7265000,1960000,305338000,327755000,237086000,24565000,-147000,188000,41000,NA,income_statement,Auto Parts,Westport Fuel Systems Inc,"Westport Fuel Systems Inc. engineers, manufactures, and supplies alternative fuel systems and components for use in transportation applications worldwide. It operates through Transportation and Cummins Westport Inc. (CWI) Joint Venture segments. The company offers alternative fuel systems and components, which include a range of alternative fuels, such as liquefied petroleum gas, compressed natural gas, liquefied natural gas, renewable natural gas, and hydrogen; and independent aftermarket, original equipment manufacturers (OEMs) and delayed OEMs, electronics, current and advanced research and development programs, supply chain, and product planning activities. It also provides Westport High Pressure Direct Injection 2.0, a fully integrated system that powers compression ignition engines by natural gas, which reduces greenhouse gas emissions. In addition, the company develops, sells, and markets spark-ignited natural gas or propane engines; and CWI engines for transit, school and shuttle buses, conventional trucks and tractors, refuse collection trucks, and specialty vehicles, such as short-haul port drayage trucks and street sweepers. Its products and services are used for passenger cars; light-, medium-, and heavy-duty trucks; and horsepower, cryogenics, and hydrogen applications. Westport Fuel Systems Inc. markets its products primarily under the Cummins Westport, BRC, Westport, OMVL, Prins, GFi Control systems, Emer, Zavoli, TA Gas Technology, Valtek, and AFS brands. The company was formerly known as Westport Innovations Inc. and changed its name to Westport Fuel Systems Inc. in June 2016. Westport Fuel Systems Inc. was founded in 1995 and is headquartered in Vancouver, Canada."
WRAP,2016-12-31,260693,-281227,NA,-281227,20534,0,-281227,-281227,-1304,0,0,281227,0,0,NA,-281227,-281227,NA,income_statement,Scientific & Technical Instruments,"Wrap Technologies, Inc.","Wrap Technologies, Inc., a security technology company, develops security products for law enforcement and security personnel. It develops BolaWrap 100, a hand-held remote restraint device that discharges an eight-foot bola style Kevlar tether to entangle a subject at a range of 10-25 feet. The company was founded in 2016 and is headquartered in Tempe, Arizona."
WRAP,2017-12-31,311335,-833545,NA,-833545,522210,0,-833545,-833545,-1304,0,0,833545,0,0,NA,-833545,-833545,NA,income_statement,Scientific & Technical Instruments,"Wrap Technologies, Inc.","Wrap Technologies, Inc., a security technology company, develops security products for law enforcement and security personnel. It develops BolaWrap 100, a hand-held remote restraint device that discharges an eight-foot bola style Kevlar tether to entangle a subject at a range of 10-25 feet. The company was founded in 2016 and is headquartered in Tempe, Arizona."
WRAP,2018-12-31,734776,-3336435,NA,-3336435,2607397,4539,-3337634,-3337634,-1304,0,23150,3360784,18611,1199,NA,-3336435,-3336435,NA,income_statement,Scientific & Technical Instruments,"Wrap Technologies, Inc.","Wrap Technologies, Inc., a security technology company, develops security products for law enforcement and security personnel. It develops BolaWrap 100, a hand-held remote restraint device that discharges an eight-foot bola style Kevlar tether to entangle a subject at a range of 10-25 feet. The company was founded in 2016 and is headquartered in Tempe, Arizona."
WRAP,2019-12-31,2236985,-8325488,NA,-8325488,6653465,276774,-8613676,-8613676,NA,0,696790,9310466,420016,288188,NA,-8325488,-8325488,NA,income_statement,Scientific & Technical Instruments,"Wrap Technologies, Inc.","Wrap Technologies, Inc., a security technology company, develops security products for law enforcement and security personnel. It develops BolaWrap 100, a hand-held remote restraint device that discharges an eight-foot bola style Kevlar tether to entangle a subject at a range of 10-25 feet. The company was founded in 2016 and is headquartered in Tempe, Arizona."
WRB,2017-12-31,NA,772770000,39819000,549094000,52925000,3356999000,935334000,935334000,-147297000,219433000,7684764000,6749430000,4327765000,-162564000,NA,553337000,549094000,2368740000,income_statement,NA,NA,NA
WRB,2018-12-31,NA,812094000,41947000,640749000,45778000,3352500000,942212000,942212000,-157185000,163028000,7691651000,6749439000,4339151000,-130118000,NA,649066000,640749000,2364510000,income_statement,NA,NA,NA
WRB,2019-12-31,NA,852920000,43403000,681944000,44107000,3368411000,975614000,975614000,-153409000,168935000,7902196000,6926582000,4533785000,-122694000,NA,683985000,681944000,2348690000,income_statement,NA,NA,NA
WRB,2020-12-31,NA,704802000,NA,530670000,NA,3245731000,864142000,864142000,-150537000,171817000,8098925000,7234783000,4853194000,-159340000,NA,532985000,530670000,2381589000,income_statement,NA,NA,NA
WRK,2017-09-30,NA,857600000,48300000,708200000,1405400000,2718200000,1083200000,1083200000,-222500000,159000000,14859700000,13776500000,12141500000,-225600000,NA,698600000,708100000,NA,income_statement,NA,NA,NA
WRK,2018-09-30,NA,1034800000,17200000,1906100000,1451300000,3362000000,1590500000,1590500000,-352800000,-874500000,16285100000,14694600000,12923100000,-555700000,NA,1909300000,1905900000,NA,income_statement,NA,NA,NA
WRK,2019-09-30,NA,1144700000,16200000,862900000,1641000000,3581500000,1527300000,1527300000,-489400000,276800000,18289000000,16761700000,14707500000,-382600000,NA,867900000,862800000,NA,income_statement,NA,NA,NA
WRK,2020-09-30,NA,-522600000,18200000,-690900000,1521100000,3196800000,1275200000,1275200000,-465500000,163500000,17578800000,16303600000,14382000000,-1797800000,NA,-686100000,-691000000,NA,income_statement,NA,NA,NA
WRLD,2017-03-31,NA,105947874,NA,73600294,243783790,371725708,127452082,127452082,-21504208,38157492,490821420,363369338,119095712,-21504208,5809912,67790382,73600294,NA,income_statement,Credit Services,World Acceptance Corporation,"World Acceptance Corporation, together with its subsidiaries, engages in small-loan consumer finance business. The company offers short-term small installment loans, medium-term larger installment loans, related credit insurance, and ancillary products and services to individuals. It also provides automobile club memberships to its borrowers; and income tax return preparation and electronic filing services. In addition, the company markets and sells credit life, credit accident and health, credit property and auto, unemployment, and accidental death and dismemberment insurance in connection with its loans. It serves individuals with limited access to other sources of consumer credit, such as banks, credit unions, other consumer finance businesses, and credit card lenders. As of March 31, 2020, it operates 1,243 branches in Alabama, Georgia, Idaho, Illinois, Indiana, Kentucky, Louisiana, Mississippi, Missouri, New Mexico, Oklahoma, South Carolina, Texas, Tennessee, Utah, and Wisconsin. World Acceptance Corporation was founded in 1962 and is headquartered in Greenville, South Carolina."
WRLD,2018-03-31,NA,96850888,NA,53690018,265617270,385048192,118440523,118440523,-19089635,47757808,502668332,384227809,117620140,-21589635,4596938,49093080,53690018,NA,income_statement,Credit Services,World Acceptance Corporation,"World Acceptance Corporation, together with its subsidiaries, engages in small-loan consumer finance business. The company offers short-term small installment loans, medium-term larger installment loans, related credit insurance, and ancillary products and services to individuals. It also provides automobile club memberships to its borrowers; and income tax return preparation and electronic filing services. In addition, the company markets and sells credit life, credit accident and health, credit property and auto, unemployment, and accidental death and dismemberment insurance in connection with its loans. It serves individuals with limited access to other sources of consumer credit, such as banks, credit unions, other consumer finance businesses, and credit card lenders. As of March 31, 2020, it operates 1,243 branches in Alabama, Georgia, Idaho, Illinois, Indiana, Kentucky, Louisiana, Mississippi, Missouri, New Mexico, Oklahoma, South Carolina, Texas, Tennessee, Utah, and Wisconsin. World Acceptance Corporation was founded in 1962 and is headquartered in Greenville, South Carolina."
WRLD,2019-03-31,NA,89878572,NA,37235134,286776059,396116347,107812632,107812632,-17934060,15981057,544542925,436730293,148426578,-17934060,-36662381,73897515,37235134,NA,income_statement,Credit Services,World Acceptance Corporation,"World Acceptance Corporation, together with its subsidiaries, engages in small-loan consumer finance business. The company offers short-term small installment loans, medium-term larger installment loans, related credit insurance, and ancillary products and services to individuals. It also provides automobile club memberships to its borrowers; and income tax return preparation and electronic filing services. In addition, the company markets and sells credit life, credit accident and health, credit property and auto, unemployment, and accidental death and dismemberment insurance in connection with its loans. It serves individuals with limited access to other sources of consumer credit, such as banks, credit unions, other consumer finance businesses, and credit card lenders. As of March 31, 2020, it operates 1,243 branches in Alabama, Georgia, Idaho, Illinois, Indiana, Kentucky, Louisiana, Mississippi, Missouri, New Mexico, Oklahoma, South Carolina, Texas, Tennessee, Utah, and Wisconsin. World Acceptance Corporation was founded in 1962 and is headquartered in Greenville, South Carolina."
WRLD,2020-03-31,NA,34909443,NA,28157478,342482634,408298833,60805573,60805573,-25896130,6751965,590029015,529223442,181730182,-25896130,NA,28157478,28157478,NA,income_statement,Credit Services,World Acceptance Corporation,"World Acceptance Corporation, together with its subsidiaries, engages in small-loan consumer finance business. The company offers short-term small installment loans, medium-term larger installment loans, related credit insurance, and ancillary products and services to individuals. It also provides automobile club memberships to its borrowers; and income tax return preparation and electronic filing services. In addition, the company markets and sells credit life, credit accident and health, credit property and auto, unemployment, and accidental death and dismemberment insurance in connection with its loans. It serves individuals with limited access to other sources of consumer credit, such as banks, credit unions, other consumer finance businesses, and credit card lenders. As of March 31, 2020, it operates 1,243 branches in Alabama, Georgia, Idaho, Illinois, Indiana, Kentucky, Louisiana, Mississippi, Missouri, New Mexico, Oklahoma, South Carolina, Texas, Tennessee, Utah, and Wisconsin. World Acceptance Corporation was founded in 1962 and is headquartered in Greenville, South Carolina."
WSBC,2017-12-31,NA,148289000,NA,94482000,166141000,369149000,0,157678000,NA,53807000,369149000,211471000,0,-9389000,NA,94482000,94482000,45330000,income_statement,Banks—Regional,"WesBanco, Inc.","WesBanco, Inc. operates as the bank holding company for WesBanco Bank, Inc. that provides retail banking, corporate banking, personal and corporate trust, brokerage, and mortgage banking and insurance services. It operates in two segments, Community Banking, and Trust and Investment Services. The company offers commercial demand, individual demand, and time deposit accounts; money market accounts; interest bearing and non-interest bearing demand deposits, as well as savings deposits; and certificates of deposit. It also provides commercial real estate loans; commercial and industrial loans; residential real estate loans, including loans to purchase, construct, or refinance borrower's home; home equity lines of credit; installment loans to finance the purchase of automobiles, trucks, motorcycles, boats, and other recreational vehicles, as well as home equity installment loans, unsecured home improvement loans, and revolving lines of credit; and commercial, mortgage, and individual installment loans. In addition, the company offers trust and investment services, as well as various investment products comprising mutual funds and annuities; and securities brokerage services. Further, WesBanco, Inc., through its non-banking subsidiaries, acts as an agency that specializes in property, casualty, life, and title insurance, as well as benefit plan sales and administration to personal and commercial clients; provides broker dealer and discount brokerage services; holds investment securities and loans; and holds and leases commercial real estate properties, as well as acts as an investment adviser to a family of mutual funds. As of December 31, 2019, it operated 236 branches and 227 ATMs in West Virginia, Ohio, western Pennsylvania, Kentucky, southern Indiana, and Maryland, as well as six loan production offices in West Virginia, Ohio, western Pennsylvania, and Maryland. WesBanco, Inc. was founded in 1870 and is headquartered in Wheeling, West Virginia."
WSBC,2018-12-31,NA,174524000,NA,143112000,186421000,439748000,0,202606000,NA,31412000,439748000,237142000,0,-28082000,NA,143112000,143112000,50721000,income_statement,Banks—Regional,"WesBanco, Inc.","WesBanco, Inc. operates as the bank holding company for WesBanco Bank, Inc. that provides retail banking, corporate banking, personal and corporate trust, brokerage, and mortgage banking and insurance services. It operates in two segments, Community Banking, and Trust and Investment Services. The company offers commercial demand, individual demand, and time deposit accounts; money market accounts; interest bearing and non-interest bearing demand deposits, as well as savings deposits; and certificates of deposit. It also provides commercial real estate loans; commercial and industrial loans; residential real estate loans, including loans to purchase, construct, or refinance borrower's home; home equity lines of credit; installment loans to finance the purchase of automobiles, trucks, motorcycles, boats, and other recreational vehicles, as well as home equity installment loans, unsecured home improvement loans, and revolving lines of credit; and commercial, mortgage, and individual installment loans. In addition, the company offers trust and investment services, as well as various investment products comprising mutual funds and annuities; and securities brokerage services. Further, WesBanco, Inc., through its non-banking subsidiaries, acts as an agency that specializes in property, casualty, life, and title insurance, as well as benefit plan sales and administration to personal and commercial clients; provides broker dealer and discount brokerage services; holds investment securities and loans; and holds and leases commercial real estate properties, as well as acts as an investment adviser to a family of mutual funds. As of December 31, 2019, it operated 236 branches and 227 ATMs in West Virginia, Ohio, western Pennsylvania, Kentucky, southern Indiana, and Maryland, as well as six loan production offices in West Virginia, Ohio, western Pennsylvania, and Maryland. WesBanco, Inc. was founded in 1870 and is headquartered in Wheeling, West Virginia."
WSBC,2019-12-31,NA,193214000,NA,158873000,220859000,505422000,0,221907000,NA,34341000,505422000,283515000,0,-28693000,NA,158873000,158873000,62656000,income_statement,Banks—Regional,"WesBanco, Inc.","WesBanco, Inc. operates as the bank holding company for WesBanco Bank, Inc. that provides retail banking, corporate banking, personal and corporate trust, brokerage, and mortgage banking and insurance services. It operates in two segments, Community Banking, and Trust and Investment Services. The company offers commercial demand, individual demand, and time deposit accounts; money market accounts; interest bearing and non-interest bearing demand deposits, as well as savings deposits; and certificates of deposit. It also provides commercial real estate loans; commercial and industrial loans; residential real estate loans, including loans to purchase, construct, or refinance borrower's home; home equity lines of credit; installment loans to finance the purchase of automobiles, trucks, motorcycles, boats, and other recreational vehicles, as well as home equity installment loans, unsecured home improvement loans, and revolving lines of credit; and commercial, mortgage, and individual installment loans. In addition, the company offers trust and investment services, as well as various investment products comprising mutual funds and annuities; and securities brokerage services. Further, WesBanco, Inc., through its non-banking subsidiaries, acts as an agency that specializes in property, casualty, life, and title insurance, as well as benefit plan sales and administration to personal and commercial clients; provides broker dealer and discount brokerage services; holds investment securities and loans; and holds and leases commercial real estate properties, as well as acts as an investment adviser to a family of mutual funds. As of December 31, 2019, it operated 236 branches and 227 ATMs in West Virginia, Ohio, western Pennsylvania, Kentucky, southern Indiana, and Maryland, as well as six loan production offices in West Virginia, Ohio, western Pennsylvania, and Maryland. WesBanco, Inc. was founded in 1870 and is headquartered in Wheeling, West Virginia."
WSBC,2020-12-31,NA,145079000,NA,122044000,253227000,499924000,0,175949000,NA,23035000,499924000,323975000,0,-30870000,NA,122044000,119400000,70748000,income_statement,Banks—Regional,"WesBanco, Inc.","WesBanco, Inc. operates as the bank holding company for WesBanco Bank, Inc. that provides retail banking, corporate banking, personal and corporate trust, brokerage, and mortgage banking and insurance services. It operates in two segments, Community Banking, and Trust and Investment Services. The company offers commercial demand, individual demand, and time deposit accounts; money market accounts; interest bearing and non-interest bearing demand deposits, as well as savings deposits; and certificates of deposit. It also provides commercial real estate loans; commercial and industrial loans; residential real estate loans, including loans to purchase, construct, or refinance borrower's home; home equity lines of credit; installment loans to finance the purchase of automobiles, trucks, motorcycles, boats, and other recreational vehicles, as well as home equity installment loans, unsecured home improvement loans, and revolving lines of credit; and commercial, mortgage, and individual installment loans. In addition, the company offers trust and investment services, as well as various investment products comprising mutual funds and annuities; and securities brokerage services. Further, WesBanco, Inc., through its non-banking subsidiaries, acts as an agency that specializes in property, casualty, life, and title insurance, as well as benefit plan sales and administration to personal and commercial clients; provides broker dealer and discount brokerage services; holds investment securities and loans; and holds and leases commercial real estate properties, as well as acts as an investment adviser to a family of mutual funds. As of December 31, 2019, it operated 236 branches and 227 ATMs in West Virginia, Ohio, western Pennsylvania, Kentucky, southern Indiana, and Maryland, as well as six loan production offices in West Virginia, Ohio, western Pennsylvania, and Maryland. WesBanco, Inc. was founded in 1870 and is headquartered in Wheeling, West Virginia."
WSBCP,2017-12-31,NA,148289000,NA,94482000,166141000,369149000,0,157678000,NA,53807000,369149000,211471000,0,-9389000,NA,94482000,94482000,45330000,income_statement,Banks—Regional,"WesBanco, Inc. - Depositary Sha","WesBanco, Inc. operates as the bank holding company for WesBanco Bank, Inc. that provides retail banking, corporate banking, personal and corporate trust, brokerage, and mortgage banking and insurance services. It operates in two segments, Community Banking, and Trust and Investment Services. The company offers commercial demand, individual demand, and time deposit accounts; money market accounts; interest bearing and non-interest bearing demand deposits, as well as savings deposits; and certificates of deposit. It also provides commercial real estate loans; commercial and industrial loans; residential real estate loans, including loans to purchase, construct, or refinance borrower's home; home equity lines of credit; installment loans to finance the purchase of automobiles, trucks, motorcycles, boats, and other recreational vehicles, as well as home equity installment loans, unsecured home improvement loans, and revolving lines of credit; and commercial, mortgage, and individual installment loans. In addition, the company offers trust and investment services, as well as various investment products comprising mutual funds and annuities; and securities brokerage services. Further, WesBanco, Inc., through its non-banking subsidiaries, acts as an agency that specializes in property, casualty, life, and title insurance, as well as benefit plan sales and administration to personal and commercial clients; provides broker dealer and discount brokerage services; holds investment securities and loans; and holds and leases commercial real estate properties, as well as acts as an investment adviser to a family of mutual funds. As of December 31, 2019, it operated 236 branches and 227 ATMs in West Virginia, Ohio, western Pennsylvania, Kentucky, southern Indiana, and Maryland, as well as six loan production offices in West Virginia, Ohio, western Pennsylvania, and Maryland. WesBanco, Inc. was founded in 1870 and is headquartered in Wheeling, West Virginia."
WSBCP,2018-12-31,NA,174524000,NA,143112000,186421000,439748000,0,202606000,NA,31412000,439748000,237142000,0,-28082000,NA,143112000,143112000,50721000,income_statement,Banks—Regional,"WesBanco, Inc. - Depositary Sha","WesBanco, Inc. operates as the bank holding company for WesBanco Bank, Inc. that provides retail banking, corporate banking, personal and corporate trust, brokerage, and mortgage banking and insurance services. It operates in two segments, Community Banking, and Trust and Investment Services. The company offers commercial demand, individual demand, and time deposit accounts; money market accounts; interest bearing and non-interest bearing demand deposits, as well as savings deposits; and certificates of deposit. It also provides commercial real estate loans; commercial and industrial loans; residential real estate loans, including loans to purchase, construct, or refinance borrower's home; home equity lines of credit; installment loans to finance the purchase of automobiles, trucks, motorcycles, boats, and other recreational vehicles, as well as home equity installment loans, unsecured home improvement loans, and revolving lines of credit; and commercial, mortgage, and individual installment loans. In addition, the company offers trust and investment services, as well as various investment products comprising mutual funds and annuities; and securities brokerage services. Further, WesBanco, Inc., through its non-banking subsidiaries, acts as an agency that specializes in property, casualty, life, and title insurance, as well as benefit plan sales and administration to personal and commercial clients; provides broker dealer and discount brokerage services; holds investment securities and loans; and holds and leases commercial real estate properties, as well as acts as an investment adviser to a family of mutual funds. As of December 31, 2019, it operated 236 branches and 227 ATMs in West Virginia, Ohio, western Pennsylvania, Kentucky, southern Indiana, and Maryland, as well as six loan production offices in West Virginia, Ohio, western Pennsylvania, and Maryland. WesBanco, Inc. was founded in 1870 and is headquartered in Wheeling, West Virginia."
WSBCP,2019-12-31,NA,193214000,NA,158873000,220859000,505422000,0,221907000,NA,34341000,505422000,283515000,0,-28693000,NA,158873000,158873000,62656000,income_statement,Banks—Regional,"WesBanco, Inc. - Depositary Sha","WesBanco, Inc. operates as the bank holding company for WesBanco Bank, Inc. that provides retail banking, corporate banking, personal and corporate trust, brokerage, and mortgage banking and insurance services. It operates in two segments, Community Banking, and Trust and Investment Services. The company offers commercial demand, individual demand, and time deposit accounts; money market accounts; interest bearing and non-interest bearing demand deposits, as well as savings deposits; and certificates of deposit. It also provides commercial real estate loans; commercial and industrial loans; residential real estate loans, including loans to purchase, construct, or refinance borrower's home; home equity lines of credit; installment loans to finance the purchase of automobiles, trucks, motorcycles, boats, and other recreational vehicles, as well as home equity installment loans, unsecured home improvement loans, and revolving lines of credit; and commercial, mortgage, and individual installment loans. In addition, the company offers trust and investment services, as well as various investment products comprising mutual funds and annuities; and securities brokerage services. Further, WesBanco, Inc., through its non-banking subsidiaries, acts as an agency that specializes in property, casualty, life, and title insurance, as well as benefit plan sales and administration to personal and commercial clients; provides broker dealer and discount brokerage services; holds investment securities and loans; and holds and leases commercial real estate properties, as well as acts as an investment adviser to a family of mutual funds. As of December 31, 2019, it operated 236 branches and 227 ATMs in West Virginia, Ohio, western Pennsylvania, Kentucky, southern Indiana, and Maryland, as well as six loan production offices in West Virginia, Ohio, western Pennsylvania, and Maryland. WesBanco, Inc. was founded in 1870 and is headquartered in Wheeling, West Virginia."
WSBCP,2020-12-31,NA,145079000,NA,122044000,253227000,499924000,0,175949000,NA,23035000,499924000,323975000,0,-30870000,NA,122044000,119400000,70748000,income_statement,Banks—Regional,"WesBanco, Inc. - Depositary Sha","WesBanco, Inc. operates as the bank holding company for WesBanco Bank, Inc. that provides retail banking, corporate banking, personal and corporate trust, brokerage, and mortgage banking and insurance services. It operates in two segments, Community Banking, and Trust and Investment Services. The company offers commercial demand, individual demand, and time deposit accounts; money market accounts; interest bearing and non-interest bearing demand deposits, as well as savings deposits; and certificates of deposit. It also provides commercial real estate loans; commercial and industrial loans; residential real estate loans, including loans to purchase, construct, or refinance borrower's home; home equity lines of credit; installment loans to finance the purchase of automobiles, trucks, motorcycles, boats, and other recreational vehicles, as well as home equity installment loans, unsecured home improvement loans, and revolving lines of credit; and commercial, mortgage, and individual installment loans. In addition, the company offers trust and investment services, as well as various investment products comprising mutual funds and annuities; and securities brokerage services. Further, WesBanco, Inc., through its non-banking subsidiaries, acts as an agency that specializes in property, casualty, life, and title insurance, as well as benefit plan sales and administration to personal and commercial clients; provides broker dealer and discount brokerage services; holds investment securities and loans; and holds and leases commercial real estate properties, as well as acts as an investment adviser to a family of mutual funds. As of December 31, 2019, it operated 236 branches and 227 ATMs in West Virginia, Ohio, western Pennsylvania, Kentucky, southern Indiana, and Maryland, as well as six loan production offices in West Virginia, Ohio, western Pennsylvania, and Maryland. WesBanco, Inc. was founded in 1870 and is headquartered in Wheeling, West Virginia."
WSBF,2017-12-31,NA,44433000,NA,25964000,117250000,176312000,0,44812000,NA,18469000,176312000,131500000,0,-379000,NA,25964000,25964000,14250000,income_statement,Banks—Regional,"Waterstone Financial, Inc.","Waterstone Financial, Inc. operates as a bank holding company for WaterStone Bank SSB that provides various financial services to customers in southeastern Wisconsin, the United States. It operates through two segments, Community Banking and Mortgage Banking. The Community Banking segment offers consumer and business banking products and services, such as deposit and transactional solutions, including checking accounts, online banking and bill pay services, and money transfer services, as well as credit, debit, and pre-paid cards; investable funds solutions comprising savings, money market deposit, and individual retirement accounts, as well as certificates of deposit; lending solutions consisting of residential mortgages, home equity loans and lines of credit, personal and installment loans, real estate financing, business loans, and business lines of credit; and fixed and variable annuities, and insurance products, as well as trust and investment management accounts. The Mortgage Banking segment provides residential mortgage loans for the purpose of sale in the secondary market. The company also provides transaction deposit, demand deposit, and non-interest bearing demand accounts, as well as time deposits; construction and land loans; and term loans for working capital, inventory, and general corporate use. Further, it invests in a portfolio of securities, which include mortgage-backed securities, government-sponsored enterprise bonds, municipal obligations, and other debt securities. Waterstone Financial, Inc. operates 13 full-service banking offices, 1 drive-through office, and 13 automated teller machines located in Milwaukee, Washington, and Waukesha Counties, Wisconsin, as well as a loan production office in Minneapolis, Minnesota. The company was formerly known as Wauwatosa Holdings, Inc. and changed its name to Waterstone Financial, Inc. in August 2008. Waterstone Financial, Inc. was founded in 1921 and is based in Wauwatosa, Wisconsin."
WSBF,2018-12-31,NA,40280000,NA,30754000,119492000,173436000,0,40281000,NA,9526000,173436000,133155000,0,-1000,NA,30754000,30754000,13663000,income_statement,Banks—Regional,"Waterstone Financial, Inc.","Waterstone Financial, Inc. operates as a bank holding company for WaterStone Bank SSB that provides various financial services to customers in southeastern Wisconsin, the United States. It operates through two segments, Community Banking and Mortgage Banking. The Community Banking segment offers consumer and business banking products and services, such as deposit and transactional solutions, including checking accounts, online banking and bill pay services, and money transfer services, as well as credit, debit, and pre-paid cards; investable funds solutions comprising savings, money market deposit, and individual retirement accounts, as well as certificates of deposit; lending solutions consisting of residential mortgages, home equity loans and lines of credit, personal and installment loans, real estate financing, business loans, and business lines of credit; and fixed and variable annuities, and insurance products, as well as trust and investment management accounts. The Mortgage Banking segment provides residential mortgage loans for the purpose of sale in the secondary market. The company also provides transaction deposit, demand deposit, and non-interest bearing demand accounts, as well as time deposits; construction and land loans; and term loans for working capital, inventory, and general corporate use. Further, it invests in a portfolio of securities, which include mortgage-backed securities, government-sponsored enterprise bonds, municipal obligations, and other debt securities. Waterstone Financial, Inc. operates 13 full-service banking offices, 1 drive-through office, and 13 automated teller machines located in Milwaukee, Washington, and Waukesha Counties, Wisconsin, as well as a loan production office in Minneapolis, Minnesota. The company was formerly known as Wauwatosa Holdings, Inc. and changed its name to Waterstone Financial, Inc. in August 2008. Waterstone Financial, Inc. was founded in 1921 and is based in Wauwatosa, Wisconsin."
WSBF,2019-12-31,NA,47574000,NA,35903000,124803000,183847000,0,47428000,NA,11671000,183847000,136419000,0,146000,NA,35903000,35903000,11616000,income_statement,Banks—Regional,"Waterstone Financial, Inc.","Waterstone Financial, Inc. operates as a bank holding company for WaterStone Bank SSB that provides various financial services to customers in southeastern Wisconsin, the United States. It operates through two segments, Community Banking and Mortgage Banking. The Community Banking segment offers consumer and business banking products and services, such as deposit and transactional solutions, including checking accounts, online banking and bill pay services, and money transfer services, as well as credit, debit, and pre-paid cards; investable funds solutions comprising savings, money market deposit, and individual retirement accounts, as well as certificates of deposit; lending solutions consisting of residential mortgages, home equity loans and lines of credit, personal and installment loans, real estate financing, business loans, and business lines of credit; and fixed and variable annuities, and insurance products, as well as trust and investment management accounts. The Mortgage Banking segment provides residential mortgage loans for the purpose of sale in the secondary market. The company also provides transaction deposit, demand deposit, and non-interest bearing demand accounts, as well as time deposits; construction and land loans; and term loans for working capital, inventory, and general corporate use. Further, it invests in a portfolio of securities, which include mortgage-backed securities, government-sponsored enterprise bonds, municipal obligations, and other debt securities. Waterstone Financial, Inc. operates 13 full-service banking offices, 1 drive-through office, and 13 automated teller machines located in Milwaukee, Washington, and Waukesha Counties, Wisconsin, as well as a loan production office in Minneapolis, Minnesota. The company was formerly known as Wauwatosa Holdings, Inc. and changed its name to Waterstone Financial, Inc. in August 2008. Waterstone Financial, Inc. was founded in 1921 and is based in Wauwatosa, Wisconsin."
WSBF,2020-12-31,NA,108116000,NA,81145000,166348000,291177000,0,108108000,NA,26971000,291177000,183069000,0,8000,NA,81145000,81145000,16721000,income_statement,Banks—Regional,"Waterstone Financial, Inc.","Waterstone Financial, Inc. operates as a bank holding company for WaterStone Bank SSB that provides various financial services to customers in southeastern Wisconsin, the United States. It operates through two segments, Community Banking and Mortgage Banking. The Community Banking segment offers consumer and business banking products and services, such as deposit and transactional solutions, including checking accounts, online banking and bill pay services, and money transfer services, as well as credit, debit, and pre-paid cards; investable funds solutions comprising savings, money market deposit, and individual retirement accounts, as well as certificates of deposit; lending solutions consisting of residential mortgages, home equity loans and lines of credit, personal and installment loans, real estate financing, business loans, and business lines of credit; and fixed and variable annuities, and insurance products, as well as trust and investment management accounts. The Mortgage Banking segment provides residential mortgage loans for the purpose of sale in the secondary market. The company also provides transaction deposit, demand deposit, and non-interest bearing demand accounts, as well as time deposits; construction and land loans; and term loans for working capital, inventory, and general corporate use. Further, it invests in a portfolio of securities, which include mortgage-backed securities, government-sponsored enterprise bonds, municipal obligations, and other debt securities. Waterstone Financial, Inc. operates 13 full-service banking offices, 1 drive-through office, and 13 automated teller machines located in Milwaukee, Washington, and Waukesha Counties, Wisconsin, as well as a loan production office in Minneapolis, Minnesota. The company was formerly known as Wauwatosa Holdings, Inc. and changed its name to Waterstone Financial, Inc. in August 2008. Waterstone Financial, Inc. was founded in 1921 and is based in Wauwatosa, Wisconsin."
WSC,2016-12-31,NA,-87633000,48931000,-30936000,130674000,168193000,26669000,26669000,-94671000,-24502000,426612000,399943000,258419000,-114302000,32195000,-63131000,-30936000,1831000,income_statement,Rental & Leasing Services,WillScot Mobile Mini Holdings C,"WillScot Mobile Mini Holdings Corp. provides modular space and portable storage solutions in the United States, Canada, Mexico, and the United Kingdom. The company leases various office space and storage solutions for temporary applications across a customer base in the commercial and industrial, construction, retail, education, health care, government, transportation, security, and energy sectors. . It operates a fleet of over 350,000 portable offices and storage containers. The company is headquartered in Phoenix, Arizona."
WSC,2017-12-31,NA,-165398000,48931000,-147702000,138470000,165570000,6310000,6310000,-119308000,-936000,445942000,439632000,280372000,-171708000,14650000,-164462000,-147702000,12137000,income_statement,Rental & Leasing Services,WillScot Mobile Mini Holdings C,"WillScot Mobile Mini Holdings Corp. provides modular space and portable storage solutions in the United States, Canada, Mexico, and the United Kingdom. The company leases various office space and storage solutions for temporary applications across a customer base in the commercial and industrial, construction, retail, education, health care, government, transportation, security, and energy sectors. . It operates a fleet of over 350,000 portable offices and storage containers. The company is headquartered in Phoenix, Arizona."
WSC,2018-12-31,NA,-92172000,63982000,-49040000,204814000,289384000,58162000,58162000,-98433000,-38600000,751412000,693250000,462028000,-150334000,NA,-53572000,-51175000,13104000,income_statement,Rental & Leasing Services,WillScot Mobile Mini Holdings C,"WillScot Mobile Mini Holdings Corp. provides modular space and portable storage solutions in the United States, Canada, Mexico, and the United Kingdom. The company leases various office space and storage solutions for temporary applications across a customer base in the commercial and industrial, construction, retail, education, health care, government, transportation, security, and energy sectors. . It operates a fleet of over 350,000 portable offices and storage containers. The company is headquartered in Phoenix, Arizona."
WSC,2019-12-31,NA,-13734000,64590000,-11122000,244397000,413313000,144661000,144661000,-122504000,-2191000,1063665000,919004000,650352000,-158395000,NA,-11543000,-11122000,11860000,income_statement,Rental & Leasing Services,WillScot Mobile Mini Holdings C,"WillScot Mobile Mini Holdings Corp. provides modular space and portable storage solutions in the United States, Canada, Mexico, and the United Kingdom. The company leases various office space and storage solutions for temporary applications across a customer base in the commercial and industrial, construction, retail, education, health care, government, transportation, security, and energy sectors. . It operates a fleet of over 350,000 portable offices and storage containers. The company is headquartered in Phoenix, Arizona."
WSFS,2017-12-31,NA,108490000,-815000,50244000,164808000,334951000,0,128943000,NA,58246000,334951000,206008000,0,-20453000,NA,50244000,50244000,41200000,income_statement,Banks—Regional,WSFS Financial Corporation,"WSFS Financial Corporation operates as the savings and loan holding company for the Wilmington Savings Fund Society, FSB that provides various banking services in the United States. It operates through three segments: WSFS Bank, Cash Connect, and Wealth Management. The company offers various deposit products, including savings accounts, demand deposits, interest-bearing demand deposits, money market deposit accounts, and certificates of deposit, as well as jumbo certificates of deposit. It also provides a range of loans, which comprise residential real estate loans; commercial real estate mortgage loans; commercial construction loans to developers; commercial loans for working capital, financing equipment and real estate acquisitions, business expansion, and other business purposes; and consumer credit products, such as home improvement, automobile, and other secured and unsecured personal installment loans, as well as home equity lines and unsecured lines of credit. In addition, the company offers cash management, trust, and wealth management services. Further, it markets various third-party investment and insurance products, such as single-premium annuities, whole life policies, and securities; provides investment advisory services to high net worth individuals and institutions; and offers mortgage and title services. Additionally, the company provides ATM vault cash, smart safe, and other cash logistics services; and online reporting and ATM cash management, predictive cash ordering and reconcilement services, armored carrier management, loss protection, ATM processing equipment sales, and deposit safe cash logistics services. As of December 31, 2019, it operated 118 offices, including 45 in Delaware, 55 in Pennsylvania, 16 in New Jersey, 1 in Virginia, and 1 in Nevada. The company was founded in 1832 and is headquartered in Wilmington, Delaware."
WSFS,2018-12-31,NA,170798000,-815000,134743000,176451000,395845000,0,171306000,NA,36055000,395845000,224539000,0,-508000,NA,134743000,134743000,48088000,income_statement,Banks—Regional,WSFS Financial Corporation,"WSFS Financial Corporation operates as the savings and loan holding company for the Wilmington Savings Fund Society, FSB that provides various banking services in the United States. It operates through three segments: WSFS Bank, Cash Connect, and Wealth Management. The company offers various deposit products, including savings accounts, demand deposits, interest-bearing demand deposits, money market deposit accounts, and certificates of deposit, as well as jumbo certificates of deposit. It also provides a range of loans, which comprise residential real estate loans; commercial real estate mortgage loans; commercial construction loans to developers; commercial loans for working capital, financing equipment and real estate acquisitions, business expansion, and other business purposes; and consumer credit products, such as home improvement, automobile, and other secured and unsecured personal installment loans, as well as home equity lines and unsecured lines of credit. In addition, the company offers cash management, trust, and wealth management services. Further, it markets various third-party investment and insurance products, such as single-premium annuities, whole life policies, and securities; provides investment advisory services to high net worth individuals and institutions; and offers mortgage and title services. Additionally, the company provides ATM vault cash, smart safe, and other cash logistics services; and online reporting and ATM cash management, predictive cash ordering and reconcilement services, armored carrier management, loss protection, ATM processing equipment sales, and deposit safe cash logistics services. As of December 31, 2019, it operated 118 offices, including 45 in Delaware, 55 in Pennsylvania, 16 in New Jersey, 1 in Virginia, and 1 in Nevada. The company was founded in 1832 and is headquartered in Wilmington, Delaware."
WSFS,2019-12-31,NA,194370000,-815000,148809000,267765000,607497000,0,269940000,NA,46452000,607497000,337557000,0,-75570000,NA,147918000,148809000,69792000,income_statement,Banks—Regional,WSFS Financial Corporation,"WSFS Financial Corporation operates as the savings and loan holding company for the Wilmington Savings Fund Society, FSB that provides various banking services in the United States. It operates through three segments: WSFS Bank, Cash Connect, and Wealth Management. The company offers various deposit products, including savings accounts, demand deposits, interest-bearing demand deposits, money market deposit accounts, and certificates of deposit, as well as jumbo certificates of deposit. It also provides a range of loans, which comprise residential real estate loans; commercial real estate mortgage loans; commercial construction loans to developers; commercial loans for working capital, financing equipment and real estate acquisitions, business expansion, and other business purposes; and consumer credit products, such as home improvement, automobile, and other secured and unsecured personal installment loans, as well as home equity lines and unsecured lines of credit. In addition, the company offers cash management, trust, and wealth management services. Further, it markets various third-party investment and insurance products, such as single-premium annuities, whole life policies, and securities; provides investment advisory services to high net worth individuals and institutions; and offers mortgage and title services. Additionally, the company provides ATM vault cash, smart safe, and other cash logistics services; and online reporting and ATM cash management, predictive cash ordering and reconcilement services, armored carrier management, loss protection, ATM processing equipment sales, and deposit safe cash logistics services. As of December 31, 2019, it operated 118 offices, including 45 in Delaware, 55 in Pennsylvania, 16 in New Jersey, 1 in Virginia, and 1 in Nevada. The company was founded in 1832 and is headquartered in Wilmington, Delaware."
WSFS,2020-12-31,NA,144956000,-2246000,114774000,291577000,513800000,0,156793000,NA,31636000,513800000,357007000,0,-11837000,NA,113320000,114774000,65430000,income_statement,Banks—Regional,WSFS Financial Corporation,"WSFS Financial Corporation operates as the savings and loan holding company for the Wilmington Savings Fund Society, FSB that provides various banking services in the United States. It operates through three segments: WSFS Bank, Cash Connect, and Wealth Management. The company offers various deposit products, including savings accounts, demand deposits, interest-bearing demand deposits, money market deposit accounts, and certificates of deposit, as well as jumbo certificates of deposit. It also provides a range of loans, which comprise residential real estate loans; commercial real estate mortgage loans; commercial construction loans to developers; commercial loans for working capital, financing equipment and real estate acquisitions, business expansion, and other business purposes; and consumer credit products, such as home improvement, automobile, and other secured and unsecured personal installment loans, as well as home equity lines and unsecured lines of credit. In addition, the company offers cash management, trust, and wealth management services. Further, it markets various third-party investment and insurance products, such as single-premium annuities, whole life policies, and securities; provides investment advisory services to high net worth individuals and institutions; and offers mortgage and title services. Additionally, the company provides ATM vault cash, smart safe, and other cash logistics services; and online reporting and ATM cash management, predictive cash ordering and reconcilement services, armored carrier management, loss protection, ATM processing equipment sales, and deposit safe cash logistics services. As of December 31, 2019, it operated 118 offices, including 45 in Delaware, 55 in Pennsylvania, 16 in New Jersey, 1 in Virginia, and 1 in Nevada. The company was founded in 1832 and is headquartered in Wilmington, Delaware."
WST,2016-12-31,36800000,198000000,NA,143600000,238000000,501400000,228900000,228900000,-8100000,54400000,1509100000,1280200000,1007700000,-30900000,NA,143600000,143600000,-2300000,income_statement,NA,NA,NA
WST,2017-12-31,39100000,231600000,NA,150700000,242900000,512900000,239200000,239200000,-7800000,80900000,1599100000,1359900000,1086200000,-7600000,NA,150700000,150700000,-8300000,income_statement,NA,NA,NA
WST,2018-12-31,40300000,248300000,NA,206900000,256200000,545400000,248000000,248000000,-8400000,41400000,1717400000,1469400000,1172000000,300000,NA,206900000,206900000,900000,income_statement,NA,NA,NA
WST,2019-12-31,38900000,300700000,NA,241700000,272800000,605700000,292300000,292300000,-8500000,59000000,1839900000,1547600000,1234200000,8400000,NA,241700000,241700000,1700000,income_statement,NA,NA,NA
WSTG,2016-12-31,NA,8933000,NA,5901000,18715000,27331000,8616000,8616000,-100000,3032000,164609000,155993000,137278000,317000,NA,5901000,5650000,NA,income_statement,Electronics & Computer Distribution,"Wayside Technology Group, Inc.","Wayside Technology Group, Inc. operates as an information technology channel company worldwide. It operates in two segments, Lifeboat Distribution and TechXtend. The company distributes technical software and hardware to corporate and value added resellers, consultants, and systems integrators; and software, hardware, and services for corporations, government organizations, and academic institutions. It also resells computer software and hardware developed by others, as well as provides technical services to end user customers in the United States and Canada. In addition, the company offers a line of products from various software vendors; and tools for virtualization/cloud computing, security, networking, storage and infrastructure management, application lifecycle management, and other technically sophisticated domains, as well as computer hardware. Wayside Technology Group, Inc. markets its products through its own web sites, local and on-line seminars, events, webinars, and social media, as well as direct email and printed materials. The company was formerly known as Programmer's Paradise, Inc. and changed its name to Wayside Technology Group, Inc. in August 2006. Wayside Technology Group, Inc. was incorporated in 1982 and is headquartered in Eatontown, New Jersey."
WSTG,2017-12-31,NA,8553000,NA,5062000,19263000,27076000,7813000,7813000,-100000,3491000,160567000,152754000,133491000,740000,NA,5062000,4840000,NA,income_statement,Electronics & Computer Distribution,"Wayside Technology Group, Inc.","Wayside Technology Group, Inc. operates as an information technology channel company worldwide. It operates in two segments, Lifeboat Distribution and TechXtend. The company distributes technical software and hardware to corporate and value added resellers, consultants, and systems integrators; and software, hardware, and services for corporations, government organizations, and academic institutions. It also resells computer software and hardware developed by others, as well as provides technical services to end user customers in the United States and Canada. In addition, the company offers a line of products from various software vendors; and tools for virtualization/cloud computing, security, networking, storage and infrastructure management, application lifecycle management, and other technically sophisticated domains, as well as computer hardware. Wayside Technology Group, Inc. markets its products through its own web sites, local and on-line seminars, events, webinars, and social media, as well as direct email and printed materials. The company was formerly known as Programmer's Paradise, Inc. and changed its name to Wayside Technology Group, Inc. in August 2006. Wayside Technology Group, Inc. was incorporated in 1982 and is headquartered in Eatontown, New Jersey."
WSTG,2018-12-31,NA,5117000,NA,3538000,20319000,26920000,6601000,6601000,-37000,1579000,181444000,174843000,154524000,-1484000,NA,3538000,3420000,NA,income_statement,Electronics & Computer Distribution,"Wayside Technology Group, Inc.","Wayside Technology Group, Inc. operates as an information technology channel company worldwide. It operates in two segments, Lifeboat Distribution and TechXtend. The company distributes technical software and hardware to corporate and value added resellers, consultants, and systems integrators; and software, hardware, and services for corporations, government organizations, and academic institutions. It also resells computer software and hardware developed by others, as well as provides technical services to end user customers in the United States and Canada. In addition, the company offers a line of products from various software vendors; and tools for virtualization/cloud computing, security, networking, storage and infrastructure management, application lifecycle management, and other technically sophisticated domains, as well as computer hardware. Wayside Technology Group, Inc. markets its products through its own web sites, local and on-line seminars, events, webinars, and social media, as well as direct email and printed materials. The company was formerly known as Programmer's Paradise, Inc. and changed its name to Wayside Technology Group, Inc. in August 2006. Wayside Technology Group, Inc. was incorporated in 1982 and is headquartered in Eatontown, New Jersey."
WSTG,2019-12-31,NA,9048000,NA,6787000,21401000,29967000,8566000,8566000,-58000,2261000,208759000,200193000,178792000,482000,NA,6787000,6657000,NA,income_statement,Electronics & Computer Distribution,"Wayside Technology Group, Inc.","Wayside Technology Group, Inc. operates as an information technology channel company worldwide. It operates in two segments, Lifeboat Distribution and TechXtend. The company distributes technical software and hardware to corporate and value added resellers, consultants, and systems integrators; and software, hardware, and services for corporations, government organizations, and academic institutions. It also resells computer software and hardware developed by others, as well as provides technical services to end user customers in the United States and Canada. In addition, the company offers a line of products from various software vendors; and tools for virtualization/cloud computing, security, networking, storage and infrastructure management, application lifecycle management, and other technically sophisticated domains, as well as computer hardware. Wayside Technology Group, Inc. markets its products through its own web sites, local and on-line seminars, events, webinars, and social media, as well as direct email and printed materials. The company was formerly known as Programmer's Paradise, Inc. and changed its name to Wayside Technology Group, Inc. in August 2006. Wayside Technology Group, Inc. was incorporated in 1982 and is headquartered in Eatontown, New Jersey."
WTBA,2017-12-31,NA,36438000,NA,23070000,26741000,68705000,0,37115000,NA,13368000,68705000,31590000,0,-677000,NA,23070000,23070000,4849000,income_statement,Banks—Regional,West Bancorporation,"West Bancorporation, Inc. operates as the financial holding company for West Bank that provides community banking and trust services to individuals and small- to medium-sized businesses in the United States. It accepts various deposit products, including checking, savings, and money market accounts, as well as time certificates of deposit. The company also provides loan products comprising commercial real estate loans, construction and land development loans, commercial lines of credit, and commercial term loans; consumer loans, including loans extended to individuals for household, family, and other personal expenditures not secured by real estate; and 1-4 family residential mortgages and home equity loans. In addition, it offers trust services, including the administration of estates, conservatorships, personal trusts, and agency accounts. Further, the company provides internet and mobile banking services; treasury management services comprising cash management, client-generated automated clearing house transaction, remote deposit, and fraud protection services; and merchant credit card processing services and corporate credit cards. It has eight offices in the Des Moines area; one office in Coralville; and one office in Rochester, Minnesota. West Bancorporation, Inc. was founded in 1893 and is headquartered in West Des Moines, Iowa."
WTBA,2018-12-31,NA,35068000,NA,28508000,29342000,70060000,0,36086000,NA,6560000,70060000,33974000,0,-1018000,NA,28508000,28508000,4632000,income_statement,Banks—Regional,West Bancorporation,"West Bancorporation, Inc. operates as the financial holding company for West Bank that provides community banking and trust services to individuals and small- to medium-sized businesses in the United States. It accepts various deposit products, including checking, savings, and money market accounts, as well as time certificates of deposit. The company also provides loan products comprising commercial real estate loans, construction and land development loans, commercial lines of credit, and commercial term loans; consumer loans, including loans extended to individuals for household, family, and other personal expenditures not secured by real estate; and 1-4 family residential mortgages and home equity loans. In addition, it offers trust services, including the administration of estates, conservatorships, personal trusts, and agency accounts. Further, the company provides internet and mobile banking services; treasury management services comprising cash management, client-generated automated clearing house transaction, remote deposit, and fraud protection services; and merchant credit card processing services and corporate credit cards. It has eight offices in the Des Moines area; one office in Coralville; and one office in Rochester, Minnesota. West Bancorporation, Inc. was founded in 1893 and is headquartered in West Des Moines, Iowa."
WTBA,2019-12-31,NA,35742000,NA,28690000,32824000,74148000,0,36146000,NA,7052000,74148000,38002000,0,-404000,NA,28690000,28690000,5178000,income_statement,Banks—Regional,West Bancorporation,"West Bancorporation, Inc. operates as the financial holding company for West Bank that provides community banking and trust services to individuals and small- to medium-sized businesses in the United States. It accepts various deposit products, including checking, savings, and money market accounts, as well as time certificates of deposit. The company also provides loan products comprising commercial real estate loans, construction and land development loans, commercial lines of credit, and commercial term loans; consumer loans, including loans extended to individuals for household, family, and other personal expenditures not secured by real estate; and 1-4 family residential mortgages and home equity loans. In addition, it offers trust services, including the administration of estates, conservatorships, personal trusts, and agency accounts. Further, the company provides internet and mobile banking services; treasury management services comprising cash management, client-generated automated clearing house transaction, remote deposit, and fraud protection services; and merchant credit card processing services and corporate credit cards. It has eight offices in the Des Moines area; one office in Coralville; and one office in Rochester, Minnesota. West Bancorporation, Inc. was founded in 1893 and is headquartered in West Des Moines, Iowa."
WTBA,2020-12-31,NA,41381000,NA,32712000,29566000,80435000,0,42591000,NA,8669000,80435000,37844000,0,-1210000,NA,32712000,32712000,8278000,income_statement,Banks—Regional,West Bancorporation,"West Bancorporation, Inc. operates as the financial holding company for West Bank that provides community banking and trust services to individuals and small- to medium-sized businesses in the United States. It accepts various deposit products, including checking, savings, and money market accounts, as well as time certificates of deposit. The company also provides loan products comprising commercial real estate loans, construction and land development loans, commercial lines of credit, and commercial term loans; consumer loans, including loans extended to individuals for household, family, and other personal expenditures not secured by real estate; and 1-4 family residential mortgages and home equity loans. In addition, it offers trust services, including the administration of estates, conservatorships, personal trusts, and agency accounts. Further, the company provides internet and mobile banking services; treasury management services comprising cash management, client-generated automated clearing house transaction, remote deposit, and fraud protection services; and merchant credit card processing services and corporate credit cards. It has eight offices in the Des Moines area; one office in Coralville; and one office in Rochester, Minnesota. West Bancorporation, Inc. was founded in 1893 and is headquartered in West Des Moines, Iowa."
WTER,2017-03-31,NA,-3454600,NA,-3454600,7592673,5413236,-2538993,-2538993,-923446,0,12763630,15302623,7350394,-915607,NA,-3454600,-3454600,NA,income_statement,Beverages—Non-Alcoholic,The Alkaline Water Company Inc.,"The Alkaline Water Company Inc. produces, distributes, and markets bottled alkaline water in the United States. It also provides flavored bottled alkaline water in various flavors, including raspberry, watermelon, lemon, lemon lime, peach mango, blood orange, and cucumber mint. The company offers bottled alkaline water in various volumes under the Alkaline88 brand. In addition, it engages in selling of hemp-derived CBD topical and ingestible products under the A88CBD brand. It sells its products through brokers and distributors to retailers, such as convenience stores, natural food products stores, large ethnic markets, and national retailers, as well as e-commerce websites. The company was founded in 2012 and is based in Scottsdale, Arizona."
WTER,2018-03-31,NA,-6687280,NA,-6687280,13636468,8125182,-5930063,-5930063,-760336,0,19812199,25742262,11687017,-757217,NA,-6687280,-6687280,NA,income_statement,Beverages—Non-Alcoholic,The Alkaline Water Company Inc.,"The Alkaline Water Company Inc. produces, distributes, and markets bottled alkaline water in the United States. It also provides flavored bottled alkaline water in various flavors, including raspberry, watermelon, lemon, lemon lime, peach mango, blood orange, and cucumber mint. The company offers bottled alkaline water in various volumes under the Alkaline88 brand. In addition, it engages in selling of hemp-derived CBD topical and ingestible products under the A88CBD brand. It sells its products through brokers and distributors to retailers, such as convenience stores, natural food products stores, large ethnic markets, and national retailers, as well as e-commerce websites. The company was founded in 2012 and is based in Scottsdale, Arizona."
WTER,2019-03-31,NA,-8617565,NA,-8617565,20429462,12946760,-8063371,-8063371,-554482,0,32199528,40262899,19252768,-554194,NA,-8617565,-8617565,NA,income_statement,Beverages—Non-Alcoholic,The Alkaline Water Company Inc.,"The Alkaline Water Company Inc. produces, distributes, and markets bottled alkaline water in the United States. It also provides flavored bottled alkaline water in various flavors, including raspberry, watermelon, lemon, lemon lime, peach mango, blood orange, and cucumber mint. The company offers bottled alkaline water in various volumes under the Alkaline88 brand. In addition, it engages in selling of hemp-derived CBD topical and ingestible products under the A88CBD brand. It sells its products through brokers and distributors to retailers, such as convenience stores, natural food products stores, large ethnic markets, and national retailers, as well as e-commerce websites. The company was founded in 2012 and is based in Scottsdale, Arizona."
WTER,2020-03-31,NA,-14826821,NA,-14826821,30206391,16839569,-14378063,-14378063,-448758,0,41142443,55520506,24302874,-448758,NA,-14826821,-14826821,NA,income_statement,Beverages—Non-Alcoholic,The Alkaline Water Company Inc.,"The Alkaline Water Company Inc. produces, distributes, and markets bottled alkaline water in the United States. It also provides flavored bottled alkaline water in various flavors, including raspberry, watermelon, lemon, lemon lime, peach mango, blood orange, and cucumber mint. The company offers bottled alkaline water in various volumes under the Alkaline88 brand. In addition, it engages in selling of hemp-derived CBD topical and ingestible products under the A88CBD brand. It sells its products through brokers and distributors to retailers, such as convenience stores, natural food products stores, large ethnic markets, and national retailers, as well as e-commerce websites. The company was founded in 2012 and is based in Scottsdale, Arizona."
WTFC,2017-12-31,NA,389997000,NA,257682000,635623000,1120586000,0,412994000,NA,132315000,1120586000,707592000,0,-22997000,NA,257682000,247904000,71969000,income_statement,Banks—Regional,Wintrust Financial Corporation,"Wintrust Financial Corporation operates as a financial holding company in the Chicago metropolitan area, southern Wisconsin, and northwest Indiana. It operates in three segments: Community Banking, Specialty Finance, and Wealth Management. The Community Banking segment offers non-interest bearing deposits, non-brokered interest-bearing transaction accounts, and savings and domestic time deposits; home equity, consumer, and real estate loans; safe deposit facilities; and automatic teller machine (ATM), online and mobile banking, and other services. It also engages in the origination and purchase of residential mortgages for sale into the secondary market; and provision of lending, deposits, and cash management services to condominium, homeowner, and community associations, as well as asset-based lending for middle-market companies. In addition, this segment offers loan and deposit services to mortgage brokerage companies; lending to restaurant franchisees; direct leasing; small business administration loans; commercial mortgages and construction loans; and financial solutions. It provides personal and commercial banking services primarily to individuals, small to mid-sized businesses, local governmental units, and institutional customers. The Specialty Finance segment offers commercial and life insurance premiums financing for businesses and individuals; accounts receivable financing, value-added, and out-sourced administrative services; and other specialty finance services, as well as data processing of payrolls, billing, and cash management services to temporary staffing industry. The Wealth Management segment provides trust and investment, asset management, tax-deferred exchange, securities brokerage, and retirement plan services. As of December 31, 2019, the company had approximately 187 banking facilities and 230 ATMs. Wintrust Financial Corporation was founded in 1991 and is headquartered in Rosemont, Illinois."
WTFC,2018-12-31,NA,460133000,NA,343166000,718618000,1285620000,0,487432000,NA,116967000,1285620000,798188000,0,-27299000,NA,343166000,334966000,79570000,income_statement,Banks—Regional,Wintrust Financial Corporation,"Wintrust Financial Corporation operates as a financial holding company in the Chicago metropolitan area, southern Wisconsin, and northwest Indiana. It operates in three segments: Community Banking, Specialty Finance, and Wealth Management. The Community Banking segment offers non-interest bearing deposits, non-brokered interest-bearing transaction accounts, and savings and domestic time deposits; home equity, consumer, and real estate loans; safe deposit facilities; and automatic teller machine (ATM), online and mobile banking, and other services. It also engages in the origination and purchase of residential mortgages for sale into the secondary market; and provision of lending, deposits, and cash management services to condominium, homeowner, and community associations, as well as asset-based lending for middle-market companies. In addition, this segment offers loan and deposit services to mortgage brokerage companies; lending to restaurant franchisees; direct leasing; small business administration loans; commercial mortgages and construction loans; and financial solutions. It provides personal and commercial banking services primarily to individuals, small to mid-sized businesses, local governmental units, and institutional customers. The Specialty Finance segment offers commercial and life insurance premiums financing for businesses and individuals; accounts receivable financing, value-added, and out-sourced administrative services; and other specialty finance services, as well as data processing of payrolls, billing, and cash management services to temporary staffing industry. The Wealth Management segment provides trust and investment, asset management, tax-deferred exchange, securities brokerage, and retirement plan services. As of December 31, 2019, the company had approximately 187 banking facilities and 230 ATMs. Wintrust Financial Corporation was founded in 1991 and is headquartered in Rosemont, Illinois."
WTFC,2019-12-31,NA,480101000,NA,355697000,802683000,1408192000,0,504737000,NA,124404000,1408192000,903455000,0,-24636000,NA,355697000,347497000,100772000,income_statement,Banks—Regional,Wintrust Financial Corporation,"Wintrust Financial Corporation operates as a financial holding company in the Chicago metropolitan area, southern Wisconsin, and northwest Indiana. It operates in three segments: Community Banking, Specialty Finance, and Wealth Management. The Community Banking segment offers non-interest bearing deposits, non-brokered interest-bearing transaction accounts, and savings and domestic time deposits; home equity, consumer, and real estate loans; safe deposit facilities; and automatic teller machine (ATM), online and mobile banking, and other services. It also engages in the origination and purchase of residential mortgages for sale into the secondary market; and provision of lending, deposits, and cash management services to condominium, homeowner, and community associations, as well as asset-based lending for middle-market companies. In addition, this segment offers loan and deposit services to mortgage brokerage companies; lending to restaurant franchisees; direct leasing; small business administration loans; commercial mortgages and construction loans; and financial solutions. It provides personal and commercial banking services primarily to individuals, small to mid-sized businesses, local governmental units, and institutional customers. The Specialty Finance segment offers commercial and life insurance premiums financing for businesses and individuals; accounts receivable financing, value-added, and out-sourced administrative services; and other specialty finance services, as well as data processing of payrolls, billing, and cash management services to temporary staffing industry. The Wealth Management segment provides trust and investment, asset management, tax-deferred exchange, securities brokerage, and retirement plan services. As of December 31, 2019, the company had approximately 187 banking facilities and 230 ATMs. Wintrust Financial Corporation was founded in 1991 and is headquartered in Rosemont, Illinois."
WTFC,2020-12-31,NA,389781000,NA,292990000,896362000,1429244000,0,424250000,NA,96791000,1429244000,1004994000,0,-34469000,NA,292990000,271613000,108632000,income_statement,Banks—Regional,Wintrust Financial Corporation,"Wintrust Financial Corporation operates as a financial holding company in the Chicago metropolitan area, southern Wisconsin, and northwest Indiana. It operates in three segments: Community Banking, Specialty Finance, and Wealth Management. The Community Banking segment offers non-interest bearing deposits, non-brokered interest-bearing transaction accounts, and savings and domestic time deposits; home equity, consumer, and real estate loans; safe deposit facilities; and automatic teller machine (ATM), online and mobile banking, and other services. It also engages in the origination and purchase of residential mortgages for sale into the secondary market; and provision of lending, deposits, and cash management services to condominium, homeowner, and community associations, as well as asset-based lending for middle-market companies. In addition, this segment offers loan and deposit services to mortgage brokerage companies; lending to restaurant franchisees; direct leasing; small business administration loans; commercial mortgages and construction loans; and financial solutions. It provides personal and commercial banking services primarily to individuals, small to mid-sized businesses, local governmental units, and institutional customers. The Specialty Finance segment offers commercial and life insurance premiums financing for businesses and individuals; accounts receivable financing, value-added, and out-sourced administrative services; and other specialty finance services, as well as data processing of payrolls, billing, and cash management services to temporary staffing industry. The Wealth Management segment provides trust and investment, asset management, tax-deferred exchange, securities brokerage, and retirement plan services. As of December 31, 2019, the company had approximately 187 banking facilities and 230 ATMs. Wintrust Financial Corporation was founded in 1991 and is headquartered in Rosemont, Illinois."
WTFCM,2017-12-31,NA,389997000,NA,257682000,635623000,1120586000,0,412994000,NA,132315000,1120586000,707592000,0,-22997000,NA,257682000,247904000,71969000,income_statement,Banks—Regional,Wintrust Financial Corporation,"Wintrust Financial Corporation operates as a financial holding company in the Chicago metropolitan area, southern Wisconsin, and northwest Indiana. It operates in three segments: Community Banking, Specialty Finance, and Wealth Management. The Community Banking segment offers non-interest bearing deposits, non-brokered interest-bearing transaction accounts, and savings and domestic time deposits; home equity, consumer, and real estate loans; safe deposit facilities; and automatic teller machine (ATM), online and mobile banking, and other services. It also engages in the origination and purchase of residential mortgages for sale into the secondary market; and provision of lending, deposits, and cash management services to condominium, homeowner, and community associations, as well as asset-based lending for middle-market companies. In addition, this segment offers loan and deposit services to mortgage brokerage companies; lending to restaurant franchisees; direct leasing; small business administration loans; commercial mortgages and construction loans; and financial solutions. It provides personal and commercial banking services primarily to individuals, small to mid-sized businesses, local governmental units, and institutional customers. The Specialty Finance segment offers commercial and life insurance premiums financing for businesses and individuals; accounts receivable financing, value-added, and out-sourced administrative services; and other specialty finance services, as well as data processing of payrolls, billing, and cash management services to temporary staffing industry. The Wealth Management segment provides trust and investment, asset management, tax-deferred exchange, securities brokerage, and retirement plan services. As of December 31, 2019, the company had approximately 187 banking facilities and 230 ATMs. Wintrust Financial Corporation was founded in 1991 and is headquartered in Rosemont, Illinois."
WTFCM,2018-12-31,NA,460133000,NA,343166000,718618000,1285620000,0,487432000,NA,116967000,1285620000,798188000,0,-27299000,NA,343166000,334966000,79570000,income_statement,Banks—Regional,Wintrust Financial Corporation,"Wintrust Financial Corporation operates as a financial holding company in the Chicago metropolitan area, southern Wisconsin, and northwest Indiana. It operates in three segments: Community Banking, Specialty Finance, and Wealth Management. The Community Banking segment offers non-interest bearing deposits, non-brokered interest-bearing transaction accounts, and savings and domestic time deposits; home equity, consumer, and real estate loans; safe deposit facilities; and automatic teller machine (ATM), online and mobile banking, and other services. It also engages in the origination and purchase of residential mortgages for sale into the secondary market; and provision of lending, deposits, and cash management services to condominium, homeowner, and community associations, as well as asset-based lending for middle-market companies. In addition, this segment offers loan and deposit services to mortgage brokerage companies; lending to restaurant franchisees; direct leasing; small business administration loans; commercial mortgages and construction loans; and financial solutions. It provides personal and commercial banking services primarily to individuals, small to mid-sized businesses, local governmental units, and institutional customers. The Specialty Finance segment offers commercial and life insurance premiums financing for businesses and individuals; accounts receivable financing, value-added, and out-sourced administrative services; and other specialty finance services, as well as data processing of payrolls, billing, and cash management services to temporary staffing industry. The Wealth Management segment provides trust and investment, asset management, tax-deferred exchange, securities brokerage, and retirement plan services. As of December 31, 2019, the company had approximately 187 banking facilities and 230 ATMs. Wintrust Financial Corporation was founded in 1991 and is headquartered in Rosemont, Illinois."
WTFCM,2019-12-31,NA,480101000,NA,355697000,802683000,1408192000,0,504737000,NA,124404000,1408192000,903455000,0,-24636000,NA,355697000,347497000,100772000,income_statement,Banks—Regional,Wintrust Financial Corporation,"Wintrust Financial Corporation operates as a financial holding company in the Chicago metropolitan area, southern Wisconsin, and northwest Indiana. It operates in three segments: Community Banking, Specialty Finance, and Wealth Management. The Community Banking segment offers non-interest bearing deposits, non-brokered interest-bearing transaction accounts, and savings and domestic time deposits; home equity, consumer, and real estate loans; safe deposit facilities; and automatic teller machine (ATM), online and mobile banking, and other services. It also engages in the origination and purchase of residential mortgages for sale into the secondary market; and provision of lending, deposits, and cash management services to condominium, homeowner, and community associations, as well as asset-based lending for middle-market companies. In addition, this segment offers loan and deposit services to mortgage brokerage companies; lending to restaurant franchisees; direct leasing; small business administration loans; commercial mortgages and construction loans; and financial solutions. It provides personal and commercial banking services primarily to individuals, small to mid-sized businesses, local governmental units, and institutional customers. The Specialty Finance segment offers commercial and life insurance premiums financing for businesses and individuals; accounts receivable financing, value-added, and out-sourced administrative services; and other specialty finance services, as well as data processing of payrolls, billing, and cash management services to temporary staffing industry. The Wealth Management segment provides trust and investment, asset management, tax-deferred exchange, securities brokerage, and retirement plan services. As of December 31, 2019, the company had approximately 187 banking facilities and 230 ATMs. Wintrust Financial Corporation was founded in 1991 and is headquartered in Rosemont, Illinois."
WTFCM,2020-12-31,NA,389781000,NA,292990000,896362000,1429244000,0,424250000,NA,96791000,1429244000,1004994000,0,-34469000,NA,292990000,271613000,108632000,income_statement,Banks—Regional,Wintrust Financial Corporation,"Wintrust Financial Corporation operates as a financial holding company in the Chicago metropolitan area, southern Wisconsin, and northwest Indiana. It operates in three segments: Community Banking, Specialty Finance, and Wealth Management. The Community Banking segment offers non-interest bearing deposits, non-brokered interest-bearing transaction accounts, and savings and domestic time deposits; home equity, consumer, and real estate loans; safe deposit facilities; and automatic teller machine (ATM), online and mobile banking, and other services. It also engages in the origination and purchase of residential mortgages for sale into the secondary market; and provision of lending, deposits, and cash management services to condominium, homeowner, and community associations, as well as asset-based lending for middle-market companies. In addition, this segment offers loan and deposit services to mortgage brokerage companies; lending to restaurant franchisees; direct leasing; small business administration loans; commercial mortgages and construction loans; and financial solutions. It provides personal and commercial banking services primarily to individuals, small to mid-sized businesses, local governmental units, and institutional customers. The Specialty Finance segment offers commercial and life insurance premiums financing for businesses and individuals; accounts receivable financing, value-added, and out-sourced administrative services; and other specialty finance services, as well as data processing of payrolls, billing, and cash management services to temporary staffing industry. The Wealth Management segment provides trust and investment, asset management, tax-deferred exchange, securities brokerage, and retirement plan services. As of December 31, 2019, the company had approximately 187 banking facilities and 230 ATMs. Wintrust Financial Corporation was founded in 1991 and is headquartered in Rosemont, Illinois."
WTRE,2017-12-31,NA,10762000,NA,10741000,21174000,46416000,25242000,25242000,-15900000,21000,623544000,598302000,577128000,-14480000,NA,10741000,-8892000,NA,income_statement,Insurance—Diversified,Watford Holdings Ltd.,"Watford Holdings Ltd., together with its subsidiaries, operates as a property, casualty, and mortgage insurance and reinsurance company worldwide. The company offers casualty reinsurance products, such as executive assurance, medical malpractice liability, other professional liability, workers' compensation, umbrella liability; other specialty reinsurance, including personal and commercial automobile, mortgage, surety, accident and health, workers' compensation catastrophe, agriculture and marine, and aviation; and property catastrophe reinsurance, as well as other insurance programs comprising general liability, umbrella liability, professional liability, personal and commercial automobile, and inland marine and property business with minimal catastrophe exposure. The company was founded in 2013 and is headquartered in Pembroke, Bermuda."
WTRE,2018-12-31,NA,-34856000,NA,-34883000,22311000,19344000,-2967000,-2967000,-26500000,27000,601735000,604702000,582391000,-31889000,NA,-34883000,-54516000,NA,income_statement,Insurance—Diversified,Watford Holdings Ltd.,"Watford Holdings Ltd., together with its subsidiaries, operates as a property, casualty, and mortgage insurance and reinsurance company worldwide. The company offers casualty reinsurance products, such as executive assurance, medical malpractice liability, other professional liability, workers' compensation, umbrella liability; other specialty reinsurance, including personal and commercial automobile, mortgage, surety, accident and health, workers' compensation catastrophe, agriculture and marine, and aviation; and property catastrophe reinsurance, as well as other insurance programs comprising general liability, umbrella liability, professional liability, personal and commercial automobile, and inland marine and property business with minimal catastrophe exposure. The company was founded in 2013 and is headquartered in Pembroke, Bermuda."
WTRE,2019-12-31,NA,62561000,NA,62541000,30843000,135142000,104299000,104299000,-33491000,20000,715065000,610766000,579923000,-41738000,NA,62541000,44745000,NA,income_statement,Insurance—Diversified,Watford Holdings Ltd.,"Watford Holdings Ltd., together with its subsidiaries, operates as a property, casualty, and mortgage insurance and reinsurance company worldwide. The company offers casualty reinsurance products, such as executive assurance, medical malpractice liability, other professional liability, workers' compensation, umbrella liability; other specialty reinsurance, including personal and commercial automobile, mortgage, surety, accident and health, workers' compensation catastrophe, agriculture and marine, and aviation; and property catastrophe reinsurance, as well as other insurance programs comprising general liability, umbrella liability, professional liability, personal and commercial automobile, and inland marine and property business with minimal catastrophe exposure. The company was founded in 2013 and is headquartered in Pembroke, Bermuda."
WTRE,2020-12-31,NA,64940000,NA,64914000,28341000,110355000,82014000,82014000,-11647000,26000,676378000,594364000,566023000,-17074000,NA,64914000,60512000,NA,income_statement,Insurance—Diversified,Watford Holdings Ltd.,"Watford Holdings Ltd., together with its subsidiaries, operates as a property, casualty, and mortgage insurance and reinsurance company worldwide. The company offers casualty reinsurance products, such as executive assurance, medical malpractice liability, other professional liability, workers' compensation, umbrella liability; other specialty reinsurance, including personal and commercial automobile, mortgage, surety, accident and health, workers' compensation catastrophe, agriculture and marine, and aviation; and property catastrophe reinsurance, as well as other insurance programs comprising general liability, umbrella liability, professional liability, personal and commercial automobile, and inland marine and property business with minimal catastrophe exposure. The company was founded in 2013 and is headquartered in Pembroke, Bermuda."
WTREP,2017-12-31,NA,10762000,NA,10741000,21174000,46416000,25242000,25242000,-15900000,21000,623544000,598302000,577128000,-14480000,NA,10741000,-8892000,NA,income_statement,Insurance—Diversified,Watford Holdings Ltd. - 8.25% C,"Watford Holdings Ltd., together with its subsidiaries, operates as a property, casualty, and mortgage insurance and reinsurance company worldwide. The company offers casualty reinsurance products, such as executive assurance, medical malpractice liability, other professional liability, workers' compensation, umbrella liability; other specialty reinsurance, including personal and commercial automobile, mortgage, surety, accident and health, workers' compensation catastrophe, agriculture and marine, and aviation; and property catastrophe reinsurance, as well as other insurance programs comprising general liability, umbrella liability, professional liability, personal and commercial automobile, and inland marine and property business with minimal catastrophe exposure. The company was founded in 2013 and is headquartered in Pembroke, Bermuda."
WTREP,2018-12-31,NA,-34856000,NA,-34883000,22311000,19344000,-2967000,-2967000,-26500000,27000,601735000,604702000,582391000,-31889000,NA,-34883000,-54516000,NA,income_statement,Insurance—Diversified,Watford Holdings Ltd. - 8.25% C,"Watford Holdings Ltd., together with its subsidiaries, operates as a property, casualty, and mortgage insurance and reinsurance company worldwide. The company offers casualty reinsurance products, such as executive assurance, medical malpractice liability, other professional liability, workers' compensation, umbrella liability; other specialty reinsurance, including personal and commercial automobile, mortgage, surety, accident and health, workers' compensation catastrophe, agriculture and marine, and aviation; and property catastrophe reinsurance, as well as other insurance programs comprising general liability, umbrella liability, professional liability, personal and commercial automobile, and inland marine and property business with minimal catastrophe exposure. The company was founded in 2013 and is headquartered in Pembroke, Bermuda."
WTREP,2019-12-31,NA,62561000,NA,62541000,30843000,135142000,104299000,104299000,-33491000,20000,715065000,610766000,579923000,-41738000,NA,62541000,44745000,NA,income_statement,Insurance—Diversified,Watford Holdings Ltd. - 8.25% C,"Watford Holdings Ltd., together with its subsidiaries, operates as a property, casualty, and mortgage insurance and reinsurance company worldwide. The company offers casualty reinsurance products, such as executive assurance, medical malpractice liability, other professional liability, workers' compensation, umbrella liability; other specialty reinsurance, including personal and commercial automobile, mortgage, surety, accident and health, workers' compensation catastrophe, agriculture and marine, and aviation; and property catastrophe reinsurance, as well as other insurance programs comprising general liability, umbrella liability, professional liability, personal and commercial automobile, and inland marine and property business with minimal catastrophe exposure. The company was founded in 2013 and is headquartered in Pembroke, Bermuda."
WTREP,2020-12-31,NA,64940000,NA,64914000,28341000,110355000,82014000,82014000,-11647000,26000,676378000,594364000,566023000,-17074000,NA,64914000,60512000,NA,income_statement,Insurance—Diversified,Watford Holdings Ltd. - 8.25% C,"Watford Holdings Ltd., together with its subsidiaries, operates as a property, casualty, and mortgage insurance and reinsurance company worldwide. The company offers casualty reinsurance products, such as executive assurance, medical malpractice liability, other professional liability, workers' compensation, umbrella liability; other specialty reinsurance, including personal and commercial automobile, mortgage, surety, accident and health, workers' compensation catastrophe, agriculture and marine, and aviation; and property catastrophe reinsurance, as well as other insurance programs comprising general liability, umbrella liability, professional liability, personal and commercial automobile, and inland marine and property business with minimal catastrophe exposure. The company was founded in 2013 and is headquartered in Pembroke, Bermuda."
WTRH,2016-12-31,395000,-8717000,NA,-8722000,5510000,865000,-5307000,-5307000,-4467000,5000,5650000,10957000,4785000,-3410000,NA,-8722000,-8722000,NA,income_statement,Software—Application,Waitr Holdings Inc.,"Waitr Holdings Inc. provides online food ordering and delivery services in the United States. Its Waitr Platform and Bite Squad Platform facilitate ordering of food and beverages by diners from restaurant partners for pick-up and delivery through a network of drivers. As of December 31, 2019, the company had approximately 18,000 restaurant partners in 640 cities. The company was founded in 2013 and is headquartered in Lafayette, Louisiana."
WTRH,2017-12-31,1586000,-26901000,NA,-26907000,15098000,1941000,-15466000,-15466000,-283000,6000,22911000,38377000,20970000,-11435000,NA,-26907000,-26907000,NA,income_statement,Software—Application,Waitr Holdings Inc.,"Waitr Holdings Inc. provides online food ordering and delivery services in the United States. Its Waitr Platform and Bite Squad Platform facilitate ordering of food and beverages by diners from restaurant partners for pick-up and delivery through a network of drivers. As of December 31, 2019, the company had approximately 18,000 restaurant partners in 640 cities. The company was founded in 2013 and is headquartered in Lafayette, Louisiana."
WTRH,2018-12-31,3913000,-34738000,NA,-34311000,46843000,17845000,-34134000,-34134000,-1822000,-427000,69273000,103407000,51428000,-604000,NA,-34311000,-34311000,NA,income_statement,Software—Application,Waitr Holdings Inc.,"Waitr Holdings Inc. provides online food ordering and delivery services in the United States. Its Waitr Platform and Bite Squad Platform facilitate ordering of food and beverages by diners from restaurant partners for pick-up and delivery through a network of drivers. As of December 31, 2019, the company had approximately 18,000 restaurant partners in 640 cities. The company was founded in 2013 and is headquartered in Lafayette, Louisiana."
WTRH,2019-12-31,7718000,-291225000,NA,-291306000,99772000,43916000,-79348000,-79348000,-9408000,81000,191675000,271023000,147759000,-211877000,NA,-291306000,-289409000,NA,income_statement,Software—Application,Waitr Holdings Inc.,"Waitr Holdings Inc. provides online food ordering and delivery services in the United States. Its Waitr Platform and Bite Squad Platform facilitate ordering of food and beverages by diners from restaurant partners for pick-up and delivery through a network of drivers. As of December 31, 2019, the company had approximately 18,000 restaurant partners in 640 cities. The company was founded in 2013 and is headquartered in Lafayette, Louisiana."
WU,2017-12-31,NA,347500000,NA,-557100000,1184100000,2207000000,1022900000,1022900000,-142100000,904600000,5524300000,4501400000,3317300000,-675400000,NA,-557100000,-557100000,NA,income_statement,NA,NA,NA
WU,2018-12-31,NA,991400000,NA,851900000,1178700000,2289100000,1110400000,1110400000,-149600000,139500000,5589900000,4479500000,3300800000,-119000000,NA,851900000,851900000,NA,income_statement,NA,NA,NA
WU,2019-12-31,NA,1321400000,NA,1058300000,1206700000,2245400000,1038700000,1038700000,-152000000,263100000,5292100000,4253400000,3046700000,282700000,NA,1058300000,1058300000,NA,income_statement,NA,NA,NA
WU,2020-12-31,NA,855100000,NA,744300000,1008900000,2013000000,1004100000,1004100000,-118500000,110800000,4835000000,3830900000,2822000000,-149000000,NA,744300000,744300000,NA,income_statement,NA,NA,NA
WVE,2016-12-31,NA,-55178000,NA,-55660000,15994000,-39726000,-55720000,-55720000,NA,482000,1092000,56812000,40818000,542000,NA,-55660000,-55660000,NA,income_statement,Biotechnology,Wave Life Sciences Ltd.,"Wave Life Sciences Ltd., a clinical stage genetic medicine company, designs, optimizes, and produces of novel stereopure oligonucleotides through PRISM, a discovery and drug developing platform. The company is primarily developing oligonucleotides that target genetic defects to either reduce the expression of disease-promoting proteins or transform the production of dysfunctional mutant proteins into the production of functional proteins. It focuses on programs in neurology in the central nervous system and neuromuscular system. The company has a research, license, and option agreement with Pfizer Inc. and Takeda Pharmaceutical Company Limited for the research, development, and commercialization of stereopure oligonucleotide therapeutics and oligonucleotide therapeutics; and research, development, and develop antisense oligonucleotides. Wave Life Sciences Ltd. was founded in 2012 and is based in Singapore."
WVE,2017-12-31,NA,-101138000,NA,-101980000,26975000,-75416000,-102391000,-102391000,NA,842000,3893000,106284000,79309000,1253000,NA,-101980000,-101980000,NA,income_statement,Biotechnology,Wave Life Sciences Ltd.,"Wave Life Sciences Ltd., a clinical stage genetic medicine company, designs, optimizes, and produces of novel stereopure oligonucleotides through PRISM, a discovery and drug developing platform. The company is primarily developing oligonucleotides that target genetic defects to either reduce the expression of disease-promoting proteins or transform the production of dysfunctional mutant proteins into the production of functional proteins. It focuses on programs in neurology in the central nervous system and neuromuscular system. The company has a research, license, and option agreement with Pfizer Inc. and Takeda Pharmaceutical Company Limited for the research, development, and commercialization of stereopure oligonucleotide therapeutics and oligonucleotide therapeutics; and research, development, and develop antisense oligonucleotides. Wave Life Sciences Ltd. was founded in 2012 and is based in Singapore."
WVE,2018-12-31,NA,-146584000,NA,-146653000,39509000,-120014000,-159523000,-159523000,NA,69000,14414000,173937000,134428000,12939000,NA,-146653000,-146653000,NA,income_statement,Biotechnology,Wave Life Sciences Ltd.,"Wave Life Sciences Ltd., a clinical stage genetic medicine company, designs, optimizes, and produces of novel stereopure oligonucleotides through PRISM, a discovery and drug developing platform. The company is primarily developing oligonucleotides that target genetic defects to either reduce the expression of disease-promoting proteins or transform the production of dysfunctional mutant proteins into the production of functional proteins. It focuses on programs in neurology in the central nervous system and neuromuscular system. The company has a research, license, and option agreement with Pfizer Inc. and Takeda Pharmaceutical Company Limited for the research, development, and commercialization of stereopure oligonucleotide therapeutics and oligonucleotide therapeutics; and research, development, and develop antisense oligonucleotides. Wave Life Sciences Ltd. was founded in 2012 and is based in Singapore."
WVE,2019-12-31,NA,-193638000,NA,-193638000,48869000,-159448000,-208317000,-208317000,NA,0,15983000,224300000,175431000,14679000,NA,-193638000,-193638000,NA,income_statement,Biotechnology,Wave Life Sciences Ltd.,"Wave Life Sciences Ltd., a clinical stage genetic medicine company, designs, optimizes, and produces of novel stereopure oligonucleotides through PRISM, a discovery and drug developing platform. The company is primarily developing oligonucleotides that target genetic defects to either reduce the expression of disease-promoting proteins or transform the production of dysfunctional mutant proteins into the production of functional proteins. It focuses on programs in neurology in the central nervous system and neuromuscular system. The company has a research, license, and option agreement with Pfizer Inc. and Takeda Pharmaceutical Company Limited for the research, development, and commercialization of stereopure oligonucleotide therapeutics and oligonucleotide therapeutics; and research, development, and develop antisense oligonucleotides. Wave Life Sciences Ltd. was founded in 2012 and is based in Singapore."
WVFC,2017-06-30,NA,2485000,NA,1637000,2809000,6224000,0,2596000,NA,848000,6224000,3628000,0,-111000,NA,1637000,1637000,819000,income_statement,Banks—Regional,WVS Financial Corp.,"WVS Financial Corp. operates as the bank holding company for West View Savings Bank that provides various banking products and services to individuals and businesses. The company accepts various deposit products, such as regular savings accounts, demand accounts, negotiable order of withdrawal accounts, money market deposit accounts, and certificates of deposit, as well as individual retirement account certificates. Its loan products include single-family and multi-family residential real estate loans; commercial real estate loans; construction loans; consumer loans, such as home equity loans, home equity lines of credit, loans secured by deposit accounts, and personal and education loans; commercial loans comprising loans secured by accounts receivable, marketable investment securities, business inventory and equipment, and related collaterals; and land acquisition and development loans. The company operates six offices in the North Hills suburbs of Pittsburgh, Pennsylvania. WVS Financial Corp. was founded in 1993 and is based in Pittsburgh, Pennsylvania."
WVFC,2018-06-30,NA,3253000,NA,2125000,2804000,6966000,0,3361000,NA,1128000,6966000,3605000,0,-108000,NA,2125000,2125000,801000,income_statement,Banks—Regional,WVS Financial Corp.,"WVS Financial Corp. operates as the bank holding company for West View Savings Bank that provides various banking products and services to individuals and businesses. The company accepts various deposit products, such as regular savings accounts, demand accounts, negotiable order of withdrawal accounts, money market deposit accounts, and certificates of deposit, as well as individual retirement account certificates. Its loan products include single-family and multi-family residential real estate loans; commercial real estate loans; construction loans; consumer loans, such as home equity loans, home equity lines of credit, loans secured by deposit accounts, and personal and education loans; commercial loans comprising loans secured by accounts receivable, marketable investment securities, business inventory and equipment, and related collaterals; and land acquisition and development loans. The company operates six offices in the North Hills suburbs of Pittsburgh, Pennsylvania. WVS Financial Corp. was founded in 1993 and is based in Pittsburgh, Pennsylvania."
WVFC,2019-06-30,NA,3727000,NA,2795000,2914000,7517000,0,3824000,NA,932000,7517000,3693000,0,-97000,NA,2795000,2795000,779000,income_statement,Banks—Regional,WVS Financial Corp.,"WVS Financial Corp. operates as the bank holding company for West View Savings Bank that provides various banking products and services to individuals and businesses. The company accepts various deposit products, such as regular savings accounts, demand accounts, negotiable order of withdrawal accounts, money market deposit accounts, and certificates of deposit, as well as individual retirement account certificates. Its loan products include single-family and multi-family residential real estate loans; commercial real estate loans; construction loans; consumer loans, such as home equity loans, home equity lines of credit, loans secured by deposit accounts, and personal and education loans; commercial loans comprising loans secured by accounts receivable, marketable investment securities, business inventory and equipment, and related collaterals; and land acquisition and development loans. The company operates six offices in the North Hills suburbs of Pittsburgh, Pennsylvania. WVS Financial Corp. was founded in 1993 and is based in Pittsburgh, Pennsylvania."
WVFC,2020-06-30,NA,3360000,NA,2490000,2758000,6923000,0,3373000,NA,870000,6923000,3550000,0,-13000,NA,2490000,2490000,792000,income_statement,Banks—Regional,WVS Financial Corp.,"WVS Financial Corp. operates as the bank holding company for West View Savings Bank that provides various banking products and services to individuals and businesses. The company accepts various deposit products, such as regular savings accounts, demand accounts, negotiable order of withdrawal accounts, money market deposit accounts, and certificates of deposit, as well as individual retirement account certificates. Its loan products include single-family and multi-family residential real estate loans; commercial real estate loans; construction loans; consumer loans, such as home equity loans, home equity lines of credit, loans secured by deposit accounts, and personal and education loans; commercial loans comprising loans secured by accounts receivable, marketable investment securities, business inventory and equipment, and related collaterals; and land acquisition and development loans. The company operates six offices in the North Hills suburbs of Pittsburgh, Pennsylvania. WVS Financial Corp. was founded in 1993 and is based in Pittsburgh, Pennsylvania."
WVVI,2016-12-31,NA,4107285,NA,2628975,8163127,12220528,4057401,4057401,-291370,1478310,19425412,15368011,7204884,49884,NA,2628975,2166446,NA,income_statement,Beverages—Wineries & Distilleries,"Willamette Valley Vineyards, In","Willamette Valley Vineyards, Inc. produces and sells wine in the United States and internationally. It primarily offers Pinot Noir, Chardonnay, Pinot Gris, Pinot Blanc, Methode Champenoise Brut, Rose, and Riesling branded wines under the Willamette Valley Vineyards label; Semi-Sparkling Muscat branded wine under the Tualatin Estate Vineyards label; Syrah, Merlot, Cabernet Sauvignon, Grenache, Cabernet Franc, Tempranillo, Malbec, The Griffin, and Viognier branded wines under the Griffin Creek label; and Oregon Blossom branded wine under the Oregon Cellars label. The company also provides Pinot Noir and Chardonnay branded wine under the Elton label; Chrysologue, Merlot, and Cabernet Sauvignon branded wine under the Pambrun label; and Frontiere Syrah, GraviÃ©re Syrah, Voyageur Syrah, Bourgeois Grenache, and Voltigeur Viognier branded wine under the Maison Bleue label, as well as offers wines under the Natoma and Metis labels. It owns and leases approximately 914 acres of land. The company markets and sells its wine products directly through sales at the winery; and mailing lists, as well as through distributors and wine brokers. Willamette Valley Vineyards, Inc. was founded in 1983 and is headquartered in Turner, Oregon."
WVVI,2017-12-31,NA,3446505,NA,2993779,9245807,12881851,3636044,3636044,-473608,452726,20853527,17217483,7971676,-189539,NA,2993779,2289730,NA,income_statement,Beverages—Wineries & Distilleries,"Willamette Valley Vineyards, In","Willamette Valley Vineyards, Inc. produces and sells wine in the United States and internationally. It primarily offers Pinot Noir, Chardonnay, Pinot Gris, Pinot Blanc, Methode Champenoise Brut, Rose, and Riesling branded wines under the Willamette Valley Vineyards label; Semi-Sparkling Muscat branded wine under the Tualatin Estate Vineyards label; Syrah, Merlot, Cabernet Sauvignon, Grenache, Cabernet Franc, Tempranillo, Malbec, The Griffin, and Viognier branded wines under the Griffin Creek label; and Oregon Blossom branded wine under the Oregon Cellars label. The company also provides Pinot Noir and Chardonnay branded wine under the Elton label; Chrysologue, Merlot, and Cabernet Sauvignon branded wine under the Pambrun label; and Frontiere Syrah, GraviÃ©re Syrah, Voyageur Syrah, Bourgeois Grenache, and Voltigeur Viognier branded wine under the Maison Bleue label, as well as offers wines under the Natoma and Metis labels. It owns and leases approximately 914 acres of land. The company markets and sells its wine products directly through sales at the winery; and mailing lists, as well as through distributors and wine brokers. Willamette Valley Vineyards, Inc. was founded in 1983 and is headquartered in Turner, Oregon."
WVVI,2018-12-31,NA,3939586,NA,2858580,10598784,14781499,4182715,4182715,-457689,1081006,23079739,18897024,8298240,-243129,NA,2858580,1839665,NA,income_statement,Beverages—Wineries & Distilleries,"Willamette Valley Vineyards, In","Willamette Valley Vineyards, Inc. produces and sells wine in the United States and internationally. It primarily offers Pinot Noir, Chardonnay, Pinot Gris, Pinot Blanc, Methode Champenoise Brut, Rose, and Riesling branded wines under the Willamette Valley Vineyards label; Semi-Sparkling Muscat branded wine under the Tualatin Estate Vineyards label; Syrah, Merlot, Cabernet Sauvignon, Grenache, Cabernet Franc, Tempranillo, Malbec, The Griffin, and Viognier branded wines under the Griffin Creek label; and Oregon Blossom branded wine under the Oregon Cellars label. The company also provides Pinot Noir and Chardonnay branded wine under the Elton label; Chrysologue, Merlot, and Cabernet Sauvignon branded wine under the Pambrun label; and Frontiere Syrah, GraviÃ©re Syrah, Voyageur Syrah, Bourgeois Grenache, and Voltigeur Viognier branded wine under the Maison Bleue label, as well as offers wines under the Natoma and Metis labels. It owns and leases approximately 914 acres of land. The company markets and sells its wine products directly through sales at the winery; and mailing lists, as well as through distributors and wine brokers. Willamette Valley Vineyards, Inc. was founded in 1983 and is headquartered in Turner, Oregon."
WVVI,2019-12-31,NA,3463024,NA,2510901,11567058,15294582,3727524,3727524,-440999,952123,24749263,21021739,9454681,-264500,NA,2510901,1484838,NA,income_statement,Beverages—Wineries & Distilleries,"Willamette Valley Vineyards, In","Willamette Valley Vineyards, Inc. produces and sells wine in the United States and internationally. It primarily offers Pinot Noir, Chardonnay, Pinot Gris, Pinot Blanc, Methode Champenoise Brut, Rose, and Riesling branded wines under the Willamette Valley Vineyards label; Semi-Sparkling Muscat branded wine under the Tualatin Estate Vineyards label; Syrah, Merlot, Cabernet Sauvignon, Grenache, Cabernet Franc, Tempranillo, Malbec, The Griffin, and Viognier branded wines under the Griffin Creek label; and Oregon Blossom branded wine under the Oregon Cellars label. The company also provides Pinot Noir and Chardonnay branded wine under the Elton label; Chrysologue, Merlot, and Cabernet Sauvignon branded wine under the Pambrun label; and Frontiere Syrah, GraviÃ©re Syrah, Voyageur Syrah, Bourgeois Grenache, and Voltigeur Viognier branded wine under the Maison Bleue label, as well as offers wines under the Natoma and Metis labels. It owns and leases approximately 914 acres of land. The company markets and sells its wine products directly through sales at the winery; and mailing lists, as well as through distributors and wine brokers. Willamette Valley Vineyards, Inc. was founded in 1983 and is headquartered in Turner, Oregon."
WVVIP,2016-12-31,NA,4107285,NA,2628975,8163127,12220528,4057401,4057401,-291370,1478310,19425412,15368011,7204884,49884,NA,2628975,2166446,NA,income_statement,Beverages—Wineries & Distilleries,"Willamette Valley Vineyards, In","Willamette Valley Vineyards, Inc. produces and sells wine in the United States and internationally. It primarily offers Pinot Noir, Chardonnay, Pinot Gris, Pinot Blanc, Methode Champenoise Brut, Rose, and Riesling branded wines under the Willamette Valley Vineyards label; Semi-Sparkling Muscat branded wine under the Tualatin Estate Vineyards label; Syrah, Merlot, Cabernet Sauvignon, Grenache, Cabernet Franc, Tempranillo, Malbec, The Griffin, and Viognier branded wines under the Griffin Creek label; and Oregon Blossom branded wine under the Oregon Cellars label. The company also provides Pinot Noir and Chardonnay branded wine under the Elton label; Chrysologue, Merlot, and Cabernet Sauvignon branded wine under the Pambrun label; and Frontiere Syrah, GraviÃ©re Syrah, Voyageur Syrah, Bourgeois Grenache, and Voltigeur Viognier branded wine under the Maison Bleue label, as well as offers wines under the Natoma and Metis labels. It owns and leases approximately 914 acres of land. The company markets and sells its wine products directly through sales at the winery; and mailing lists, as well as through distributors and wine brokers. Willamette Valley Vineyards, Inc. was founded in 1983 and is headquartered in Turner, Oregon."
WVVIP,2017-12-31,NA,3446505,NA,2993779,9245807,12881851,3636044,3636044,-473608,452726,20853527,17217483,7971676,-189539,NA,2993779,2289730,NA,income_statement,Beverages—Wineries & Distilleries,"Willamette Valley Vineyards, In","Willamette Valley Vineyards, Inc. produces and sells wine in the United States and internationally. It primarily offers Pinot Noir, Chardonnay, Pinot Gris, Pinot Blanc, Methode Champenoise Brut, Rose, and Riesling branded wines under the Willamette Valley Vineyards label; Semi-Sparkling Muscat branded wine under the Tualatin Estate Vineyards label; Syrah, Merlot, Cabernet Sauvignon, Grenache, Cabernet Franc, Tempranillo, Malbec, The Griffin, and Viognier branded wines under the Griffin Creek label; and Oregon Blossom branded wine under the Oregon Cellars label. The company also provides Pinot Noir and Chardonnay branded wine under the Elton label; Chrysologue, Merlot, and Cabernet Sauvignon branded wine under the Pambrun label; and Frontiere Syrah, GraviÃ©re Syrah, Voyageur Syrah, Bourgeois Grenache, and Voltigeur Viognier branded wine under the Maison Bleue label, as well as offers wines under the Natoma and Metis labels. It owns and leases approximately 914 acres of land. The company markets and sells its wine products directly through sales at the winery; and mailing lists, as well as through distributors and wine brokers. Willamette Valley Vineyards, Inc. was founded in 1983 and is headquartered in Turner, Oregon."
WVVIP,2018-12-31,NA,3939586,NA,2858580,10598784,14781499,4182715,4182715,-457689,1081006,23079739,18897024,8298240,-243129,NA,2858580,1839665,NA,income_statement,Beverages—Wineries & Distilleries,"Willamette Valley Vineyards, In","Willamette Valley Vineyards, Inc. produces and sells wine in the United States and internationally. It primarily offers Pinot Noir, Chardonnay, Pinot Gris, Pinot Blanc, Methode Champenoise Brut, Rose, and Riesling branded wines under the Willamette Valley Vineyards label; Semi-Sparkling Muscat branded wine under the Tualatin Estate Vineyards label; Syrah, Merlot, Cabernet Sauvignon, Grenache, Cabernet Franc, Tempranillo, Malbec, The Griffin, and Viognier branded wines under the Griffin Creek label; and Oregon Blossom branded wine under the Oregon Cellars label. The company also provides Pinot Noir and Chardonnay branded wine under the Elton label; Chrysologue, Merlot, and Cabernet Sauvignon branded wine under the Pambrun label; and Frontiere Syrah, GraviÃ©re Syrah, Voyageur Syrah, Bourgeois Grenache, and Voltigeur Viognier branded wine under the Maison Bleue label, as well as offers wines under the Natoma and Metis labels. It owns and leases approximately 914 acres of land. The company markets and sells its wine products directly through sales at the winery; and mailing lists, as well as through distributors and wine brokers. Willamette Valley Vineyards, Inc. was founded in 1983 and is headquartered in Turner, Oregon."
WVVIP,2019-12-31,NA,3463024,NA,2510901,11567058,15294582,3727524,3727524,-440999,952123,24749263,21021739,9454681,-264500,NA,2510901,1484838,NA,income_statement,Beverages—Wineries & Distilleries,"Willamette Valley Vineyards, In","Willamette Valley Vineyards, Inc. produces and sells wine in the United States and internationally. It primarily offers Pinot Noir, Chardonnay, Pinot Gris, Pinot Blanc, Methode Champenoise Brut, Rose, and Riesling branded wines under the Willamette Valley Vineyards label; Semi-Sparkling Muscat branded wine under the Tualatin Estate Vineyards label; Syrah, Merlot, Cabernet Sauvignon, Grenache, Cabernet Franc, Tempranillo, Malbec, The Griffin, and Viognier branded wines under the Griffin Creek label; and Oregon Blossom branded wine under the Oregon Cellars label. The company also provides Pinot Noir and Chardonnay branded wine under the Elton label; Chrysologue, Merlot, and Cabernet Sauvignon branded wine under the Pambrun label; and Frontiere Syrah, GraviÃ©re Syrah, Voyageur Syrah, Bourgeois Grenache, and Voltigeur Viognier branded wine under the Maison Bleue label, as well as offers wines under the Natoma and Metis labels. It owns and leases approximately 914 acres of land. The company markets and sells its wine products directly through sales at the winery; and mailing lists, as well as through distributors and wine brokers. Willamette Valley Vineyards, Inc. was founded in 1983 and is headquartered in Turner, Oregon."
WW,2016-12-31,NA,84127000,4699000,67699000,384690000,585501000,200811000,200811000,-115160000,16634000,1164902000,964091000,579401000,-116684000,NA,67493000,67699000,NA,income_statement,Personal Services,"WW International, Inc.","WW International, Inc. provides weight management products and services worldwide. The company operates in four segments: North America, Continental Europe, United Kingdom, and Other. It offers a range of nutritional, activity, behavioral, and lifestyle tools and approaches products and services. The company also provides various digital subscription products to wellness and weight management business, which provide interactive and personalized resources that allow users to follow its weight management program via its Web-based and mobile app products, including personal coaching and digital products; and allows members to inspire and support each other by sharing their experiences with other people on weight management and wellness journeys. In addition, it offers various consumer products, including bars, snacks, cookbooks, kitchen tools, and other products. Further, the company licenses its trademarks and other intellectual property in food, beverages, and other consumer products and services. It offers products through its e-commerce platform, workshops, magazine subscriptions, retail partners, publishing, and third-party advertising in publications; and through Websites and sales from the By Mail product. The company was formerly known as Weight Watchers International, Inc. and changed its name to WW International, Inc. in September 2019. WW International, Inc. was founded in 1961 and is headquartered in New York, New York."
WW,2017-12-30,NA,145080000,4467000,163514000,412021000,692649000,280628000,280628000,-112784000,-18237000,1306911000,1026283000,614262000,-135548000,NA,163317000,163514000,NA,income_statement,Personal Services,"WW International, Inc.","WW International, Inc. provides weight management products and services worldwide. The company operates in four segments: North America, Continental Europe, United Kingdom, and Other. It offers a range of nutritional, activity, behavioral, and lifestyle tools and approaches products and services. The company also provides various digital subscription products to wellness and weight management business, which provide interactive and personalized resources that allow users to follow its weight management program via its Web-based and mobile app products, including personal coaching and digital products; and allows members to inspire and support each other by sharing their experiences with other people on weight management and wellness journeys. In addition, it offers various consumer products, including bars, snacks, cookbooks, kitchen tools, and other products. Further, the company licenses its trademarks and other intellectual property in food, beverages, and other consumer products and services. It offers products through its e-commerce platform, workshops, magazine subscriptions, retail partners, publishing, and third-party advertising in publications; and through Websites and sales from the By Mail product. The company was formerly known as Weight Watchers International, Inc. and changed its name to WW International, Inc. in September 2019. WW International, Inc. was founded in 1961 and is headquartered in New York, New York."
WW,2018-12-29,NA,244061000,3913000,223749000,477425000,866410000,388985000,388985000,-142346000,20493000,1514121000,1125136000,647711000,-144924000,NA,223568000,223749000,NA,income_statement,Personal Services,"WW International, Inc.","WW International, Inc. provides weight management products and services worldwide. The company operates in four segments: North America, Continental Europe, United Kingdom, and Other. It offers a range of nutritional, activity, behavioral, and lifestyle tools and approaches products and services. The company also provides various digital subscription products to wellness and weight management business, which provide interactive and personalized resources that allow users to follow its weight management program via its Web-based and mobile app products, including personal coaching and digital products; and allows members to inspire and support each other by sharing their experiences with other people on weight management and wellness journeys. In addition, it offers various consumer products, including bars, snacks, cookbooks, kitchen tools, and other products. Further, the company licenses its trademarks and other intellectual property in food, beverages, and other consumer products and services. It offers products through its e-commerce platform, workshops, magazine subscriptions, retail partners, publishing, and third-party advertising in publications; and through Websites and sales from the By Mail product. The company was formerly known as Weight Watchers International, Inc. and changed its name to WW International, Inc. in September 2019. WW International, Inc. was founded in 1961 and is headquartered in New York, New York."
WW,2019-12-28,NA,150960000,3722000,119616000,493791000,788107000,294316000,294316000,-135267000,31513000,1413337000,1119021000,625230000,-143356000,NA,119447000,119616000,NA,income_statement,Personal Services,"WW International, Inc.","WW International, Inc. provides weight management products and services worldwide. The company operates in four segments: North America, Continental Europe, United Kingdom, and Other. It offers a range of nutritional, activity, behavioral, and lifestyle tools and approaches products and services. The company also provides various digital subscription products to wellness and weight management business, which provide interactive and personalized resources that allow users to follow its weight management program via its Web-based and mobile app products, including personal coaching and digital products; and allows members to inspire and support each other by sharing their experiences with other people on weight management and wellness journeys. In addition, it offers various consumer products, including bars, snacks, cookbooks, kitchen tools, and other products. Further, the company licenses its trademarks and other intellectual property in food, beverages, and other consumer products and services. It offers products through its e-commerce platform, workshops, magazine subscriptions, retail partners, publishing, and third-party advertising in publications; and through Websites and sales from the By Mail product. The company was formerly known as Weight Watchers International, Inc. and changed its name to WW International, Inc. in September 2019. WW International, Inc. was founded in 1961 and is headquartered in New York, New York."
WWD,2017-09-30,126519000,252747000,NA,200507000,175191000,571117000,269407000,269407000,-27430000,52240000,2098685000,1829278000,1527568000,-16660000,NA,200507000,200507000,NA,income_statement,Aerospace & Defense,"Woodward, Inc.","Woodward, Inc. designs, manufactures, and services control solutions for the aerospace and industrial markets worldwide. The company operates in two segments, Aerospace and Industrial. The Aerospace segment offers fuel pumps, metering units, actuators, air valves, specialty valves, fuel nozzles, and thrust reverser actuation systems for turbine engines and nacelles; and flight deck controls, actuators, servo controls, and motors and sensors for aircraft that are used on commercial and private aircraft and rotorcraft, as well as on military fixed-wing aircraft and rotorcraft, guided weapons, and other defense systems. It also provides aftermarket maintenance, repair and overhaul, and other services to commercial airlines, repair facilities, military depots, third party repair shops, and other end users. This segment sells its products to original equipment manufacturers (OEMs), tier-one suppliers, and various contractors, as well as through aftermarket sales of components, such as provisioning spares or replacements, and spare parts. The Industrial segment designs, produces, and services systems and products for the management of fuel, air, fluids, gases, motion, combustion, and electricity. Its products include actuators, valves, pumps, fuel injection systems, solenoids, ignition systems, speed controls, electronics and software, power converters, sensors, and other devices that measure, communicate, and protect electrical distribution systems for use in industrial gas turbines, steam turbines, reciprocating engines, electric power generation and power distribution systems, wind turbines, and compressors. This segment sells its aftermarket products, and other related services to OEMs through an independent network of distributors, as well as directly to end users. The company was founded in 1870 and is headquartered in Fort Collins, Colorado."
WWD,2018-09-30,148279000,219578000,NA,180378000,189630000,619395000,281486000,281486000,-31770000,39200000,2325873000,2044387000,1706478000,-61908000,NA,180378000,180378000,NA,income_statement,Aerospace & Defense,"Woodward, Inc.","Woodward, Inc. designs, manufactures, and services control solutions for the aerospace and industrial markets worldwide. The company operates in two segments, Aerospace and Industrial. The Aerospace segment offers fuel pumps, metering units, actuators, air valves, specialty valves, fuel nozzles, and thrust reverser actuation systems for turbine engines and nacelles; and flight deck controls, actuators, servo controls, and motors and sensors for aircraft that are used on commercial and private aircraft and rotorcraft, as well as on military fixed-wing aircraft and rotorcraft, guided weapons, and other defense systems. It also provides aftermarket maintenance, repair and overhaul, and other services to commercial airlines, repair facilities, military depots, third party repair shops, and other end users. This segment sells its products to original equipment manufacturers (OEMs), tier-one suppliers, and various contractors, as well as through aftermarket sales of components, such as provisioning spares or replacements, and spare parts. The Industrial segment designs, produces, and services systems and products for the management of fuel, air, fluids, gases, motion, combustion, and electricity. Its products include actuators, valves, pumps, fuel injection systems, solenoids, ignition systems, speed controls, electronics and software, power converters, sensors, and other devices that measure, communicate, and protect electrical distribution systems for use in industrial gas turbines, steam turbines, reciprocating engines, electric power generation and power distribution systems, wind turbines, and compressors. This segment sells its aftermarket products, and other related services to OEMs through an independent network of distributors, as well as directly to end users. The company was founded in 1870 and is headquartered in Fort Collins, Colorado."
WWD,2019-09-30,159107000,320612000,NA,259602000,207684000,707543000,340752000,340752000,-34557000,61010000,2900197000,2559445000,2192654000,-20140000,NA,259602000,259602000,NA,income_statement,Aerospace & Defense,"Woodward, Inc.","Woodward, Inc. designs, manufactures, and services control solutions for the aerospace and industrial markets worldwide. The company operates in two segments, Aerospace and Industrial. The Aerospace segment offers fuel pumps, metering units, actuators, air valves, specialty valves, fuel nozzles, and thrust reverser actuation systems for turbine engines and nacelles; and flight deck controls, actuators, servo controls, and motors and sensors for aircraft that are used on commercial and private aircraft and rotorcraft, as well as on military fixed-wing aircraft and rotorcraft, guided weapons, and other defense systems. It also provides aftermarket maintenance, repair and overhaul, and other services to commercial airlines, repair facilities, military depots, third party repair shops, and other end users. This segment sells its products to original equipment manufacturers (OEMs), tier-one suppliers, and various contractors, as well as through aftermarket sales of components, such as provisioning spares or replacements, and spare parts. The Industrial segment designs, produces, and services systems and products for the management of fuel, air, fluids, gases, motion, combustion, and electricity. Its products include actuators, valves, pumps, fuel injection systems, solenoids, ignition systems, speed controls, electronics and software, power converters, sensors, and other devices that measure, communicate, and protect electrical distribution systems for use in industrial gas turbines, steam turbines, reciprocating engines, electric power generation and power distribution systems, wind turbines, and compressors. This segment sells its aftermarket products, and other related services to OEMs through an independent network of distributors, as well as directly to end users. The company was founded in 1870 and is headquartered in Fort Collins, Colorado."
WWD,2020-09-30,133134000,281881000,NA,240395000,197196000,640243000,309913000,309913000,2320000,41486000,2495665000,2185752000,1855422000,-28032000,NA,240395000,240395000,NA,income_statement,Aerospace & Defense,"Woodward, Inc.","Woodward, Inc. designs, manufactures, and services control solutions for the aerospace and industrial markets worldwide. The company operates in two segments, Aerospace and Industrial. The Aerospace segment offers fuel pumps, metering units, actuators, air valves, specialty valves, fuel nozzles, and thrust reverser actuation systems for turbine engines and nacelles; and flight deck controls, actuators, servo controls, and motors and sensors for aircraft that are used on commercial and private aircraft and rotorcraft, as well as on military fixed-wing aircraft and rotorcraft, guided weapons, and other defense systems. It also provides aftermarket maintenance, repair and overhaul, and other services to commercial airlines, repair facilities, military depots, third party repair shops, and other end users. This segment sells its products to original equipment manufacturers (OEMs), tier-one suppliers, and various contractors, as well as through aftermarket sales of components, such as provisioning spares or replacements, and spare parts. The Industrial segment designs, produces, and services systems and products for the management of fuel, air, fluids, gases, motion, combustion, and electricity. Its products include actuators, valves, pumps, fuel injection systems, solenoids, ignition systems, speed controls, electronics and software, power converters, sensors, and other devices that measure, communicate, and protect electrical distribution systems for use in industrial gas turbines, steam turbines, reciprocating engines, electric power generation and power distribution systems, wind turbines, and compressors. This segment sells its aftermarket products, and other related services to OEMs through an independent network of distributors, as well as directly to end users. The company was founded in 1870 and is headquartered in Fort Collins, Colorado."
WWR,2017-12-31,116000,-19288000,NA,-19288000,6614000,-3772000,-23815000,-23815000,NA,0,0,23815000,3772000,4527000,-4561000,-19288000,-19288000,1039000,income_statement,Other Industrial Metals & Mining,"Westwater Resources, Inc.","Westwater Resources, Inc. operates as an energy materials developer. The company holds interests in Coosa graphite project covering an area of approximately 41,965 acres situated in Coosa County, Alabama. The company was formerly known as Uranium Resources, Inc. and changed its name to Westwater Resources, Inc. in August 2017. Westwater Resources, Inc. was incorporated in 1977 and is based in Centennial, Colorado."
WWR,2018-12-31,116000,-35684000,NA,-35684000,7009000,-3426000,-35368000,-35368000,NA,0,0,35368000,3426000,-316000,-4561000,-35684000,-35684000,993000,income_statement,Other Industrial Metals & Mining,"Westwater Resources, Inc.","Westwater Resources, Inc. operates as an energy materials developer. The company holds interests in Coosa graphite project covering an area of approximately 41,965 acres situated in Coosa County, Alabama. The company was formerly known as Uranium Resources, Inc. and changed its name to Westwater Resources, Inc. in August 2017. Westwater Resources, Inc. was incorporated in 1977 and is based in Centennial, Colorado."
WWR,2019-12-31,116000,-6004000,NA,-10565000,4474000,-268000,-4916000,-4916000,NA,0,0,4916000,268000,-1088000,-4561000,-6004000,-10565000,NA,income_statement,Other Industrial Metals & Mining,"Westwater Resources, Inc.","Westwater Resources, Inc. operates as an energy materials developer. The company holds interests in Coosa graphite project covering an area of approximately 41,965 acres situated in Coosa County, Alabama. The company was formerly known as Uranium Resources, Inc. and changed its name to Westwater Resources, Inc. in August 2017. Westwater Resources, Inc. was incorporated in 1977 and is based in Centennial, Colorado."
WWR,2020-12-31,4049000,-13912000,NA,-23574000,5678000,-34000,-9778000,-9778000,NA,0,0,9778000,34000,-4134000,-9662000,-13912000,-23574000,NA,income_statement,Other Industrial Metals & Mining,"Westwater Resources, Inc.","Westwater Resources, Inc. operates as an energy materials developer. The company holds interests in Coosa graphite project covering an area of approximately 41,965 acres situated in Coosa County, Alabama. The company was formerly known as Uranium Resources, Inc. and changed its name to Westwater Resources, Inc. in August 2017. Westwater Resources, Inc. was incorporated in 1977 and is based in Centennial, Colorado."
WY,2017-12-31,NA,716000000,NA,582000000,459000000,1898000000,1415000000,1415000000,-393000000,134000000,7196000000,5781000000,5298000000,-699000000,NA,582000000,582000000,24000000,income_statement,NA,NA,NA
WY,2018-12-31,NA,807000000,NA,748000000,478000000,1884000000,1374000000,1374000000,-375000000,59000000,7476000000,6102000000,5592000000,-567000000,NA,748000000,748000000,32000000,income_statement,NA,NA,NA
WY,2019-12-31,NA,-213000000,NA,-76000000,493000000,1142000000,615000000,615000000,-378000000,-137000000,6554000000,5939000000,5412000000,-828000000,NA,-76000000,-76000000,34000000,income_statement,NA,NA,NA
WY,2020-12-31,NA,982000000,NA,797000000,467000000,2085000000,1484000000,1484000000,-443000000,185000000,7532000000,6048000000,5447000000,-502000000,NA,797000000,797000000,134000000,income_statement,NA,NA,NA
WYNN,2017-12-31,NA,560269000,130504000,747181000,685485000,4512975000,1055565000,1055565000,-388664000,-328985000,6070160000,5014595000,1557185000,-495296000,NA,889254000,747181000,2199576000,income_statement,NA,NA,NA
WYNN,2018-12-31,NA,305740000,-219334000,572430000,761415000,5071385000,1257201000,1257201000,-381849000,-497344000,6717660000,5460459000,1646275000,-951461000,NA,803084000,572430000,2442156000,income_statement,NA,NA,NA
WYNN,2019-12-31,NA,488218000,-201573000,122985000,896670000,4784046000,898591000,898591000,-414030000,176840000,6611099000,5712508000,1827053000,-410373000,NA,311378000,122985000,2240000000,income_statement,NA,NA,NA
WYNN,2020-12-31,NA,-1762275000,NA,-2067245000,720849000,352642000,-1232045000,-1232045000,-556474000,564671000,2095861000,3327906000,1743219000,-530230000,NA,-2326946000,-2067245000,67455000,income_statement,NA,NA,NA
XAIR,2017-12-31,4438264,-18044346,NA,-18044346,6629344,0,-11067608,-11067608,-1060511,0,0,11067608,0,-6976738,NA,-18044346,-18044346,NA,income_statement,Medical Devices,"Beyond Air, Inc.","Beyond Air, Inc., a clinical-stage medical device and biopharmaceutical company, develops inhaled nitric oxide (NO) to treat respiratory infections, and gaseous NO to treat solid tumors. The company is developing LungFit system, a NO generator and delivery system, which is in clinical trials for the treatment of lung infections, persistent pulmonary hypertension of the newborn, severe acute respiratory syndrome coronavirus 2, bronchiolitis, and nontuberculous mycobacteria.The company was formerly known as AIT Therapeutics, Inc. and changed its name to Beyond Air, Inc. in June 2019. The company is based in Garden City, New York."
XAIR,2018-03-31,4632983,-10714895,NA,-10714895,5309504,0,-9942487,-9942487,-1506,0,0,9942487,0,-772408,NA,-10714895,-10714895,NA,income_statement,Medical Devices,"Beyond Air, Inc.","Beyond Air, Inc., a clinical-stage medical device and biopharmaceutical company, develops inhaled nitric oxide (NO) to treat respiratory infections, and gaseous NO to treat solid tumors. The company is developing LungFit system, a NO generator and delivery system, which is in clinical trials for the treatment of lung infections, persistent pulmonary hypertension of the newborn, severe acute respiratory syndrome coronavirus 2, bronchiolitis, and nontuberculous mycobacteria.The company was formerly known as AIT Therapeutics, Inc. and changed its name to Beyond Air, Inc. in June 2019. The company is based in Garden City, New York."
XAIR,2019-03-31,3929558,-6558450,NA,-6558450,6852988,7724001,-3058545,-3058545,-1506,0,7724001,10782546,0,-3499905,NA,-6558450,-6558450,NA,income_statement,Medical Devices,"Beyond Air, Inc.","Beyond Air, Inc., a clinical-stage medical device and biopharmaceutical company, develops inhaled nitric oxide (NO) to treat respiratory infections, and gaseous NO to treat solid tumors. The company is developing LungFit system, a NO generator and delivery system, which is in clinical trials for the treatment of lung infections, persistent pulmonary hypertension of the newborn, severe acute respiratory syndrome coronavirus 2, bronchiolitis, and nontuberculous mycobacteria.The company was formerly known as AIT Therapeutics, Inc. and changed its name to Beyond Air, Inc. in June 2019. The company is based in Garden City, New York."
XAIR,2020-03-31,10648920,-20096804,NA,-19942504,8883119,1390104,-18141935,-18141935,-30543,-154300,1390104,19532039,0,-1954869,NA,-19942504,-20464982,NA,income_statement,Medical Devices,"Beyond Air, Inc.","Beyond Air, Inc., a clinical-stage medical device and biopharmaceutical company, develops inhaled nitric oxide (NO) to treat respiratory infections, and gaseous NO to treat solid tumors. The company is developing LungFit system, a NO generator and delivery system, which is in clinical trials for the treatment of lung infections, persistent pulmonary hypertension of the newborn, severe acute respiratory syndrome coronavirus 2, bronchiolitis, and nontuberculous mycobacteria.The company was formerly known as AIT Therapeutics, Inc. and changed its name to Beyond Air, Inc. in June 2019. The company is based in Garden City, New York."
XBIO,2016-12-31,4137814,-54206106,NA,-54206106,6792786,3000000,-7930600,-7930600,-729572,0,3000000,10930600,0,-46275506,NA,-54206106,-58241366,NA,income_statement,Biotechnology,"Xenetic Biosciences, Inc.","Xenetic Biosciences, Inc., a biopharmaceutical company, focuses on advancing XCART, a personalized chimeric antigen receptor T cell (CAR T) platform technology engineered to target patient-specific tumor neoantigens. The company engages in the discovery, research, and development of biologic drugs and novel oncology therapeutics. It advances cell-based therapeutics targeting the B-cell receptor on the surface of an individual patient's malignant tumor cells for the treatment of B-cell lymphomas. The company is also leveraging PolyXen, its proprietary drug delivery platform, by partnering with biotechnology and pharmaceutical companies. It has collaboration agreements with Takeda Pharmaceutical Co. Ltd., Serum Institute of India Limited, PJSC Pharmsynthez, and SynBio LLC. Xenetic Biosciences, Inc. is headquartered in Framingham, Massachusetts."
XBIO,2017-12-31,3960000,-3595132,NA,-3595132,6437643,7428881,-2968762,-2968762,-1818,0,7585000,10553762,156119,-626370,NA,-3595132,-3595132,NA,income_statement,Biotechnology,"Xenetic Biosciences, Inc.","Xenetic Biosciences, Inc., a biopharmaceutical company, focuses on advancing XCART, a personalized chimeric antigen receptor T cell (CAR T) platform technology engineered to target patient-specific tumor neoantigens. The company engages in the discovery, research, and development of biologic drugs and novel oncology therapeutics. It advances cell-based therapeutics targeting the B-cell receptor on the surface of an individual patient's malignant tumor cells for the treatment of B-cell lymphomas. The company is also leveraging PolyXen, its proprietary drug delivery platform, by partnering with biotechnology and pharmaceutical companies. It has collaboration agreements with Takeda Pharmaceutical Co. Ltd., Serum Institute of India Limited, PJSC Pharmsynthez, and SynBio LLC. Xenetic Biosciences, Inc. is headquartered in Framingham, Massachusetts."
XBIO,2018-12-31,2883952,-7300458,NA,-7300458,4392375,0,-7276327,-7276327,NA,0,0,7276327,0,-24131,NA,-7300458,-7300458,NA,income_statement,Biotechnology,"Xenetic Biosciences, Inc.","Xenetic Biosciences, Inc., a biopharmaceutical company, focuses on advancing XCART, a personalized chimeric antigen receptor T cell (CAR T) platform technology engineered to target patient-specific tumor neoantigens. The company engages in the discovery, research, and development of biologic drugs and novel oncology therapeutics. It advances cell-based therapeutics targeting the B-cell receptor on the surface of an individual patient's malignant tumor cells for the treatment of B-cell lymphomas. The company is also leveraging PolyXen, its proprietary drug delivery platform, by partnering with biotechnology and pharmaceutical companies. It has collaboration agreements with Takeda Pharmaceutical Co. Ltd., Serum Institute of India Limited, PJSC Pharmsynthez, and SynBio LLC. Xenetic Biosciences, Inc. is headquartered in Framingham, Massachusetts."
XBIO,2019-12-31,4889340,-12775025,NA,-12775025,3631176,17066,-8503450,-8503450,NA,0,17066,8520516,0,-4271575,NA,-12775025,-18059404,NA,income_statement,Biotechnology,"Xenetic Biosciences, Inc.","Xenetic Biosciences, Inc., a biopharmaceutical company, focuses on advancing XCART, a personalized chimeric antigen receptor T cell (CAR T) platform technology engineered to target patient-specific tumor neoantigens. The company engages in the discovery, research, and development of biologic drugs and novel oncology therapeutics. It advances cell-based therapeutics targeting the B-cell receptor on the surface of an individual patient's malignant tumor cells for the treatment of B-cell lymphomas. The company is also leveraging PolyXen, its proprietary drug delivery platform, by partnering with biotechnology and pharmaceutical companies. It has collaboration agreements with Takeda Pharmaceutical Co. Ltd., Serum Institute of India Limited, PJSC Pharmsynthez, and SynBio LLC. Xenetic Biosciences, Inc. is headquartered in Framingham, Massachusetts."
XBIT,2016-12-31,41725000,-52761000,NA,-52761000,11038000,0,-52763000,-52763000,NA,0,0,52763000,0,2000,NA,-52761000,-52761000,NA,income_statement,Biotechnology,XBiotech Inc.,"XBiotech Inc., a biopharmaceutical company, discovers, develops, and commercializes True Human monoclonal antibodies for treating various diseases. The company focuses on developing a pipeline of antibody therapies for treating oncology, inflammatory conditions, and infectious diseases. Its product candidates include 514G3, an anti-infective antibody that is in Phase II clinical trial for the treatment of Staphylococcus Aureus infections; and other anti-infectious disease antibodies, which are in pre-clinical development to treat Clostridium Difficile, influenza, Ebola, and Herpes Varicella Zoster (Chickenpox). XBiotech Inc. has a collaboration with BioBridge Global for the development of potential COVID 19 treatment based on natural antibodies from recovered patients. The company was founded in 2005 and is headquartered in Austin, Texas."
XBIT,2017-12-31,26424000,-33150000,NA,-33150000,7635000,0,-34059000,-34059000,NA,0,0,34059000,0,909000,NA,-33150000,-33150000,NA,income_statement,Biotechnology,XBiotech Inc.,"XBiotech Inc., a biopharmaceutical company, discovers, develops, and commercializes True Human monoclonal antibodies for treating various diseases. The company focuses on developing a pipeline of antibody therapies for treating oncology, inflammatory conditions, and infectious diseases. Its product candidates include 514G3, an anti-infective antibody that is in Phase II clinical trial for the treatment of Staphylococcus Aureus infections; and other anti-infectious disease antibodies, which are in pre-clinical development to treat Clostridium Difficile, influenza, Ebola, and Herpes Varicella Zoster (Chickenpox). XBiotech Inc. has a collaboration with BioBridge Global for the development of potential COVID 19 treatment based on natural antibodies from recovered patients. The company was founded in 2005 and is headquartered in Austin, Texas."
XBIT,2018-12-31,15725000,-21138000,NA,-21138000,5269000,0,-20994000,-20994000,NA,0,0,20994000,0,-144000,NA,-21138000,-21138000,NA,income_statement,Biotechnology,XBiotech Inc.,"XBiotech Inc., a biopharmaceutical company, discovers, develops, and commercializes True Human monoclonal antibodies for treating various diseases. The company focuses on developing a pipeline of antibody therapies for treating oncology, inflammatory conditions, and infectious diseases. Its product candidates include 514G3, an anti-infective antibody that is in Phase II clinical trial for the treatment of Staphylococcus Aureus infections; and other anti-infectious disease antibodies, which are in pre-clinical development to treat Clostridium Difficile, influenza, Ebola, and Herpes Varicella Zoster (Chickenpox). XBiotech Inc. has a collaboration with BioBridge Global for the development of potential COVID 19 treatment based on natural antibodies from recovered patients. The company was founded in 2005 and is headquartered in Austin, Texas."
XBIT,2019-12-31,24090000,718453000,NA,668629000,7143000,0,-31233000,-31233000,NA,49824000,0,31233000,0,749686000,NA,668629000,668629000,NA,income_statement,Biotechnology,XBiotech Inc.,"XBiotech Inc., a biopharmaceutical company, discovers, develops, and commercializes True Human monoclonal antibodies for treating various diseases. The company focuses on developing a pipeline of antibody therapies for treating oncology, inflammatory conditions, and infectious diseases. Its product candidates include 514G3, an anti-infective antibody that is in Phase II clinical trial for the treatment of Staphylococcus Aureus infections; and other anti-infectious disease antibodies, which are in pre-clinical development to treat Clostridium Difficile, influenza, Ebola, and Herpes Varicella Zoster (Chickenpox). XBiotech Inc. has a collaboration with BioBridge Global for the development of potential COVID 19 treatment based on natural antibodies from recovered patients. The company was founded in 2005 and is headquartered in Austin, Texas."
XCUR,2016-12-31,NA,-16941000,NA,-16941000,3539000,-12623000,-16162000,-16162000,-724000,0,1036000,17198000,13659000,-779000,NA,-16941000,-16941000,NA,income_statement,Biotechnology,"Exicure, Inc.","Exicure, Inc., a clinical-stage biotechnology company, develops therapeutics for neurology, immuno-oncology, inflammatory diseases, and genetic disorders based on its proprietary spherical nucleic acid (SNA) technology. Its drug candidate includes AST-008 that is in a Phase 1b/2 clinical trials in patients with advanced solid tumors. The company is also developing XCUR-FXN, an SNAÂbased therapeutic candidate that is in preclinical trials for the treatment of Friedreich's ataxia; and XCUR17, an SNA that targets the messenger RNA (mRNA) encoding interleukin 17 receptor alpha. It has a collaboration, option, and license agreement with Allergan Pharmaceuticals International Limited to develop SNA-based treatments for hair loss disorders; and license and development agreement with DERMELIX, LLC to research, develop, and commercialize its technology for the treatment of netherton syndrome. The company was founded in 2011 and is based in Chicago, Illinois."
XCUR,2017-12-31,NA,-11011000,NA,-11011000,7046000,-3361000,-10407000,-10407000,-795000,0,9719000,20126000,13080000,-604000,NA,-11011000,-11011000,NA,income_statement,Biotechnology,"Exicure, Inc.","Exicure, Inc., a clinical-stage biotechnology company, develops therapeutics for neurology, immuno-oncology, inflammatory diseases, and genetic disorders based on its proprietary spherical nucleic acid (SNA) technology. Its drug candidate includes AST-008 that is in a Phase 1b/2 clinical trials in patients with advanced solid tumors. The company is also developing XCUR-FXN, an SNAÂbased therapeutic candidate that is in preclinical trials for the treatment of Friedreich's ataxia; and XCUR17, an SNA that targets the messenger RNA (mRNA) encoding interleukin 17 receptor alpha. It has a collaboration, option, and license agreement with Allergan Pharmaceuticals International Limited to develop SNA-based treatments for hair loss disorders; and license and development agreement with DERMELIX, LLC to research, develop, and commercialize its technology for the treatment of netherton syndrome. The company was founded in 2011 and is based in Chicago, Illinois."
XCUR,2018-12-31,NA,-22413000,NA,-22413000,7818000,-14001000,-21819000,-21819000,-672000,0,118000,21937000,14119000,-594000,NA,-22413000,-22413000,NA,income_statement,Biotechnology,"Exicure, Inc.","Exicure, Inc., a clinical-stage biotechnology company, develops therapeutics for neurology, immuno-oncology, inflammatory diseases, and genetic disorders based on its proprietary spherical nucleic acid (SNA) technology. Its drug candidate includes AST-008 that is in a Phase 1b/2 clinical trials in patients with advanced solid tumors. The company is also developing XCUR-FXN, an SNAÂbased therapeutic candidate that is in preclinical trials for the treatment of Friedreich's ataxia; and XCUR17, an SNA that targets the messenger RNA (mRNA) encoding interleukin 17 receptor alpha. It has a collaboration, option, and license agreement with Allergan Pharmaceuticals International Limited to develop SNA-based treatments for hair loss disorders; and license and development agreement with DERMELIX, LLC to research, develop, and commercialize its technology for the treatment of netherton syndrome. The company was founded in 2011 and is based in Chicago, Illinois."
XCUR,2019-12-31,NA,-26303000,NA,-26303000,8573000,-18044000,-26617000,-26617000,-786000,0,1296000,27913000,19340000,314000,NA,-26303000,-26303000,NA,income_statement,Biotechnology,"Exicure, Inc.","Exicure, Inc., a clinical-stage biotechnology company, develops therapeutics for neurology, immuno-oncology, inflammatory diseases, and genetic disorders based on its proprietary spherical nucleic acid (SNA) technology. Its drug candidate includes AST-008 that is in a Phase 1b/2 clinical trials in patients with advanced solid tumors. The company is also developing XCUR-FXN, an SNAÂbased therapeutic candidate that is in preclinical trials for the treatment of Friedreich's ataxia; and XCUR17, an SNA that targets the messenger RNA (mRNA) encoding interleukin 17 receptor alpha. It has a collaboration, option, and license agreement with Allergan Pharmaceuticals International Limited to develop SNA-based treatments for hair loss disorders; and license and development agreement with DERMELIX, LLC to research, develop, and commercialize its technology for the treatment of netherton syndrome. The company was founded in 2011 and is based in Chicago, Illinois."
XEL,2017-12-31,NA,1690000000,NA,1148000000,329000000,4457000000,2104000000,2104000000,-663000000,542000000,11404000000,9300000000,6947000000,-414000000,NA,1148000000,1148000000,545000000,income_statement,NA,NA,NA
XEL,2018-12-31,NA,1442000000,NA,1261000000,324000000,4373000000,1851000000,1851000000,-700000000,181000000,11537000000,9686000000,7164000000,-409000000,NA,1261000000,1261000000,556000000,income_statement,NA,NA,NA
XEL,2019-12-31,NA,1500000000,NA,1372000000,247000000,4659000000,2078000000,2078000000,-773000000,128000000,11529000000,9451000000,6870000000,-578000000,NA,1372000000,1372000000,569000000,income_statement,NA,NA,NA
XEL,2020-12-31,NA,1467000000,NA,1473000000,NA,4676000000,2116000000,2116000000,-840000000,-6000000,11526000000,9410000000,6850000000,-649000000,NA,1473000000,1473000000,612000000,income_statement,NA,NA,NA
XELA,2016-12-31,NA,-59890000,NA,-48103000,140930000,270805000,50236000,50236000,-109414000,-11787000,789926000,739690000,519121000,-110126000,NA,-48103000,-48103000,NA,income_statement,Software—Application,"Exela Technologies, Inc.","Exela Technologies, Inc. provides transaction processing solutions, enterprise information management, document management, and digital business process services worldwide. The company operates through three segments: Information & Transaction Processing Solutions (ITPS), Healthcare Solutions (HS), and Legal & Loss Prevention Services (LLPS). The ITPS segment provides lending solutions for mortgages and auto loans; banking solutions for clearing, anti-money laundering, sanctions, and interbank cross-border settlement; property and casualty insurance solutions for origination, enrollments, claims processing, and benefits administration communications; and public sector solutions for income tax processing, benefits administration, and records management. It also offers solutions for payment processing and reconciliation, integrated receivable and payables management, document logistics and location services, records management, and electronic storage of data/documents; and software, hardware, professional services, and maintenance related to information and transaction processing automation. The HS segment provides revenue cycle solutions, integrated accounts payable and accounts receivable, and information management for healthcare payer and provider markets. The LLPS segment processes legal claims for class action and mass action settlement administrations, involving project management support, notification, and outreach to claimants; and collects, analyzes, and distributes settlement funds. It also offers data and analytical services in the area of litigation consulting, economic and statistical analysis, expert witness services, and revenue recovery services for delinquent accounts receivable. The company is headquartered in Irving, Texas."
XELA,2017-12-31,NA,-270552000,NA,-209484000,171386000,318347000,48071000,48071000,-129676000,-61068000,1145891000,1097820000,827544000,-318623000,NA,-209484000,-228348000,NA,income_statement,Software—Application,"Exela Technologies, Inc.","Exela Technologies, Inc. provides transaction processing solutions, enterprise information management, document management, and digital business process services worldwide. The company operates through three segments: Information & Transaction Processing Solutions (ITPS), Healthcare Solutions (HS), and Legal & Loss Prevention Services (LLPS). The ITPS segment provides lending solutions for mortgages and auto loans; banking solutions for clearing, anti-money laundering, sanctions, and interbank cross-border settlement; property and casualty insurance solutions for origination, enrollments, claims processing, and benefits administration communications; and public sector solutions for income tax processing, benefits administration, and records management. It also offers solutions for payment processing and reconciliation, integrated receivable and payables management, document logistics and location services, records management, and electronic storage of data/documents; and software, hardware, professional services, and maintenance related to information and transaction processing automation. The HS segment provides revenue cycle solutions, integrated accounts payable and accounts receivable, and information management for healthcare payer and provider markets. The LLPS segment processes legal claims for class action and mass action settlement administrations, involving project management support, notification, and outreach to claimants; and collects, analyzes, and distributes settlement funds. It also offers data and analytical services in the area of litigation consulting, economic and statistical analysis, expert witness services, and revenue recovery services for delinquent accounts receivable. The company is headquartered in Irving, Texas."
XELA,2018-12-31,NA,-161453000,NA,-169806000,197311000,372819000,37431000,37431000,-153491000,8353000,1586222000,1548791000,1213403000,-198884000,NA,-169806000,-173461000,NA,income_statement,Software—Application,"Exela Technologies, Inc.","Exela Technologies, Inc. provides transaction processing solutions, enterprise information management, document management, and digital business process services worldwide. The company operates through three segments: Information & Transaction Processing Solutions (ITPS), Healthcare Solutions (HS), and Legal & Loss Prevention Services (LLPS). The ITPS segment provides lending solutions for mortgages and auto loans; banking solutions for clearing, anti-money laundering, sanctions, and interbank cross-border settlement; property and casualty insurance solutions for origination, enrollments, claims processing, and benefits administration communications; and public sector solutions for income tax processing, benefits administration, and records management. It also offers solutions for payment processing and reconciliation, integrated receivable and payables management, document logistics and location services, records management, and electronic storage of data/documents; and software, hardware, professional services, and maintenance related to information and transaction processing automation. The HS segment provides revenue cycle solutions, integrated accounts payable and accounts receivable, and information management for healthcare payer and provider markets. The LLPS segment processes legal claims for class action and mass action settlement administrations, involving project management support, notification, and outreach to claimants; and collects, analyzes, and distributes settlement funds. It also offers data and analytical services in the area of litigation consulting, economic and statistical analysis, expert witness services, and revenue recovery services for delinquent accounts receivable. The company is headquartered in Irving, Texas."
XELA,2019-12-31,NA,-501474000,NA,-509116000,208365000,337602000,28334000,28334000,-167749000,7642000,1562337000,1534003000,1224735000,-529808000,NA,-509116000,-512425000,NA,income_statement,Software—Application,"Exela Technologies, Inc.","Exela Technologies, Inc. provides transaction processing solutions, enterprise information management, document management, and digital business process services worldwide. The company operates through three segments: Information & Transaction Processing Solutions (ITPS), Healthcare Solutions (HS), and Legal & Loss Prevention Services (LLPS). The ITPS segment provides lending solutions for mortgages and auto loans; banking solutions for clearing, anti-money laundering, sanctions, and interbank cross-border settlement; property and casualty insurance solutions for origination, enrollments, claims processing, and benefits administration communications; and public sector solutions for income tax processing, benefits administration, and records management. It also offers solutions for payment processing and reconciliation, integrated receivable and payables management, document logistics and location services, records management, and electronic storage of data/documents; and software, hardware, professional services, and maintenance related to information and transaction processing automation. The HS segment provides revenue cycle solutions, integrated accounts payable and accounts receivable, and information management for healthcare payer and provider markets. The LLPS segment processes legal claims for class action and mass action settlement administrations, involving project management support, notification, and outreach to claimants; and collects, analyzes, and distributes settlement funds. It also offers data and analytical services in the area of litigation consulting, economic and statistical analysis, expert witness services, and revenue recovery services for delinquent accounts receivable. The company is headquartered in Irving, Texas."
XELB,2016-12-31,NA,3018000,356000,2737000,24278000,32692000,2127000,2127000,-1599000,315000,32692000,30565000,0,891000,34000,2703000,2737000,NA,income_statement,Apparel Manufacturing,"Xcel Brands, Inc","Xcel Brands, Inc., together with its subsidiaries, operates as a media and consumer products company in the United States. The company designs, produces, markets, wholesales, and sells branded apparel, footwear, accessories, jewelry, home goods, and other consumer products; and acquires consumer lifestyle brands, including the Isaac Mizrahi, the Judith Ripka, the H Halston Brand, the Halston Heritage, and the C Wonder brands. It licenses its brands to third parties; and provides design, production, and marketing services for promotion and distribution through a ubiquitous-channel retail sales strategy, including distribution through interactive television, the internet, and traditional brick-and-mortar retail channels. The company also offers social media marketing and other marketing, and public relations support for its brands. In addition, it markets the Mizrahi brands through www.isaacmizrahi.com; the Halston Brand through www.halston.com; the Judith Ripka Fine Jewelry brand through www.judithripka.com; the C Wonder brands through www.cwonder.com; and the Longaberger brand through www.longaberger.com. Xcel Brands, Inc. is headquartered in New York, New York."
XELB,2017-12-31,NA,-10569000,356000,-10122000,23811000,31706000,3149000,3149000,-1211000,-447000,31706000,28557000,0,-13718000,NA,-10122000,-10122000,NA,income_statement,Apparel Manufacturing,"Xcel Brands, Inc","Xcel Brands, Inc., together with its subsidiaries, operates as a media and consumer products company in the United States. The company designs, produces, markets, wholesales, and sells branded apparel, footwear, accessories, jewelry, home goods, and other consumer products; and acquires consumer lifestyle brands, including the Isaac Mizrahi, the Judith Ripka, the H Halston Brand, the Halston Heritage, and the C Wonder brands. It licenses its brands to third parties; and provides design, production, and marketing services for promotion and distribution through a ubiquitous-channel retail sales strategy, including distribution through interactive television, the internet, and traditional brick-and-mortar retail channels. The company also offers social media marketing and other marketing, and public relations support for its brands. In addition, it markets the Mizrahi brands through www.isaacmizrahi.com; the Halston Brand through www.halston.com; the Judith Ripka Fine Jewelry brand through www.judithripka.com; the C Wonder brands through www.cwonder.com; and the Longaberger brand through www.longaberger.com. Xcel Brands, Inc. is headquartered in New York, New York."
XELB,2018-12-31,NA,2919000,356000,1088000,24467000,32764000,4729000,4729000,-986000,1831000,35466000,30737000,2702000,-1810000,NA,1088000,1088000,NA,income_statement,Apparel Manufacturing,"Xcel Brands, Inc","Xcel Brands, Inc., together with its subsidiaries, operates as a media and consumer products company in the United States. The company designs, produces, markets, wholesales, and sells branded apparel, footwear, accessories, jewelry, home goods, and other consumer products; and acquires consumer lifestyle brands, including the Isaac Mizrahi, the Judith Ripka, the H Halston Brand, the Halston Heritage, and the C Wonder brands. It licenses its brands to third parties; and provides design, production, and marketing services for promotion and distribution through a ubiquitous-channel retail sales strategy, including distribution through interactive television, the internet, and traditional brick-and-mortar retail channels. The company also offers social media marketing and other marketing, and public relations support for its brands. In addition, it markets the Mizrahi brands through www.isaacmizrahi.com; the Halston Brand through www.halston.com; the Judith Ripka Fine Jewelry brand through www.judithripka.com; the C Wonder brands through www.cwonder.com; and the Longaberger brand through www.longaberger.com. Xcel Brands, Inc. is headquartered in New York, New York."
XELB,2019-12-31,NA,-4087000,356000,-3426000,24550000,31455000,2027000,2027000,-1231000,-642000,41727000,39700000,10272000,-6114000,NA,-3445000,-3426000,NA,income_statement,Apparel Manufacturing,"Xcel Brands, Inc","Xcel Brands, Inc., together with its subsidiaries, operates as a media and consumer products company in the United States. The company designs, produces, markets, wholesales, and sells branded apparel, footwear, accessories, jewelry, home goods, and other consumer products; and acquires consumer lifestyle brands, including the Isaac Mizrahi, the Judith Ripka, the H Halston Brand, the Halston Heritage, and the C Wonder brands. It licenses its brands to third parties; and provides design, production, and marketing services for promotion and distribution through a ubiquitous-channel retail sales strategy, including distribution through interactive television, the internet, and traditional brick-and-mortar retail channels. The company also offers social media marketing and other marketing, and public relations support for its brands. In addition, it markets the Mizrahi brands through www.isaacmizrahi.com; the Halston Brand through www.halston.com; the Judith Ripka Fine Jewelry brand through www.judithripka.com; the C Wonder brands through www.cwonder.com; and the Longaberger brand through www.longaberger.com. Xcel Brands, Inc. is headquartered in New York, New York."
XENE,2016-12-31,18714000,-22997000,NA,-22997000,6792000,689000,-24817000,-24817000,-1394000,0,1803000,26620000,1114000,1820000,NA,-22997000,-22997000,NA,income_statement,Biotechnology,Xenon Pharmaceuticals Inc.,"Xenon Pharmaceuticals Inc., a clinical-stage biopharmaceutical company, engages in developing therapeutics to treat patients with neurological disorders in Canada. Its clinical development pipeline include XEN496, A Kv7 potassium channel modulator that is Phase II clinical trials for the treatment of KCNQ2 epilepsy; XEN1101, A Kv7 potassium channel modulator, which is in Phase II clinical trial for the treatment of epilepsy. The company's product candidates also comprise XEN901, a selective Nav1.6 sodium channel inhibitor that is in Phase I clinical trials for the treatment of epilepsy; and XEN007, A central nervous system-acting calcium channel modulator, which is in Phase I clinical trials. The company has a license and collaboration agreement with the Neurocrine Biosciences, Inc. to develop first-in-class treatments for epilepsy. The company was founded in 1996 and is headquartered in Burnaby, Canada."
XENE,2017-12-31,25453000,-30704000,NA,-30704000,7313000,-25262000,-32575000,-32575000,-1394000,0,311000,32886000,25573000,1871000,NA,-30704000,-30704000,NA,income_statement,Biotechnology,Xenon Pharmaceuticals Inc.,"Xenon Pharmaceuticals Inc., a clinical-stage biopharmaceutical company, engages in developing therapeutics to treat patients with neurological disorders in Canada. Its clinical development pipeline include XEN496, A Kv7 potassium channel modulator that is Phase II clinical trials for the treatment of KCNQ2 epilepsy; XEN1101, A Kv7 potassium channel modulator, which is in Phase II clinical trial for the treatment of epilepsy. The company's product candidates also comprise XEN901, a selective Nav1.6 sodium channel inhibitor that is in Phase I clinical trials for the treatment of epilepsy; and XEN007, A central nervous system-acting calcium channel modulator, which is in Phase I clinical trials. The company has a license and collaboration agreement with the Neurocrine Biosciences, Inc. to develop first-in-class treatments for epilepsy. The company was founded in 1996 and is headquartered in Burnaby, Canada."
XENE,2018-12-31,23634000,-34521000,NA,-34497000,8406000,-23634000,-32040000,-32040000,-1394000,-24000,0,32040000,23634000,-2481000,NA,-34497000,-31616000,NA,income_statement,Biotechnology,Xenon Pharmaceuticals Inc.,"Xenon Pharmaceuticals Inc., a clinical-stage biopharmaceutical company, engages in developing therapeutics to treat patients with neurological disorders in Canada. Its clinical development pipeline include XEN496, A Kv7 potassium channel modulator that is Phase II clinical trials for the treatment of KCNQ2 epilepsy; XEN1101, A Kv7 potassium channel modulator, which is in Phase II clinical trial for the treatment of epilepsy. The company's product candidates also comprise XEN901, a selective Nav1.6 sodium channel inhibitor that is in Phase I clinical trials for the treatment of epilepsy; and XEN007, A central nervous system-acting calcium channel modulator, which is in Phase I clinical trials. The company has a license and collaboration agreement with the Neurocrine Biosciences, Inc. to develop first-in-class treatments for epilepsy. The company was founded in 1996 and is headquartered in Burnaby, Canada."
XENE,2019-12-31,NA,-41618000,NA,-41595000,10803000,-32016000,-42819000,-42819000,-1434000,-23000,6829000,49648000,38845000,1201000,NA,-41595000,-40027000,NA,income_statement,Biotechnology,Xenon Pharmaceuticals Inc.,"Xenon Pharmaceuticals Inc., a clinical-stage biopharmaceutical company, engages in developing therapeutics to treat patients with neurological disorders in Canada. Its clinical development pipeline include XEN496, A Kv7 potassium channel modulator that is Phase II clinical trials for the treatment of KCNQ2 epilepsy; XEN1101, A Kv7 potassium channel modulator, which is in Phase II clinical trial for the treatment of epilepsy. The company's product candidates also comprise XEN901, a selective Nav1.6 sodium channel inhibitor that is in Phase I clinical trials for the treatment of epilepsy; and XEN007, A central nervous system-acting calcium channel modulator, which is in Phase I clinical trials. The company has a license and collaboration agreement with the Neurocrine Biosciences, Inc. to develop first-in-class treatments for epilepsy. The company was founded in 1996 and is headquartered in Burnaby, Canada."
XENT,2016-12-31,18890000,-25222000,NA,-25222000,72926000,65705000,-26111000,-26111000,NA,0,78708000,104819000,13003000,889000,NA,-25222000,-25222000,NA,income_statement,Medical Devices,"Intersect ENT, Inc.","Intersect ENT, Inc., a drug delivery company, researches and develops products for the treatment of patients with ear, nose, and throat conditions in the United States. The company offers PROPEL and PROPEL mini drug releasing implants for patients undergoing sinus surgery to treat chronic sinusitis; and PROPEL Contour, a steroid releasing implant to frontal and maxillary sinus ostia, or openings, of the dependent sinuses. It also provides SINUVA, a steroid releasing implant for refractory disease for the treatment of patients in the physician office setting. The company was formerly known as Sinexus, Inc. and changed its name to Intersect ENT, Inc. in November 2009. Intersect ENT, Inc. was founded in 2003 and is headquartered in Menlo Park, California."
XENT,2017-12-31,18360000,-16363000,NA,-16363000,80045000,80802000,-17603000,-17603000,NA,0,96301000,113904000,15499000,1240000,NA,-16363000,-16363000,NA,income_statement,Medical Devices,"Intersect ENT, Inc.","Intersect ENT, Inc., a drug delivery company, researches and develops products for the treatment of patients with ear, nose, and throat conditions in the United States. The company offers PROPEL and PROPEL mini drug releasing implants for patients undergoing sinus surgery to treat chronic sinusitis; and PROPEL Contour, a steroid releasing implant to frontal and maxillary sinus ostia, or openings, of the dependent sinuses. It also provides SINUVA, a steroid releasing implant for refractory disease for the treatment of patients in the physician office setting. The company was formerly known as Sinexus, Inc. and changed its name to Intersect ENT, Inc. in November 2009. Intersect ENT, Inc. was founded in 2003 and is headquartered in Menlo Park, California."
XENT,2018-12-31,19262000,-22922000,NA,-22922000,91603000,85859000,-25006000,-25006000,NA,0,108472000,133478000,22613000,2084000,NA,-22922000,-22922000,NA,income_statement,Medical Devices,"Intersect ENT, Inc.","Intersect ENT, Inc., a drug delivery company, researches and develops products for the treatment of patients with ear, nose, and throat conditions in the United States. The company offers PROPEL and PROPEL mini drug releasing implants for patients undergoing sinus surgery to treat chronic sinusitis; and PROPEL Contour, a steroid releasing implant to frontal and maxillary sinus ostia, or openings, of the dependent sinuses. It also provides SINUVA, a steroid releasing implant for refractory disease for the treatment of patients in the physician office setting. The company was formerly known as Sinexus, Inc. and changed its name to Intersect ENT, Inc. in November 2009. Intersect ENT, Inc. was founded in 2003 and is headquartered in Menlo Park, California."
XENT,2019-12-31,24283000,-42994000,NA,-42994000,108480000,87369000,-45394000,-45394000,NA,0,109142000,154536000,21773000,2400000,NA,-42994000,-42994000,NA,income_statement,Medical Devices,"Intersect ENT, Inc.","Intersect ENT, Inc., a drug delivery company, researches and develops products for the treatment of patients with ear, nose, and throat conditions in the United States. The company offers PROPEL and PROPEL mini drug releasing implants for patients undergoing sinus surgery to treat chronic sinusitis; and PROPEL Contour, a steroid releasing implant to frontal and maxillary sinus ostia, or openings, of the dependent sinuses. It also provides SINUVA, a steroid releasing implant for refractory disease for the treatment of patients in the physician office setting. The company was formerly known as Sinexus, Inc. and changed its name to Intersect ENT, Inc. in November 2009. Intersect ENT, Inc. was founded in 2003 and is headquartered in Menlo Park, California."
XERS,2016-12-31,10238000,-13209000,NA,-13209000,4060000,1067000,-13231000,-13231000,-2000,0,1075000,14306000,8000,22000,NA,-13209000,-13209000,NA,income_statement,Biotechnology,"Xeris Pharmaceuticals, Inc.","Xeris Pharmaceuticals, Inc., a specialty pharmaceutical company, develops and commercializes ready-to-use injectable and infusible drug formulations. Its proprietary XeriSol and XeriJect formulation technology platforms allow for the subcutaneous and intramuscular delivery of highly-concentrated, ready-to-use formulations of peptides, small molecules, and proteins using commercially available syringes, auto-injectors, multi-dose pens, and infusion pumps. The company's lead product candidate is Gvoke HypoPen for the treatment of severe hypoglycemia, a potentially life-threatening condition in people with diabetes. Its product candidates also comprise ready-to-use glucagon that has completed Phase II clinical trials for the treatment of post-bariatric hypoglycemia, exercise-induced hypoglycemia in diabetes, bi-hormonal artificial pancreas closed-loop systems, congenital hyperinsulinism, and hypoglycemia-associated autonomic failure; and hypoglycemia associated with intermittent and chronic conditions. In addition, it develops ready-to-use diazepam formulation, which is in Phase Ib clinical trial for the treatment of Dravet syndrome and acute repetitive seizures in patients with epilepsy; and Pramlintide-Insulin co-formulation that is Phase II clinical trials for treating type 1 and 2 diabetes. Xeris Pharmaceuticals, Inc. serves patients, caregivers, and health practitioners. The company was founded in 2005 and is headquartered in Chicago, Illinois."
XERS,2017-12-31,20166000,-26554000,NA,-26554000,8015000,1552000,-26629000,-26629000,-2000,0,1556000,28185000,4000,75000,NA,-26554000,-26554000,NA,income_statement,Biotechnology,"Xeris Pharmaceuticals, Inc.","Xeris Pharmaceuticals, Inc., a specialty pharmaceutical company, develops and commercializes ready-to-use injectable and infusible drug formulations. Its proprietary XeriSol and XeriJect formulation technology platforms allow for the subcutaneous and intramuscular delivery of highly-concentrated, ready-to-use formulations of peptides, small molecules, and proteins using commercially available syringes, auto-injectors, multi-dose pens, and infusion pumps. The company's lead product candidate is Gvoke HypoPen for the treatment of severe hypoglycemia, a potentially life-threatening condition in people with diabetes. Its product candidates also comprise ready-to-use glucagon that has completed Phase II clinical trials for the treatment of post-bariatric hypoglycemia, exercise-induced hypoglycemia in diabetes, bi-hormonal artificial pancreas closed-loop systems, congenital hyperinsulinism, and hypoglycemia-associated autonomic failure; and hypoglycemia associated with intermittent and chronic conditions. In addition, it develops ready-to-use diazepam formulation, which is in Phase Ib clinical trial for the treatment of Dravet syndrome and acute repetitive seizures in patients with epilepsy; and Pramlintide-Insulin co-formulation that is Phase II clinical trials for treating type 1 and 2 diabetes. Xeris Pharmaceuticals, Inc. serves patients, caregivers, and health practitioners. The company was founded in 2005 and is headquartered in Chicago, Illinois."
XERS,2018-12-31,40654000,-60080000,NA,-60080000,21113000,2423000,-59344000,-59344000,-2545000,0,2423000,61767000,0,-736000,NA,-60080000,-60080000,NA,income_statement,Biotechnology,"Xeris Pharmaceuticals, Inc.","Xeris Pharmaceuticals, Inc., a specialty pharmaceutical company, develops and commercializes ready-to-use injectable and infusible drug formulations. Its proprietary XeriSol and XeriJect formulation technology platforms allow for the subcutaneous and intramuscular delivery of highly-concentrated, ready-to-use formulations of peptides, small molecules, and proteins using commercially available syringes, auto-injectors, multi-dose pens, and infusion pumps. The company's lead product candidate is Gvoke HypoPen for the treatment of severe hypoglycemia, a potentially life-threatening condition in people with diabetes. Its product candidates also comprise ready-to-use glucagon that has completed Phase II clinical trials for the treatment of post-bariatric hypoglycemia, exercise-induced hypoglycemia in diabetes, bi-hormonal artificial pancreas closed-loop systems, congenital hyperinsulinism, and hypoglycemia-associated autonomic failure; and hypoglycemia associated with intermittent and chronic conditions. In addition, it develops ready-to-use diazepam formulation, which is in Phase Ib clinical trial for the treatment of Dravet syndrome and acute repetitive seizures in patients with epilepsy; and Pramlintide-Insulin co-formulation that is Phase II clinical trials for treating type 1 and 2 diabetes. Xeris Pharmaceuticals, Inc. serves patients, caregivers, and health practitioners. The company was founded in 2005 and is headquartered in Chicago, Illinois."
XERS,2019-12-31,60438000,-126038000,NA,-125580000,63061000,1119000,-122380000,-122380000,-7163000,-458000,2722000,125102000,1603000,-3658000,NA,-125580000,-125580000,NA,income_statement,Biotechnology,"Xeris Pharmaceuticals, Inc.","Xeris Pharmaceuticals, Inc., a specialty pharmaceutical company, develops and commercializes ready-to-use injectable and infusible drug formulations. Its proprietary XeriSol and XeriJect formulation technology platforms allow for the subcutaneous and intramuscular delivery of highly-concentrated, ready-to-use formulations of peptides, small molecules, and proteins using commercially available syringes, auto-injectors, multi-dose pens, and infusion pumps. The company's lead product candidate is Gvoke HypoPen for the treatment of severe hypoglycemia, a potentially life-threatening condition in people with diabetes. Its product candidates also comprise ready-to-use glucagon that has completed Phase II clinical trials for the treatment of post-bariatric hypoglycemia, exercise-induced hypoglycemia in diabetes, bi-hormonal artificial pancreas closed-loop systems, congenital hyperinsulinism, and hypoglycemia-associated autonomic failure; and hypoglycemia associated with intermittent and chronic conditions. In addition, it develops ready-to-use diazepam formulation, which is in Phase Ib clinical trial for the treatment of Dravet syndrome and acute repetitive seizures in patients with epilepsy; and Pramlintide-Insulin co-formulation that is Phase II clinical trials for treating type 1 and 2 diabetes. Xeris Pharmaceuticals, Inc. serves patients, caregivers, and health practitioners. The company was founded in 2005 and is headquartered in Chicago, Illinois."
XFOR,2016-12-31,12761000,-17865000,NA,-17865000,5126000,0,-17887000,-17887000,-53000,0,0,17887000,0,22000,NA,-17865000,-20873000,NA,income_statement,Biotechnology,"X4 Pharmaceuticals, Inc.","X4 Pharmaceuticals, Inc., a clinical-stage biopharmaceutical company, focuses on the discovery, development, and commercialization of novel therapeutics for the treatment of primary immune-deficiencies and cancer. Its lead drug candidate is mavorixafor (X4P-001), an oral small molecule antagonist of chemokine receptor CXCR4, which is in Phase III clinical trial for the treatment of patients with warts, hypogammaglobulinemia, infections, and myelokathexis syndrome; Phase Ib clinical trial to treat severe congenital neutropenia and WaldenstrÃ¶m macroglobulinemia; and Phase IIa clinical trial for the treatment of clear cell renal cell carcinoma. The company is also developing X4P-002 for the treatment of glioblastoma multiforme; and X4P-003 to treat primary immune-deficiencies. It has a license agreement with Abbisko Therapeutics Co., Ltd. to develop, manufacture, and commercialize mavorixafor in combination with checkpoint inhibitors or other agents in oncology indications. The company was formerly known as Arsanis, Inc. and changed its name to X4 Pharmaceuticals, Inc. in March 2019. X4 Pharmaceuticals, Inc. was founded in 2014 and is headquartered in Cambridge, Massachusetts."
XFOR,2017-12-31,17066000,-21994000,NA,-21994000,5181000,0,-22247000,-22247000,-490000,0,0,22247000,0,253000,NA,-21994000,-24994000,NA,income_statement,Biotechnology,"X4 Pharmaceuticals, Inc.","X4 Pharmaceuticals, Inc., a clinical-stage biopharmaceutical company, focuses on the discovery, development, and commercialization of novel therapeutics for the treatment of primary immune-deficiencies and cancer. Its lead drug candidate is mavorixafor (X4P-001), an oral small molecule antagonist of chemokine receptor CXCR4, which is in Phase III clinical trial for the treatment of patients with warts, hypogammaglobulinemia, infections, and myelokathexis syndrome; Phase Ib clinical trial to treat severe congenital neutropenia and WaldenstrÃ¶m macroglobulinemia; and Phase IIa clinical trial for the treatment of clear cell renal cell carcinoma. The company is also developing X4P-002 for the treatment of glioblastoma multiforme; and X4P-003 to treat primary immune-deficiencies. It has a license agreement with Abbisko Therapeutics Co., Ltd. to develop, manufacture, and commercialize mavorixafor in combination with checkpoint inhibitors or other agents in oncology indications. The company was formerly known as Arsanis, Inc. and changed its name to X4 Pharmaceuticals, Inc. in March 2019. X4 Pharmaceuticals, Inc. was founded in 2014 and is headquartered in Cambridge, Massachusetts."
XFOR,2018-12-31,20346000,-33285000,NA,-33285000,8739000,0,-29085000,-29085000,-720000,0,0,29085000,0,-4200000,NA,-33285000,-36307000,NA,income_statement,Biotechnology,"X4 Pharmaceuticals, Inc.","X4 Pharmaceuticals, Inc., a clinical-stage biopharmaceutical company, focuses on the discovery, development, and commercialization of novel therapeutics for the treatment of primary immune-deficiencies and cancer. Its lead drug candidate is mavorixafor (X4P-001), an oral small molecule antagonist of chemokine receptor CXCR4, which is in Phase III clinical trial for the treatment of patients with warts, hypogammaglobulinemia, infections, and myelokathexis syndrome; Phase Ib clinical trial to treat severe congenital neutropenia and WaldenstrÃ¶m macroglobulinemia; and Phase IIa clinical trial for the treatment of clear cell renal cell carcinoma. The company is also developing X4P-002 for the treatment of glioblastoma multiforme; and X4P-003 to treat primary immune-deficiencies. It has a license agreement with Abbisko Therapeutics Co., Ltd. to develop, manufacture, and commercialize mavorixafor in combination with checkpoint inhibitors or other agents in oncology indications. The company was formerly known as Arsanis, Inc. and changed its name to X4 Pharmaceuticals, Inc. in March 2019. X4 Pharmaceuticals, Inc. was founded in 2014 and is headquartered in Cambridge, Massachusetts."
XFOR,2019-12-31,30163000,-52807000,NA,-52807000,16640000,0,-46803000,-46803000,-2147000,0,0,46803000,0,-6004000,NA,-52807000,-53399000,NA,income_statement,Biotechnology,"X4 Pharmaceuticals, Inc.","X4 Pharmaceuticals, Inc., a clinical-stage biopharmaceutical company, focuses on the discovery, development, and commercialization of novel therapeutics for the treatment of primary immune-deficiencies and cancer. Its lead drug candidate is mavorixafor (X4P-001), an oral small molecule antagonist of chemokine receptor CXCR4, which is in Phase III clinical trial for the treatment of patients with warts, hypogammaglobulinemia, infections, and myelokathexis syndrome; Phase Ib clinical trial to treat severe congenital neutropenia and WaldenstrÃ¶m macroglobulinemia; and Phase IIa clinical trial for the treatment of clear cell renal cell carcinoma. The company is also developing X4P-002 for the treatment of glioblastoma multiforme; and X4P-003 to treat primary immune-deficiencies. It has a license agreement with Abbisko Therapeutics Co., Ltd. to develop, manufacture, and commercialize mavorixafor in combination with checkpoint inhibitors or other agents in oncology indications. The company was formerly known as Arsanis, Inc. and changed its name to X4 Pharmaceuticals, Inc. in March 2019. X4 Pharmaceuticals, Inc. was founded in 2014 and is headquartered in Cambridge, Massachusetts."
XGN,2015-12-31,1367000,-18930000,NA,-19183000,17406000,8413000,-10568000,-10568000,-4501000,253000,17946000,28514000,9533000,-8362000,NA,-19183000,-21294000,NA,income_statement,Diagnostics & Research,Exagen Inc.,"Exagen Inc. develops and commercializes various testing products based on its Cell-Bound Complement Activation Products technology under the AVISE brand in the United States. It enable rheumatologists to enhance care for patients through the diagnosis, prognosis, and monitoring of complex autoimmune and autoimmune related diseases, including systemic lupus erythematosus (SLE) and rheumatoid arthritis (RA). Its lead testing product is AVISE CTD that enables differential diagnosis for patients presenting with symptoms indicative of various connective tissue diseases (CTDs) and other related diseases with overlapping symptoms. The company's products also comprise AVISE Lupus that measures activation of the complement system by quantifying the level of B-cell C4d and erythrocyte bound C4d in the patient's blood; and AVISE APS, which consists of a panel of eight autoantibody tests that aids in the diagnosis and management of APS. In addition, it provides AVISE SLE Prognostic, a ten-biomarker panel of autoantibodies for assessing the potential for complications affecting the kidney, brain, and cardiovascular system; AVISE Anti-CarP test, which identifies RA patients with severe disease requiring aggressive therapy, such as anti-TNF biologics; and AVISE PC4d that measures platelet- bound C4d. Further, the company offers AVISE SLE Monitor, a six-biomarker blood test; AVISE MTX, a patented and validated blood test that measures levels of MTXPG; and AVISE HCQ, a blood test designed to help rheumatologists objectively monitor levels of hydroxychloroquine. The company was formerly known as Exagen Diagnostics, Inc. and changed its name to Exagen Inc. in January 2019. Exagen Inc. was incorporated in 2002 and is headquartered in Vista, California."
XGN,2017-12-31,1551000,-26180000,NA,-25631000,18820000,12670000,-7887000,-7887000,-2948000,-549000,26807000,34694000,14137000,-18293000,NA,-25631000,-32774000,NA,income_statement,Diagnostics & Research,Exagen Inc.,"Exagen Inc. develops and commercializes various testing products based on its Cell-Bound Complement Activation Products technology under the AVISE brand in the United States. It enable rheumatologists to enhance care for patients through the diagnosis, prognosis, and monitoring of complex autoimmune and autoimmune related diseases, including systemic lupus erythematosus (SLE) and rheumatoid arthritis (RA). Its lead testing product is AVISE CTD that enables differential diagnosis for patients presenting with symptoms indicative of various connective tissue diseases (CTDs) and other related diseases with overlapping symptoms. The company's products also comprise AVISE Lupus that measures activation of the complement system by quantifying the level of B-cell C4d and erythrocyte bound C4d in the patient's blood; and AVISE APS, which consists of a panel of eight autoantibody tests that aids in the diagnosis and management of APS. In addition, it provides AVISE SLE Prognostic, a ten-biomarker panel of autoantibodies for assessing the potential for complications affecting the kidney, brain, and cardiovascular system; AVISE Anti-CarP test, which identifies RA patients with severe disease requiring aggressive therapy, such as anti-TNF biologics; and AVISE PC4d that measures platelet- bound C4d. Further, the company offers AVISE SLE Monitor, a six-biomarker blood test; AVISE MTX, a patented and validated blood test that measures levels of MTXPG; and AVISE HCQ, a blood test designed to help rheumatologists objectively monitor levels of hydroxychloroquine. The company was formerly known as Exagen Diagnostics, Inc. and changed its name to Exagen Inc. in January 2019. Exagen Inc. was incorporated in 2002 and is headquartered in Vista, California."
XGN,2018-12-31,2125000,-7954000,NA,-8012000,19675000,17061000,-4880000,-4880000,-2868000,58000,32440000,37320000,15379000,-3074000,NA,-8012000,-18482000,NA,income_statement,Diagnostics & Research,Exagen Inc.,"Exagen Inc. develops and commercializes various testing products based on its Cell-Bound Complement Activation Products technology under the AVISE brand in the United States. It enable rheumatologists to enhance care for patients through the diagnosis, prognosis, and monitoring of complex autoimmune and autoimmune related diseases, including systemic lupus erythematosus (SLE) and rheumatoid arthritis (RA). Its lead testing product is AVISE CTD that enables differential diagnosis for patients presenting with symptoms indicative of various connective tissue diseases (CTDs) and other related diseases with overlapping symptoms. The company's products also comprise AVISE Lupus that measures activation of the complement system by quantifying the level of B-cell C4d and erythrocyte bound C4d in the patient's blood; and AVISE APS, which consists of a panel of eight autoantibody tests that aids in the diagnosis and management of APS. In addition, it provides AVISE SLE Prognostic, a ten-biomarker panel of autoantibodies for assessing the potential for complications affecting the kidney, brain, and cardiovascular system; AVISE Anti-CarP test, which identifies RA patients with severe disease requiring aggressive therapy, such as anti-TNF biologics; and AVISE PC4d that measures platelet- bound C4d. Further, the company offers AVISE SLE Monitor, a six-biomarker blood test; AVISE MTX, a patented and validated blood test that measures levels of MTXPG; and AVISE HCQ, a blood test designed to help rheumatologists objectively monitor levels of hydroxychloroquine. The company was formerly known as Exagen Diagnostics, Inc. and changed its name to Exagen Inc. in January 2019. Exagen Inc. was incorporated in 2002 and is headquartered in Vista, California."
XGN,2019-12-31,2176000,-12013000,NA,-12038000,28702000,21579000,-9299000,-9299000,-3491000,25000,40387000,49686000,18808000,-2714000,NA,-12038000,-30279000,NA,income_statement,Diagnostics & Research,Exagen Inc.,"Exagen Inc. develops and commercializes various testing products based on its Cell-Bound Complement Activation Products technology under the AVISE brand in the United States. It enable rheumatologists to enhance care for patients through the diagnosis, prognosis, and monitoring of complex autoimmune and autoimmune related diseases, including systemic lupus erythematosus (SLE) and rheumatoid arthritis (RA). Its lead testing product is AVISE CTD that enables differential diagnosis for patients presenting with symptoms indicative of various connective tissue diseases (CTDs) and other related diseases with overlapping symptoms. The company's products also comprise AVISE Lupus that measures activation of the complement system by quantifying the level of B-cell C4d and erythrocyte bound C4d in the patient's blood; and AVISE APS, which consists of a panel of eight autoantibody tests that aids in the diagnosis and management of APS. In addition, it provides AVISE SLE Prognostic, a ten-biomarker panel of autoantibodies for assessing the potential for complications affecting the kidney, brain, and cardiovascular system; AVISE Anti-CarP test, which identifies RA patients with severe disease requiring aggressive therapy, such as anti-TNF biologics; and AVISE PC4d that measures platelet- bound C4d. Further, the company offers AVISE SLE Monitor, a six-biomarker blood test; AVISE MTX, a patented and validated blood test that measures levels of MTXPG; and AVISE HCQ, a blood test designed to help rheumatologists objectively monitor levels of hydroxychloroquine. The company was formerly known as Exagen Diagnostics, Inc. and changed its name to Exagen Inc. in January 2019. Exagen Inc. was incorporated in 2002 and is headquartered in Vista, California."
XLNX,2017-04-01,601443000,698076000,NA,628133000,335150000,1648110000,706390000,706390000,-53953000,69943000,2356742000,1650352000,708632000,-8314000,NA,628133000,628133000,NA,income_statement,NA,NA,NA
XLNX,2018-03-31,639750000,691379000,NA,463981000,362329000,1723604000,719373000,719373000,-45837000,227398000,2467023000,1747650000,743419000,-27994000,NA,463981000,463981000,NA,income_statement,NA,NA,NA
XLNX,2019-03-30,743027000,968332000,NA,889750000,398416000,2103172000,956799000,956799000,-52883000,78582000,3059040000,2102241000,955868000,11533000,NA,889750000,889750000,NA,income_statement,NA,NA,NA
XLNX,2020-03-28,853589000,833984000,NA,792721000,428108000,2137432000,824450000,824450000,-39820000,41263000,3162666000,2338216000,1025234000,9534000,NA,792721000,792721000,NA,income_statement,NA,NA,NA
XLRN,2016-12-31,NA,-56990000,NA,-57014000,29097000,-37009000,-66106000,-66106000,NA,24000,27771000,93877000,64780000,9116000,NA,-57014000,-57014000,NA,income_statement,Biotechnology,Acceleron Pharma Inc.,"Acceleron Pharma Inc., a biopharmaceutical company, focuses on the discovery, development, and commercialization of therapeutics to treat serious and rare diseases. It offers luspatercept-aamt for the treatment of anemia in adult patients with beta-thalassemia under the REBLOZYL name. The company also develops luspatercept-aamt for the treatment of myelodysplastic syndromes and myelofibrosis; Sotatercept for the treatment of patients with pulmonary arterial hypertension; and ACE-083, a neuromuscular candidate that is in Phase II clinical trials for the treatment of patients with Charcot-Marie-Tooth disease. In addition, it has a collaboration, license, and option agreement with Celgene Corporation; and collaboration and license agreement with Fulcrum Therapeutics, Inc. to identify small molecules designed to modulate specific pathways associated with a targeted indication within the pulmonary disease space. The company was formerly known as Phoenix Pharma, Inc. Acceleron Pharma Inc. was founded in 2003 and is headquartered in Cambridge, Massachusetts."
XLRN,2017-12-31,NA,-108422000,NA,-108454000,33738000,-76245000,-109983000,-109983000,NA,32000,13481000,123464000,89726000,1561000,NA,-108454000,-108454000,NA,income_statement,Biotechnology,Acceleron Pharma Inc.,"Acceleron Pharma Inc., a biopharmaceutical company, focuses on the discovery, development, and commercialization of therapeutics to treat serious and rare diseases. It offers luspatercept-aamt for the treatment of anemia in adult patients with beta-thalassemia under the REBLOZYL name. The company also develops luspatercept-aamt for the treatment of myelodysplastic syndromes and myelofibrosis; Sotatercept for the treatment of patients with pulmonary arterial hypertension; and ACE-083, a neuromuscular candidate that is in Phase II clinical trials for the treatment of patients with Charcot-Marie-Tooth disease. In addition, it has a collaboration, license, and option agreement with Celgene Corporation; and collaboration and license agreement with Fulcrum Therapeutics, Inc. to identify small molecules designed to modulate specific pathways associated with a targeted indication within the pulmonary disease space. The company was formerly known as Phoenix Pharma, Inc. Acceleron Pharma Inc. was founded in 2003 and is headquartered in Cambridge, Massachusetts."
XLRN,2018-12-31,NA,-118898000,NA,-118871000,34503000,-89911000,-124414000,-124414000,NA,-27000,13991000,138405000,103902000,5516000,NA,-118871000,-118871000,NA,income_statement,Biotechnology,Acceleron Pharma Inc.,"Acceleron Pharma Inc., a biopharmaceutical company, focuses on the discovery, development, and commercialization of therapeutics to treat serious and rare diseases. It offers luspatercept-aamt for the treatment of anemia in adult patients with beta-thalassemia under the REBLOZYL name. The company also develops luspatercept-aamt for the treatment of myelodysplastic syndromes and myelofibrosis; Sotatercept for the treatment of patients with pulmonary arterial hypertension; and ACE-083, a neuromuscular candidate that is in Phase II clinical trials for the treatment of patients with Charcot-Marie-Tooth disease. In addition, it has a collaboration, license, and option agreement with Celgene Corporation; and collaboration and license agreement with Fulcrum Therapeutics, Inc. to identify small molecules designed to modulate specific pathways associated with a targeted indication within the pulmonary disease space. The company was formerly known as Phoenix Pharma, Inc. Acceleron Pharma Inc. was founded in 2003 and is headquartered in Cambridge, Massachusetts."
XLRN,2019-12-31,NA,-124920000,NA,-124858000,56485000,-79960000,-136445000,-136445000,NA,-62000,73993000,210438000,153953000,11525000,NA,-124858000,-124858000,NA,income_statement,Biotechnology,Acceleron Pharma Inc.,"Acceleron Pharma Inc., a biopharmaceutical company, focuses on the discovery, development, and commercialization of therapeutics to treat serious and rare diseases. It offers luspatercept-aamt for the treatment of anemia in adult patients with beta-thalassemia under the REBLOZYL name. The company also develops luspatercept-aamt for the treatment of myelodysplastic syndromes and myelofibrosis; Sotatercept for the treatment of patients with pulmonary arterial hypertension; and ACE-083, a neuromuscular candidate that is in Phase II clinical trials for the treatment of patients with Charcot-Marie-Tooth disease. In addition, it has a collaboration, license, and option agreement with Celgene Corporation; and collaboration and license agreement with Fulcrum Therapeutics, Inc. to identify small molecules designed to modulate specific pathways associated with a targeted indication within the pulmonary disease space. The company was formerly known as Phoenix Pharma, Inc. Acceleron Pharma Inc. was founded in 2003 and is headquartered in Cambridge, Massachusetts."
XM,2016-12-31,22303000,-11009000,NA,-12034000,117768000,129623000,-10448000,-10448000,NA,1025000,190603000,201051000,60980000,-561000,NA,-12034000,-12034000,NA,income_statement,Software—Application,Elkhorn S&P MidCap Materials Po,"Qualtrics International Inc. provides an experience management platform for organizations to design, manage, and improve customer, employee, product, and brand experiences of businesses. The company offers Qualtrics XM Platform, a system of action that allows organizations to design new breakthrough experiences; a continuously improve broken experiences through identifying issues, addressing the root cause, and then overhauling processes before they manifest as lower trending satisfaction scores. The company's customer experience products include digital customer experience software and voice of the customer software; and employee experience products include employee engagement software, 360-degree feedback and performance review software, and employee pulse survey software, as well as offers design experience software. Its brand experience management products include brand tracking software and advertising testing tools; product experience management products include pricing research software, market segmentation software, and concept testing tool; and research services. The company also provides experience management (XM) platform products, including XM Directory, Qualtrics iQ, and xFlow; platform security products; and survey tolls. It serves organizations in retail, healthcare, financial services, travel and hospitality, B2B, government, media, airlines, and automotive industries worldwide. The company was founded in 2002 and is headquartered in Provo, Utah. As of January 23, 2019, Qualtrics International Inc. operates as a subsidiary of SAP America, Inc."
XM,2017-12-31,40680000,4463000,NA,2556000,167046000,210819000,3093000,3093000,NA,1907000,289903000,286810000,79084000,1370000,NA,2556000,39000,NA,income_statement,Software—Application,Elkhorn S&P MidCap Materials Po,"Qualtrics International Inc. provides an experience management platform for organizations to design, manage, and improve customer, employee, product, and brand experiences of businesses. The company offers Qualtrics XM Platform, a system of action that allows organizations to design new breakthrough experiences; a continuously improve broken experiences through identifying issues, addressing the root cause, and then overhauling processes before they manifest as lower trending satisfaction scores. The company's customer experience products include digital customer experience software and voice of the customer software; and employee experience products include employee engagement software, 360-degree feedback and performance review software, and employee pulse survey software, as well as offers design experience software. Its brand experience management products include brand tracking software and advertising testing tools; product experience management products include pricing research software, market segmentation software, and concept testing tool; and research services. The company also provides experience management (XM) platform products, including XM Directory, Qualtrics iQ, and xFlow; platform security products; and survey tolls. It serves organizations in retail, healthcare, financial services, travel and hospitality, B2B, government, media, airlines, and automotive industries worldwide. The company was founded in 2002 and is headquartered in Provo, Utah. As of January 23, 2019, Qualtrics International Inc. operates as a subsidiary of SAP America, Inc."
XM,2018-12-31,65925000,-32952000,NA,-37308000,266390000,299194000,-33121000,-33121000,NA,4356000,401908000,435029000,102714000,169000,NA,-37308000,-37308000,NA,income_statement,Software—Application,Elkhorn S&P MidCap Materials Po,"Qualtrics International Inc. provides an experience management platform for organizations to design, manage, and improve customer, employee, product, and brand experiences of businesses. The company offers Qualtrics XM Platform, a system of action that allows organizations to design new breakthrough experiences; a continuously improve broken experiences through identifying issues, addressing the root cause, and then overhauling processes before they manifest as lower trending satisfaction scores. The company's customer experience products include digital customer experience software and voice of the customer software; and employee experience products include employee engagement software, 360-degree feedback and performance review software, and employee pulse survey software, as well as offers design experience software. Its brand experience management products include brand tracking software and advertising testing tools; product experience management products include pricing research software, market segmentation software, and concept testing tool; and research services. The company also provides experience management (XM) platform products, including XM Directory, Qualtrics iQ, and xFlow; platform security products; and survey tolls. It serves organizations in retail, healthcare, financial services, travel and hospitality, B2B, government, media, airlines, and automotive industries worldwide. The company was founded in 2002 and is headquartered in Provo, Utah. As of January 23, 2019, Qualtrics International Inc. operates as a subsidiary of SAP America, Inc."
XM,2019-12-31,242124000,-994634000,NA,-1007633000,1157688000,405664000,-994148000,-994148000,NA,12999000,591155000,1585303000,185491000,-486000,NA,-1007633000,-1007633000,NA,income_statement,Software—Application,Elkhorn S&P MidCap Materials Po,"Qualtrics International Inc. provides an experience management platform for organizations to design, manage, and improve customer, employee, product, and brand experiences of businesses. The company offers Qualtrics XM Platform, a system of action that allows organizations to design new breakthrough experiences; a continuously improve broken experiences through identifying issues, addressing the root cause, and then overhauling processes before they manifest as lower trending satisfaction scores. The company's customer experience products include digital customer experience software and voice of the customer software; and employee experience products include employee engagement software, 360-degree feedback and performance review software, and employee pulse survey software, as well as offers design experience software. Its brand experience management products include brand tracking software and advertising testing tools; product experience management products include pricing research software, market segmentation software, and concept testing tool; and research services. The company also provides experience management (XM) platform products, including XM Directory, Qualtrics iQ, and xFlow; platform security products; and survey tolls. It serves organizations in retail, healthcare, financial services, travel and hospitality, B2B, government, media, airlines, and automotive industries worldwide. The company was founded in 2002 and is headquartered in Provo, Utah. As of January 23, 2019, Qualtrics International Inc. operates as a subsidiary of SAP America, Inc."
XNCR,2016-12-31,71772000,46116000,NA,45125000,12752000,57148000,44396000,44396000,-21000,991000,109020000,64624000,51872000,1720000,NA,45125000,45125000,NA,income_statement,Biotechnology,"Xencor, Inc.","Xencor, Inc., a clinical stage biopharmaceutical company, focuses on the discovery and development of engineered monoclonal antibody and other protein therapeutics to treat severe and life threatening diseases. It develops its antibody product candidates to treat cancer and autoimmune diseases. The company's product candidates include XmAb5871, an immune inhibitor, which has been completed Phase II clinical trial for the treatment of autoimmune diseases; AIMab7195, which is in development and commercialization stage. Its product candidates also comprise XmAb14045, a bispecific antibody which is in Phase I clinical trial for the treatment of acute myeloid leukemia; plamotamab (XmAb13676) that is in Phase I clinical trial to treat B-cell malignancies; and XmAb18087, which is in Phase I clinical trial for neuroendocrine tumors and gastrointestinal stromal tumors. In addition, the company offers Tafasitamab, an antibody drug candidate for the treatment of patients with relapsed/refractory diffuse; AMG424, a bispecific antibody that targets CD38 and CD3, which is in Phase I clinical trial for the treatment of various myeloma; and AMG509, a bispecific antibody that is in preclinical development stage to treat prostate cancer. Further, it is developing bispecific antibodies to treat various cancers, such as XmAb20717, XmAb22841, and XmAb23104 which are in preclinical Phase. Additionally, it offers XmAb24306, initial cytokine candidate which is in Phase I clinical trial. The company has collaboration and license agreement with Novartis Institutes for BioMedical Research, Inc.; Amgen Inc.; Catalent Pharma Solutions LLC.; Janssen Biotech, Inc.; MorphoSys AG; Incyte Corporation; and The University of Texas MD Anderson Cancer Center. Xencor, Inc. was founded in 1997 and is headquartered in Monrovia, California."
XNCR,2017-12-31,71772000,-38949000,NA,-38486000,17105000,-25622000,-42727000,-42727000,NA,-463000,46150000,88877000,71772000,3778000,NA,-38486000,-38486000,NA,income_statement,Biotechnology,"Xencor, Inc.","Xencor, Inc., a clinical stage biopharmaceutical company, focuses on the discovery and development of engineered monoclonal antibody and other protein therapeutics to treat severe and life threatening diseases. It develops its antibody product candidates to treat cancer and autoimmune diseases. The company's product candidates include XmAb5871, an immune inhibitor, which has been completed Phase II clinical trial for the treatment of autoimmune diseases; AIMab7195, which is in development and commercialization stage. Its product candidates also comprise XmAb14045, a bispecific antibody which is in Phase I clinical trial for the treatment of acute myeloid leukemia; plamotamab (XmAb13676) that is in Phase I clinical trial to treat B-cell malignancies; and XmAb18087, which is in Phase I clinical trial for neuroendocrine tumors and gastrointestinal stromal tumors. In addition, the company offers Tafasitamab, an antibody drug candidate for the treatment of patients with relapsed/refractory diffuse; AMG424, a bispecific antibody that targets CD38 and CD3, which is in Phase I clinical trial for the treatment of various myeloma; and AMG509, a bispecific antibody that is in preclinical development stage to treat prostate cancer. Further, it is developing bispecific antibodies to treat various cancers, such as XmAb20717, XmAb22841, and XmAb23104 which are in preclinical Phase. Additionally, it offers XmAb24306, initial cytokine candidate which is in Phase I clinical trial. The company has collaboration and license agreement with Novartis Institutes for BioMedical Research, Inc.; Amgen Inc.; Catalent Pharma Solutions LLC.; Janssen Biotech, Inc.; MorphoSys AG; Incyte Corporation; and The University of Texas MD Anderson Cancer Center. Xencor, Inc. was founded in 1997 and is headquartered in Monrovia, California."
XNCR,2018-12-31,NA,-70409000,NA,-70409000,22233000,-56898000,-79131000,-79131000,NA,0,40603000,119734000,97501000,8722000,NA,-70409000,-70409000,NA,income_statement,Biotechnology,"Xencor, Inc.","Xencor, Inc., a clinical stage biopharmaceutical company, focuses on the discovery and development of engineered monoclonal antibody and other protein therapeutics to treat severe and life threatening diseases. It develops its antibody product candidates to treat cancer and autoimmune diseases. The company's product candidates include XmAb5871, an immune inhibitor, which has been completed Phase II clinical trial for the treatment of autoimmune diseases; AIMab7195, which is in development and commercialization stage. Its product candidates also comprise XmAb14045, a bispecific antibody which is in Phase I clinical trial for the treatment of acute myeloid leukemia; plamotamab (XmAb13676) that is in Phase I clinical trial to treat B-cell malignancies; and XmAb18087, which is in Phase I clinical trial for neuroendocrine tumors and gastrointestinal stromal tumors. In addition, the company offers Tafasitamab, an antibody drug candidate for the treatment of patients with relapsed/refractory diffuse; AMG424, a bispecific antibody that targets CD38 and CD3, which is in Phase I clinical trial for the treatment of various myeloma; and AMG509, a bispecific antibody that is in preclinical development stage to treat prostate cancer. Further, it is developing bispecific antibodies to treat various cancers, such as XmAb20717, XmAb22841, and XmAb23104 which are in preclinical Phase. Additionally, it offers XmAb24306, initial cytokine candidate which is in Phase I clinical trial. The company has collaboration and license agreement with Novartis Institutes for BioMedical Research, Inc.; Amgen Inc.; Catalent Pharma Solutions LLC.; Janssen Biotech, Inc.; MorphoSys AG; Incyte Corporation; and The University of Texas MD Anderson Cancer Center. Xencor, Inc. was founded in 1997 and is headquartered in Monrovia, California."
XNCR,2019-12-31,NA,27187000,NA,26875000,24065000,38110000,14045000,14045000,NA,312000,156700000,142655000,118590000,13142000,NA,26875000,26875000,NA,income_statement,Biotechnology,"Xencor, Inc.","Xencor, Inc., a clinical stage biopharmaceutical company, focuses on the discovery and development of engineered monoclonal antibody and other protein therapeutics to treat severe and life threatening diseases. It develops its antibody product candidates to treat cancer and autoimmune diseases. The company's product candidates include XmAb5871, an immune inhibitor, which has been completed Phase II clinical trial for the treatment of autoimmune diseases; AIMab7195, which is in development and commercialization stage. Its product candidates also comprise XmAb14045, a bispecific antibody which is in Phase I clinical trial for the treatment of acute myeloid leukemia; plamotamab (XmAb13676) that is in Phase I clinical trial to treat B-cell malignancies; and XmAb18087, which is in Phase I clinical trial for neuroendocrine tumors and gastrointestinal stromal tumors. In addition, the company offers Tafasitamab, an antibody drug candidate for the treatment of patients with relapsed/refractory diffuse; AMG424, a bispecific antibody that targets CD38 and CD3, which is in Phase I clinical trial for the treatment of various myeloma; and AMG509, a bispecific antibody that is in preclinical development stage to treat prostate cancer. Further, it is developing bispecific antibodies to treat various cancers, such as XmAb20717, XmAb22841, and XmAb23104 which are in preclinical Phase. Additionally, it offers XmAb24306, initial cytokine candidate which is in Phase I clinical trial. The company has collaboration and license agreement with Novartis Institutes for BioMedical Research, Inc.; Amgen Inc.; Catalent Pharma Solutions LLC.; Janssen Biotech, Inc.; MorphoSys AG; Incyte Corporation; and The University of Texas MD Anderson Cancer Center. Xencor, Inc. was founded in 1997 and is headquartered in Monrovia, California."
XNET,2016-12-31,61169000,-33275000,-1988000,-24111000,38942000,60278000,-39833000,-39833000,-239000,-2469000,140206000,180039000,79928000,6558000,6623000,-30806000,-24111000,NA,income_statement,Advertising Agencies,Xunlei Limited,"Xunlei Limited operates an Internet platform for digital media content in the People's Republic of China. The company's platform is based on cloud technology that enables users to access, manage, and consume digital media content. It offers Xunlei Accelerator, which enables users to accelerate digital transmission over the Internet; mobile acceleration plug-in, which provides mobile device users with benefits of download speed acceleration and download success rate improvements; and cloud acceleration subscription services that offer users premium services through various products, such as Green Channel. The company also provides Mobile Xunlei, a mobile application that allows users to search, download, and consume digital media content on their mobile devices; Xunlei Media Player, which supports online and offline play of digital media content, as well as simultaneous play of digital media content while it is being transmitted by Xunlei Accelerator; online games through online game Website and mobile app; live video streaming and online advertising services; and cloud computing and other Internet value-added services. As of December 2019, its platform had approximately 88.3 million monthly unique visitors. The company was formerly known as Giganology Limited and changed its name to Xunlei Limited in January 2011. Xunlei Limited was founded in 2003 and is based in Shenzhen, the People's Republic of China."
XNET,2017-12-31,66947000,-46468000,-2160000,-37822000,56405000,84007000,-48068000,-48068000,-239000,-2252000,200583000,248651000,116576000,1600000,6407000,-44216000,-37822000,NA,income_statement,Advertising Agencies,Xunlei Limited,"Xunlei Limited operates an Internet platform for digital media content in the People's Republic of China. The company's platform is based on cloud technology that enables users to access, manage, and consume digital media content. It offers Xunlei Accelerator, which enables users to accelerate digital transmission over the Internet; mobile acceleration plug-in, which provides mobile device users with benefits of download speed acceleration and download success rate improvements; and cloud acceleration subscription services that offer users premium services through various products, such as Green Channel. The company also provides Mobile Xunlei, a mobile application that allows users to search, download, and consume digital media content on their mobile devices; Xunlei Media Player, which supports online and offline play of digital media content, as well as simultaneous play of digital media content while it is being transmitted by Xunlei Accelerator; online games through online game Website and mobile app; live video streaming and online advertising services; and cloud computing and other Internet value-added services. As of December 2019, its platform had approximately 88.3 million monthly unique visitors. The company was formerly known as Giganology Limited and changed its name to Xunlei Limited in January 2011. Xunlei Limited was founded in 2003 and is based in Shenzhen, the People's Republic of China."
XNET,2018-12-31,76763000,-40882000,-1116000,-39278000,76155000,114937000,-37981000,-37981000,-239000,-89000,230604000,268585000,115667000,-2901000,1303000,-40793000,-39278000,NA,income_statement,Advertising Agencies,Xunlei Limited,"Xunlei Limited operates an Internet platform for digital media content in the People's Republic of China. The company's platform is based on cloud technology that enables users to access, manage, and consume digital media content. It offers Xunlei Accelerator, which enables users to accelerate digital transmission over the Internet; mobile acceleration plug-in, which provides mobile device users with benefits of download speed acceleration and download success rate improvements; and cloud acceleration subscription services that offer users premium services through various products, such as Green Channel. The company also provides Mobile Xunlei, a mobile application that allows users to search, download, and consume digital media content on their mobile devices; Xunlei Media Player, which supports online and offline play of digital media content, as well as simultaneous play of digital media content while it is being transmitted by Xunlei Accelerator; online games through online game Website and mobile app; live video streaming and online advertising services; and cloud computing and other Internet value-added services. As of December 2019, its platform had approximately 88.3 million monthly unique visitors. The company was formerly known as Giganology Limited and changed its name to Xunlei Limited in January 2011. Xunlei Limited was founded in 2003 and is based in Shenzhen, the People's Republic of China."
XNET,2019-12-31,68571000,-48739000,-1335000,-53169000,68795000,80752000,-56614000,-56614000,-75000,4676000,180665000,237279000,99913000,7875000,NA,-53415000,-53169000,NA,income_statement,Advertising Agencies,Xunlei Limited,"Xunlei Limited operates an Internet platform for digital media content in the People's Republic of China. The company's platform is based on cloud technology that enables users to access, manage, and consume digital media content. It offers Xunlei Accelerator, which enables users to accelerate digital transmission over the Internet; mobile acceleration plug-in, which provides mobile device users with benefits of download speed acceleration and download success rate improvements; and cloud acceleration subscription services that offer users premium services through various products, such as Green Channel. The company also provides Mobile Xunlei, a mobile application that allows users to search, download, and consume digital media content on their mobile devices; Xunlei Media Player, which supports online and offline play of digital media content, as well as simultaneous play of digital media content while it is being transmitted by Xunlei Accelerator; online games through online game Website and mobile app; live video streaming and online advertising services; and cloud computing and other Internet value-added services. As of December 2019, its platform had approximately 88.3 million monthly unique visitors. The company was formerly known as Giganology Limited and changed its name to Xunlei Limited in January 2011. Xunlei Limited was founded in 2003 and is based in Shenzhen, the People's Republic of China."
XOG,2016-12-31,NA,-485281000,147872000,-456001000,232388000,195316000,-412289000,-412289000,-68843000,-29280000,257359000,669648000,62043000,-72992000,NA,-456001000,-230106000,110947000,income_statement,Oil & Gas E&P,"Extraction Oil & Gas, Inc.","Extraction Oil & Gas, Inc., an independent oil and gas company, focuses on the acquisition, development, and production of oil, natural gas, and natural gas liquid reserves in the Rocky Mountain region, primarily in the Wattenberg Field of the Denver-Julesburg (DJ) Basin of Colorado. The company also engages in the construction and support of midstream assets to gather, process, and produce crude oil and gas. As of December 31, 2019, it had approximately 169,900 net acres of contiguous acreage blocks in the productive areas of the DJ Basin; held approximately 125,500 net acres outside of the Core DJ Basin; had estimated proved reserves of approximately 254.1 MMBoe; and had 1,509 gross producing wells. The company was founded in 2012 and is headquartered in Denver, Colorado."
XOG,2017-12-31,NA,-108108000,147872000,-44408000,110167000,441623000,-56131000,-56131000,-51889000,-63700000,552929000,609060000,111306000,-51977000,NA,-44408000,-60687000,36332000,income_statement,Oil & Gas E&P,"Extraction Oil & Gas, Inc.","Extraction Oil & Gas, Inc., an independent oil and gas company, focuses on the acquisition, development, and production of oil, natural gas, and natural gas liquid reserves in the Rocky Mountain region, primarily in the Wattenberg Field of the Denver-Julesburg (DJ) Basin of Colorado. The company also engages in the construction and support of midstream assets to gather, process, and produce crude oil and gas. As of December 31, 2019, it had approximately 169,900 net acres of contiguous acreage blocks in the productive areas of the DJ Basin; held approximately 125,500 net acres outside of the Core DJ Basin; had estimated proved reserves of approximately 254.1 MMBoe; and had 1,509 gross producing wells. The company was founded in 2012 and is headquartered in Denver, Colorado."
XOG,2018-12-31,NA,188705000,147872000,114568000,134604000,851574000,224864000,224864000,-123330000,66850000,970398000,745534000,118824000,-36159000,NA,121855000,97699000,8554000,income_statement,Oil & Gas E&P,"Extraction Oil & Gas, Inc.","Extraction Oil & Gas, Inc., an independent oil and gas company, focuses on the acquisition, development, and production of oil, natural gas, and natural gas liquid reserves in the Rocky Mountain region, primarily in the Wattenberg Field of the Denver-Julesburg (DJ) Basin of Colorado. The company also engages in the construction and support of midstream assets to gather, process, and produce crude oil and gas. As of December 31, 2019, it had approximately 169,900 net acres of contiguous acreage blocks in the productive areas of the DJ Basin; held approximately 125,500 net acres outside of the Core DJ Basin; had estimated proved reserves of approximately 254.1 MMBoe; and had 1,509 gross producing wells. The company was founded in 2012 and is headquartered in Denver, Colorado."
XOG,2019-12-31,NA,-1476596000,264364000,-1387412000,96545000,685801000,-1399178000,-1399178000,-79232000,-109176000,838453000,2237631000,152652000,-77418000,NA,-1367420000,-1406848000,37107000,income_statement,Oil & Gas E&P,"Extraction Oil & Gas, Inc.","Extraction Oil & Gas, Inc., an independent oil and gas company, focuses on the acquisition, development, and production of oil, natural gas, and natural gas liquid reserves in the Rocky Mountain region, primarily in the Wattenberg Field of the Denver-Julesburg (DJ) Basin of Colorado. The company also engages in the construction and support of midstream assets to gather, process, and produce crude oil and gas. As of December 31, 2019, it had approximately 169,900 net acres of contiguous acreage blocks in the productive areas of the DJ Basin; held approximately 125,500 net acres outside of the Core DJ Basin; had estimated proved reserves of approximately 254.1 MMBoe; and had 1,509 gross producing wells. The company was founded in 2012 and is headquartered in Denver, Colorado."
XOM,2017-12-31,NA,18674000000,6812000000,19710000000,11893000000,78109000000,14074000000,14074000000,-601000000,-1174000000,237162000000,223088000000,159053000000,4600000000,NA,19848000000,19710000000,32459000000,income_statement,NA,NA,NA
XOM,2018-12-31,NA,30953000000,6734000000,20840000000,12300000000,88580000000,21539000000,21539000000,-766000000,9532000000,279332000000,257793000000,190752000000,9414000000,NA,21421000000,20840000000,35230000000,income_statement,NA,NA,NA
XOM,2019-12-31,NA,20056000000,7288000000,14340000000,12168000000,77152000000,11631000000,11631000000,-830000000,5282000000,255583000000,243952000000,178431000000,8425000000,NA,14774000000,14340000000,33186000000,income_statement,NA,NA,NA
XOM,2020-12-31,NA,-28883000000,NA,-22440000000,NA,827000000,-28883000000,-28883000000,NA,-5632000000,181502000000,210385000000,180675000000,0,NA,-23251000000,-22440000000,28425000000,income_statement,NA,NA,NA
XOMA,2016-12-31,42834000,-53530000,NA,-53530000,18322000,4164000,-56992000,-56992000,-3946000,0,5564000,62556000,1400000,3462000,NA,-53530000,-53530000,NA,income_statement,Biotechnology,XOMA Corporation,"XOMA Corporation, a biotech royalty aggregator, discovers and develops therapeutic candidates in the United States, Europe, and the Asia Pacific. The company has a pipeline of monoclonal antibodies and technologies to license to pharmaceutical and biotechnology companies to further their clinical development. Its proprietary product candidates include X213, an allosteric inhibitor of prolactin action; XMetA, an insulin receptor-activating antibody to provide long-acting reduction of hyperglycemia in Type 2 diabetic patients; IL-2, a therapy for metastatic melanoma and renal cell carcinoma; and PTH1R program, an anti-parathyroid receptor pipeline to address unmet medical needs, including primary hyperparathyroidism and humoral hypercalcemia of malignancy. The company also licenses antibody discovery, optimization, and development technologies. It has research and development collaboration agreements with Novartis Vaccines and Diagnostics, Inc.; Novartis Pharma AG; Novartis International Pharmaceutical Ltd.; Rezolute, Inc.; and Takeda Pharmaceutical Company Limited. XOMA Corporation was incorporated in 1981 and is headquartered in Emeryville, California."
XOMA,2017-12-31,NA,16258000,NA,14596000,24337000,44815000,20478000,20478000,-1238000,1662000,52690000,32212000,7875000,-4220000,NA,14596000,5714000,NA,income_statement,Biotechnology,XOMA Corporation,"XOMA Corporation, a biotech royalty aggregator, discovers and develops therapeutic candidates in the United States, Europe, and the Asia Pacific. The company has a pipeline of monoclonal antibodies and technologies to license to pharmaceutical and biotechnology companies to further their clinical development. Its proprietary product candidates include X213, an allosteric inhibitor of prolactin action; XMetA, an insulin receptor-activating antibody to provide long-acting reduction of hyperglycemia in Type 2 diabetic patients; IL-2, a therapy for metastatic melanoma and renal cell carcinoma; and PTH1R program, an anti-parathyroid receptor pipeline to address unmet medical needs, including primary hyperparathyroidism and humoral hypercalcemia of malignancy. The company also licenses antibody discovery, optimization, and development technologies. It has research and development collaboration agreements with Novartis Vaccines and Diagnostics, Inc.; Novartis Pharma AG; Novartis International Pharmaceutical Ltd.; Rezolute, Inc.; and Takeda Pharmaceutical Company Limited. XOMA Corporation was incorporated in 1981 and is headquartered in Emeryville, California."
XOMA,2018-12-31,NA,-13441000,NA,-13343000,18563000,3617000,-14946000,-14946000,-922000,-98000,5299000,20245000,1682000,1505000,NA,-13343000,-13343000,NA,income_statement,Biotechnology,XOMA Corporation,"XOMA Corporation, a biotech royalty aggregator, discovers and develops therapeutic candidates in the United States, Europe, and the Asia Pacific. The company has a pipeline of monoclonal antibodies and technologies to license to pharmaceutical and biotechnology companies to further their clinical development. Its proprietary product candidates include X213, an allosteric inhibitor of prolactin action; XMetA, an insulin receptor-activating antibody to provide long-acting reduction of hyperglycemia in Type 2 diabetic patients; IL-2, a therapy for metastatic melanoma and renal cell carcinoma; and PTH1R program, an anti-parathyroid receptor pipeline to address unmet medical needs, including primary hyperparathyroidism and humoral hypercalcemia of malignancy. The company also licenses antibody discovery, optimization, and development technologies. It has research and development collaboration agreements with Novartis Vaccines and Diagnostics, Inc.; Novartis Pharma AG; Novartis International Pharmaceutical Ltd.; Rezolute, Inc.; and Takeda Pharmaceutical Company Limited. XOMA Corporation was incorporated in 1981 and is headquartered in Emeryville, California."
XOMA,2019-12-31,NA,-1982000,NA,-1982000,20102000,17117000,-2985000,-2985000,-1919000,0,18370000,21355000,1253000,1003000,NA,-1982000,-1982000,NA,income_statement,Biotechnology,XOMA Corporation,"XOMA Corporation, a biotech royalty aggregator, discovers and develops therapeutic candidates in the United States, Europe, and the Asia Pacific. The company has a pipeline of monoclonal antibodies and technologies to license to pharmaceutical and biotechnology companies to further their clinical development. Its proprietary product candidates include X213, an allosteric inhibitor of prolactin action; XMetA, an insulin receptor-activating antibody to provide long-acting reduction of hyperglycemia in Type 2 diabetic patients; IL-2, a therapy for metastatic melanoma and renal cell carcinoma; and PTH1R program, an anti-parathyroid receptor pipeline to address unmet medical needs, including primary hyperparathyroidism and humoral hypercalcemia of malignancy. The company also licenses antibody discovery, optimization, and development technologies. It has research and development collaboration agreements with Novartis Vaccines and Diagnostics, Inc.; Novartis Pharma AG; Novartis International Pharmaceutical Ltd.; Rezolute, Inc.; and Takeda Pharmaceutical Company Limited. XOMA Corporation was incorporated in 1981 and is headquartered in Emeryville, California."
XONE,2016-12-31,7812000,-14531000,NA,-14598000,20683000,14291000,-14204000,-14204000,-298000,67000,47788000,61992000,33497000,-327000,NA,-14598000,-14598000,NA,income_statement,Specialty Industrial Machinery,The ExOne Company,"The ExOne Company develops, manufactures, and markets three-dimensional (3D) printing machines, 3D printed and other products, materials, and services to industrial customers primarily in the Americas, Europe, the Middle East, Africa, and Asia Pacific regions. The company manufactures and sells 3D printing machines that serves direct and indirect applications, including components and tools to produce a component; and offers pre-production collaboration and print products for customers. It also supplies associated materials comprising consumables and replacement parts; and other services, such as training and technical support services. The company markets its products to industrial customers under the ExOne brand name. The ExOne Company has a strategic partnership with Rapidia to enhance the company's portfolio and technical capabilities. The company was founded in 2005 and is headquartered in North Huntingdon, Pennsylvania."
XONE,2017-12-31,9909000,-19979000,NA,-20017000,23833000,14843000,-18899000,-18899000,-94000,38000,57744000,76643000,42901000,-1080000,NA,-20017000,-20017000,NA,income_statement,Specialty Industrial Machinery,The ExOne Company,"The ExOne Company develops, manufactures, and markets three-dimensional (3D) printing machines, 3D printed and other products, materials, and services to industrial customers primarily in the Americas, Europe, the Middle East, Africa, and Asia Pacific regions. The company manufactures and sells 3D printing machines that serves direct and indirect applications, including components and tools to produce a component; and offers pre-production collaboration and print products for customers. It also supplies associated materials comprising consumables and replacement parts; and other services, such as training and technical support services. The company markets its products to industrial customers under the ExOne brand name. The ExOne Company has a strategic partnership with Rapidia to enhance the company's portfolio and technical capabilities. The company was founded in 2005 and is headquartered in North Huntingdon, Pennsylvania."
XONE,2018-12-31,10744000,-12507000,NA,-12667000,22473000,21164000,-12053000,-12053000,-254000,160000,64644000,76697000,43480000,-454000,NA,-12667000,-12667000,NA,income_statement,Specialty Industrial Machinery,The ExOne Company,"The ExOne Company develops, manufactures, and markets three-dimensional (3D) printing machines, 3D printed and other products, materials, and services to industrial customers primarily in the Americas, Europe, the Middle East, Africa, and Asia Pacific regions. The company manufactures and sells 3D printing machines that serves direct and indirect applications, including components and tools to produce a component; and offers pre-production collaboration and print products for customers. It also supplies associated materials comprising consumables and replacement parts; and other services, such as training and technical support services. The company markets its products to industrial customers under the ExOne brand name. The ExOne Company has a strategic partnership with Rapidia to enhance the company's portfolio and technical capabilities. The company was founded in 2005 and is headquartered in North Huntingdon, Pennsylvania."
XONE,2019-12-31,9884000,-15502000,NA,-15095000,22592000,17428000,-15048000,-15048000,-343000,-407000,53276000,68324000,35848000,-454000,NA,-15095000,-15095000,NA,income_statement,Specialty Industrial Machinery,The ExOne Company,"The ExOne Company develops, manufactures, and markets three-dimensional (3D) printing machines, 3D printed and other products, materials, and services to industrial customers primarily in the Americas, Europe, the Middle East, Africa, and Asia Pacific regions. The company manufactures and sells 3D printing machines that serves direct and indirect applications, including components and tools to produce a component; and offers pre-production collaboration and print products for customers. It also supplies associated materials comprising consumables and replacement parts; and other services, such as training and technical support services. The company markets its products to industrial customers under the ExOne brand name. The ExOne Company has a strategic partnership with Rapidia to enhance the company's portfolio and technical capabilities. The company was founded in 2005 and is headquartered in North Huntingdon, Pennsylvania."
XP,2016-12-31,NA,373916000,49647000,188675000,488140000,875719000,375659000,375659000,-61093000,130151000,1251807000,876148000,376088000,-1743000,NA,243765000,188675000,11920000,income_statement,Capital Markets,XP Inc.,"XP Inc. operates technology-driven financial services platform that provides financial products and services in Brazil. It provides broker-dealer services for high-net worth customers and institutional clients; product structuring and capital markets services for corporate clients and issuers of fixed income products; advisory services for mass-affluent and institutional clients; and wealth management services for high-net-worth clients. The company also offers XP EducaÃ§Ã£o, an online financial education portal that offers seminars, classes, and learning tools to help teach individuals a range of topics, such as basics of investing, techniques, and investment strategies, as well as insurance brokerage services. In addition, it operates XP Platform, an open product platform that provides clients to access investment products in the market, including equity and fixed income securities, mutual and hedge funds, structured products, life insurance, pension plans, real-estate investment funds, and others. The company was founded in 2001 and is based in SÃ£o Paulo, Brazil."
XP,2017-12-31,NA,575507000,7923000,413874000,661027000,1326770000,657163000,657163000,-61093000,151966000,1906650000,1249487000,579880000,-81656000,NA,423541000,413874000,8580000,income_statement,Capital Markets,XP Inc.,"XP Inc. operates technology-driven financial services platform that provides financial products and services in Brazil. It provides broker-dealer services for high-net worth customers and institutional clients; product structuring and capital markets services for corporate clients and issuers of fixed income products; advisory services for mass-affluent and institutional clients; and wealth management services for high-net-worth clients. The company also offers XP EducaÃ§Ã£o, an online financial education portal that offers seminars, classes, and learning tools to help teach individuals a range of topics, such as basics of investing, techniques, and investment strategies, as well as insurance brokerage services. In addition, it operates XP Platform, an open product platform that provides clients to access investment products in the market, including equity and fixed income securities, mutual and hedge funds, structured products, life insurance, pension plans, real-estate investment funds, and others. The company was founded in 2001 and is based in SÃ£o Paulo, Brazil."
XP,2018-12-31,NA,640728000,6935000,461440000,1228935000,2017207000,740487000,740487000,-72310000,175398000,2958453000,2217966000,941246000,-99759000,NA,465330000,461440000,47785000,income_statement,Capital Markets,XP Inc.,"XP Inc. operates technology-driven financial services platform that provides financial products and services in Brazil. It provides broker-dealer services for high-net worth customers and institutional clients; product structuring and capital markets services for corporate clients and issuers of fixed income products; advisory services for mass-affluent and institutional clients; and wealth management services for high-net-worth clients. The company also offers XP EducaÃ§Ã£o, an online financial education portal that offers seminars, classes, and learning tools to help teach individuals a range of topics, such as basics of investing, techniques, and investment strategies, as well as insurance brokerage services. In addition, it operates XP Platform, an open product platform that provides clients to access investment products in the market, including equity and fixed income securities, mutual and hedge funds, structured products, life insurance, pension plans, real-estate investment funds, and others. The company was founded in 2001 and is based in SÃ£o Paulo, Brazil."
XP,2019-12-31,NA,1544109000,2563000,1080484000,2006905000,3521748000,1645068000,1645068000,-84400000,454625000,5127808000,3482740000,1606060000,-101959000,NA,1089484000,1080484000,-130225000,income_statement,Capital Markets,XP Inc.,"XP Inc. operates technology-driven financial services platform that provides financial products and services in Brazil. It provides broker-dealer services for high-net worth customers and institutional clients; product structuring and capital markets services for corporate clients and issuers of fixed income products; advisory services for mass-affluent and institutional clients; and wealth management services for high-net-worth clients. The company also offers XP EducaÃ§Ã£o, an online financial education portal that offers seminars, classes, and learning tools to help teach individuals a range of topics, such as basics of investing, techniques, and investment strategies, as well as insurance brokerage services. In addition, it operates XP Platform, an open product platform that provides clients to access investment products in the market, including equity and fixed income securities, mutual and hedge funds, structured products, life insurance, pension plans, real-estate investment funds, and others. The company was founded in 2001 and is based in SÃ£o Paulo, Brazil."
XPEL,2016-12-31,NA,3029575,-55179,2215502,10569731,14098083,3295147,3295147,-223045,866075,51759267,48464120,37661184,-265572,NA,2163500,2215502,233205,income_statement,Auto Parts,"XPEL, Inc.","XPEL, Inc. manufactures, sells, distributes, and installs after-market automotive products in the United States, China, Canada, Continental Europe, the United Kingdom, Asia Pacific, Latin America, the Middle East/Africa, and internationally. The company offers automotive surface and paint protection, headlight protection, and automotive and architectural window films, as well as proprietary software. It also provides merchandise and apparel, aftercare products, and ceramic coatings. In addition, the company offers paint protection kits, car wash products, after-care products, and installation tools through its website. It sells its products to independent installers and new car dealerships, third party distributors, owned installation centers, and franchisees and online. XPEL, Inc. was founded in 1999 and is headquartered in San Antonio, Texas."
XPEL,2017-12-31,NA,2148550,-188426,1047331,14472327,16683832,2211505,2211505,-328402,1154220,67297044,65085539,50613212,-62955,NA,994330,1047331,NA,income_statement,Auto Parts,"XPEL, Inc.","XPEL, Inc. manufactures, sells, distributes, and installs after-market automotive products in the United States, China, Canada, Continental Europe, the United Kingdom, Asia Pacific, Latin America, the Middle East/Africa, and internationally. The company offers automotive surface and paint protection, headlight protection, and automotive and architectural window films, as well as proprietary software. It also provides merchandise and apparel, aftercare products, and ceramic coatings. In addition, the company offers paint protection kits, car wash products, after-care products, and installation tools through its website. It sells its products to independent installers and new car dealerships, third party distributors, owned installation centers, and franchisees and online. XPEL, Inc. was founded in 1999 and is headquartered in San Antonio, Texas."
XPEL,2018-12-31,NA,11481305,-190029,8712534,21630602,33436605,11806003,11806003,-168389,2760073,109920614,98114611,76484009,-324698,NA,8721232,8712534,NA,income_statement,Auto Parts,"XPEL, Inc.","XPEL, Inc. manufactures, sells, distributes, and installs after-market automotive products in the United States, China, Canada, Continental Europe, the United Kingdom, Asia Pacific, Latin America, the Middle East/Africa, and internationally. The company offers automotive surface and paint protection, headlight protection, and automotive and architectural window films, as well as proprietary software. It also provides merchandise and apparel, aftercare products, and ceramic coatings. In addition, the company offers paint protection kits, car wash products, after-care products, and installation tools through its website. It sells its products to independent installers and new car dealerships, third party distributors, owned installation centers, and franchisees and online. XPEL, Inc. was founded in 1999 and is headquartered in San Antonio, Texas."
XPEL,2019-12-31,NA,16950428,-168680,13977625,26352548,43506259,17153711,17153711,-96646,2955356,129932881,112779170,86426622,-203283,NA,13995072,13977625,NA,income_statement,Auto Parts,"XPEL, Inc.","XPEL, Inc. manufactures, sells, distributes, and installs after-market automotive products in the United States, China, Canada, Continental Europe, the United Kingdom, Asia Pacific, Latin America, the Middle East/Africa, and internationally. The company offers automotive surface and paint protection, headlight protection, and automotive and architectural window films, as well as proprietary software. It also provides merchandise and apparel, aftercare products, and ceramic coatings. In addition, the company offers paint protection kits, car wash products, after-care products, and installation tools through its website. It sells its products to independent installers and new car dealerships, third party distributors, owned installation centers, and franchisees and online. XPEL, Inc. was founded in 1999 and is headquartered in San Antonio, Texas."
XPER,2016-12-31,44738000,90715000,-1295000,56089000,72065000,259014000,110341000,110341000,-2409000,34626000,259565000,149224000,551000,-19626000,NA,56089000,56089000,NA,income_statement,Semiconductor Equipment & Materials,Xperi Holding Corporation,"Xperi Holding Corporation invents, develops, and delivers various technologies worldwide. Its technologies that enable extraordinary experiences are integrated into consumer devices, media platforms, and semiconductors. The company provides its technologies under the DTS, HD Radio, IMAX Enhanced, Invensas, TiVo, and Perceive brands. It serves automotive, home solutions, mobile, pro audio and content solutions, semiconductor technologies, and intellectual property markets. The company is based in San Jose, California."
XPER,2017-12-31,105849000,-58343000,-1295000,-56558000,144649000,367424000,4996000,4996000,-28292000,-1785000,373732000,368736000,6308000,-63339000,NA,-56558000,-56558000,NA,income_statement,Semiconductor Equipment & Materials,Xperi Holding Corporation,"Xperi Holding Corporation invents, develops, and delivers various technologies worldwide. Its technologies that enable extraordinary experiences are integrated into consumer devices, media platforms, and semiconductors. The company provides its technologies under the DTS, HD Radio, IMAX Enhanced, Invensas, TiVo, and Perceive brands. It serves automotive, home solutions, mobile, pro audio and content solutions, semiconductor technologies, and intellectual property markets. The company is based in San Jose, California."
XPER,2018-12-31,106347000,6910000,-1295000,-289000,125455000,392842000,52590000,52590000,-25665000,8673000,406133000,353543000,13291000,-45680000,NA,-1763000,-289000,NA,income_statement,Semiconductor Equipment & Materials,Xperi Holding Corporation,"Xperi Holding Corporation invents, develops, and delivers various technologies worldwide. Its technologies that enable extraordinary experiences are integrated into consumer devices, media platforms, and semiconductors. The company provides its technologies under the DTS, HD Radio, IMAX Enhanced, Invensas, TiVo, and Perceive brands. It serves automotive, home solutions, mobile, pro audio and content solutions, semiconductor technologies, and intellectual property markets. The company is based in San Jose, California."
XPER,2019-12-31,112345000,-83057000,-2811000,-62530000,118261000,271607000,-58945000,-58945000,-23377000,-19024000,280067000,339012000,8460000,-24112000,NA,-64033000,-62530000,NA,income_statement,Semiconductor Equipment & Materials,Xperi Holding Corporation,"Xperi Holding Corporation invents, develops, and delivers various technologies worldwide. Its technologies that enable extraordinary experiences are integrated into consumer devices, media platforms, and semiconductors. The company provides its technologies under the DTS, HD Radio, IMAX Enhanced, Invensas, TiVo, and Perceive brands. It serves automotive, home solutions, mobile, pro audio and content solutions, semiconductor technologies, and intellectual property markets. The company is based in San Jose, California."
XRAY,2016-12-31,128500000,440900000,11600000,429900000,1373600000,2000900000,498800000,498800000,-35900000,9500000,3745300000,3246500000,1744400000,-57900000,NA,431400000,429900000,5300000,income_statement,NA,NA,NA
XRAY,2017-12-31,151700000,-1603500000,11600000,-1550000000,1532200000,2188500000,504600000,504600000,-38300000,-53200000,3993400000,3488800000,1804900000,-2108100000,NA,-1550300000,-1550000000,5300000,income_statement,NA,NA,NA
XRAY,2018-12-31,160500000,-958400000,11900000,-1011000000,1538300000,2067800000,341900000,341900000,-37300000,52500000,3986300000,3644400000,1918500000,-1300300000,NA,-1010900000,-1011000000,5300000,income_statement,NA,NA,NA
XRAY,2019-12-31,131300000,345400000,2400000,262900000,1492000000,2190400000,526300000,526300000,-29400000,82300000,4029200000,3502900000,1838800000,-180900000,NA,263100000,262900000,5300000,income_statement,NA,NA,NA
XRX,2017-12-31,424000000,538000000,37000000,195000000,2702000000,4071000000,892000000,892000000,-119000000,468000000,9991000000,9099000000,5920000000,-354000000,129000000,70000000,181000000,NA,income_statement,NA,NA,NA
XRX,2018-12-31,397000000,557000000,34000000,361000000,2485000000,3869000000,939000000,939000000,-114000000,247000000,9662000000,8723000000,5793000000,-382000000,55000000,310000000,347000000,NA,income_statement,NA,NA,NA
XRX,2019-12-31,373000000,830000000,7000000,1353000000,2103000000,3650000000,1129000000,1129000000,-105000000,179000000,9066000000,7937000000,5416000000,-299000000,705000000,651000000,1339000000,NA,income_statement,NA,NA,NA
XRX,2020-12-31,311000000,256000000,4000000,192000000,1851000000,2626000000,408000000,408000000,NA,64000000,7022000000,6614000000,4396000000,-152000000,NA,192000000,178000000,NA,income_statement,NA,NA,NA
XSPA,2016-12-31,NA,-19279000,4641000,-24006000,8349000,5248000,-4418000,-4418000,-1698000,0,11986000,16404000,6738000,-14861000,-4724000,-19279000,-24006000,NA,income_statement,Personal Services,"XpresSpa Group, Inc.","XpresSpa Group, Inc., a health and wellness services company, provides spa services and related products at airports. The company offers massage services for the neck, back, feet, and whole body; nail care, including pedicures, manicures, and polish changes; travel products, such as neck pillows, blankets, and massage tools; and cryotherapy services, compression services, and personal care services, as well as retail products. As of January 20, 2021, it provided its services through 45 locations in 23 airports worldwide. XpresSpa Group, Inc., through its subsidiary XpresTest, Inc., provides COVID-19 screening and testing, and rapid testing services for other communicable diseases, such as influenza, mononucleosis and group A streptococcus, and flu vaccination services under the XpresCheck brand. The company was formerly known as FORM Holdings Corp. and changed its name to XpresSpa Group, Inc. in January 2018. XpresSpa Group, Inc. is headquartered in New York, New York."
XSPA,2017-12-31,NA,-16001000,4956000,-28840000,24198000,17458000,-14716000,-14716000,-731000,111000,48823000,63539000,31365000,-1285000,-12277000,-16112000,-28840000,NA,income_statement,Personal Services,"XpresSpa Group, Inc.","XpresSpa Group, Inc., a health and wellness services company, provides spa services and related products at airports. The company offers massage services for the neck, back, feet, and whole body; nail care, including pedicures, manicures, and polish changes; travel products, such as neck pillows, blankets, and massage tools; and cryotherapy services, compression services, and personal care services, as well as retail products. As of January 20, 2021, it provided its services through 45 locations in 23 airports worldwide. XpresSpa Group, Inc., through its subsidiary XpresTest, Inc., provides COVID-19 screening and testing, and rapid testing services for other communicable diseases, such as influenza, mononucleosis and group A streptococcus, and flu vaccination services under the XpresCheck brand. The company was formerly known as FORM Holdings Corp. and changed its name to XpresSpa Group, Inc. in January 2018. XpresSpa Group, Inc. is headquartered in New York, New York."
XSPA,2018-12-31,NA,-35909000,4029000,-37205000,23649000,18311000,-12736000,-12736000,-1827000,-278000,49644000,62380000,31333000,-23173000,-1115000,-35631000,-37205000,NA,income_statement,Personal Services,"XpresSpa Group, Inc.","XpresSpa Group, Inc., a health and wellness services company, provides spa services and related products at airports. The company offers massage services for the neck, back, feet, and whole body; nail care, including pedicures, manicures, and polish changes; travel products, such as neck pillows, blankets, and massage tools; and cryotherapy services, compression services, and personal care services, as well as retail products. As of January 20, 2021, it provided its services through 45 locations in 23 airports worldwide. XpresSpa Group, Inc., through its subsidiary XpresTest, Inc., provides COVID-19 screening and testing, and rapid testing services for other communicable diseases, such as influenza, mononucleosis and group A streptococcus, and flu vaccination services under the XpresCheck brand. The company was formerly known as FORM Holdings Corp. and changed its name to XpresSpa Group, Inc. in January 2018. XpresSpa Group, Inc. is headquartered in New York, New York."
XSPA,2019-12-31,NA,-20676000,3703000,-21223000,20750000,17392000,-9482000,-9482000,-2900000,-146000,47415000,56897000,30023000,-11194000,NA,-20530000,-21223000,NA,income_statement,Personal Services,"XpresSpa Group, Inc.","XpresSpa Group, Inc., a health and wellness services company, provides spa services and related products at airports. The company offers massage services for the neck, back, feet, and whole body; nail care, including pedicures, manicures, and polish changes; travel products, such as neck pillows, blankets, and massage tools; and cryotherapy services, compression services, and personal care services, as well as retail products. As of January 20, 2021, it provided its services through 45 locations in 23 airports worldwide. XpresSpa Group, Inc., through its subsidiary XpresTest, Inc., provides COVID-19 screening and testing, and rapid testing services for other communicable diseases, such as influenza, mononucleosis and group A streptococcus, and flu vaccination services under the XpresCheck brand. The company was formerly known as FORM Holdings Corp. and changed its name to XpresSpa Group, Inc. in January 2018. XpresSpa Group, Inc. is headquartered in New York, New York."
XTLB,2016-12-31,443000,-2545000,NA,-2545000,1270000,-5000,-1713000,-1713000,NA,0,0,1713000,5000,-832000,NA,-2545000,-2545000,NA,income_statement,Biotechnology,XTL Biopharmaceuticals Ltd.,"XTL Biopharmaceuticals Ltd., a biopharmaceutical company, engages in the acquisition and development of pharmaceutical products for the treatment of autoimmune diseases. Its lead drug candidate is hCDR1, a Phase II-ready asset for the treatment of systemic lupus erythematosus and Sjogren's syndrome. XTL Biopharmaceuticals Ltd. has a licensing agreement with Yeda Research and Development Company Limited for the research, development, and commercialization of hCDR1 for various indications. The company was formerly known as Xenograft Technologies Ltd. and changed its name to XTL Biopharmaceuticals Ltd. in July 1995. XTL Biopharmaceuticals Ltd. was founded in 1993 and is headquartered in Ramat Gan, Israel."
XTLB,2017-12-31,43000,-781000,NA,-781000,1203000,0,-1246000,-1246000,NA,0,0,1246000,0,465000,NA,-781000,-781000,NA,income_statement,Biotechnology,XTL Biopharmaceuticals Ltd.,"XTL Biopharmaceuticals Ltd., a biopharmaceutical company, engages in the acquisition and development of pharmaceutical products for the treatment of autoimmune diseases. Its lead drug candidate is hCDR1, a Phase II-ready asset for the treatment of systemic lupus erythematosus and Sjogren's syndrome. XTL Biopharmaceuticals Ltd. has a licensing agreement with Yeda Research and Development Company Limited for the research, development, and commercialization of hCDR1 for various indications. The company was formerly known as Xenograft Technologies Ltd. and changed its name to XTL Biopharmaceuticals Ltd. in July 1995. XTL Biopharmaceuticals Ltd. was founded in 1993 and is headquartered in Ramat Gan, Israel."
XTLB,2018-12-31,38000,2986000,NA,2986000,755000,0,-793000,-793000,NA,0,0,793000,0,3779000,NA,2986000,2986000,NA,income_statement,Biotechnology,XTL Biopharmaceuticals Ltd.,"XTL Biopharmaceuticals Ltd., a biopharmaceutical company, engages in the acquisition and development of pharmaceutical products for the treatment of autoimmune diseases. Its lead drug candidate is hCDR1, a Phase II-ready asset for the treatment of systemic lupus erythematosus and Sjogren's syndrome. XTL Biopharmaceuticals Ltd. has a licensing agreement with Yeda Research and Development Company Limited for the research, development, and commercialization of hCDR1 for various indications. The company was formerly known as Xenograft Technologies Ltd. and changed its name to XTL Biopharmaceuticals Ltd. in July 1995. XTL Biopharmaceuticals Ltd. was founded in 1993 and is headquartered in Ramat Gan, Israel."
XTLB,2019-12-31,35000,-1347000,NA,-1347000,807000,0,-842000,-842000,NA,0,0,842000,0,-505000,NA,-1347000,-1347000,NA,income_statement,Biotechnology,XTL Biopharmaceuticals Ltd.,"XTL Biopharmaceuticals Ltd., a biopharmaceutical company, engages in the acquisition and development of pharmaceutical products for the treatment of autoimmune diseases. Its lead drug candidate is hCDR1, a Phase II-ready asset for the treatment of systemic lupus erythematosus and Sjogren's syndrome. XTL Biopharmaceuticals Ltd. has a licensing agreement with Yeda Research and Development Company Limited for the research, development, and commercialization of hCDR1 for various indications. The company was formerly known as Xenograft Technologies Ltd. and changed its name to XTL Biopharmaceuticals Ltd. in July 1995. XTL Biopharmaceuticals Ltd. was founded in 1993 and is headquartered in Ramat Gan, Israel."
XYL,2017-12-31,181000000,466000000,16000000,331000000,1086000000,1847000000,580000000,580000000,-82000000,136000000,4707000000,4127000000,2860000000,-114000000,NA,330000000,331000000,NA,income_statement,NA,NA,NA
XYL,2018-12-31,189000000,585000000,14000000,549000000,1150000000,2031000000,692000000,692000000,-82000000,36000000,5207000000,4515000000,3176000000,-107000000,NA,549000000,549000000,NA,income_statement,NA,NA,NA
XYL,2019-12-31,191000000,416000000,10000000,401000000,1165000000,2051000000,695000000,695000000,-67000000,15000000,5249000000,4554000000,3198000000,-279000000,NA,401000000,401000000,NA,income_statement,NA,NA,NA
XYL,2020-12-31,187000000,285000000,8000000,254000000,1143000000,1830000000,500000000,500000000,-77000000,31000000,4876000000,4376000000,3046000000,-215000000,NA,254000000,254000000,NA,income_statement,NA,NA,NA
YELL,2017-12-31,NA,-18100000,NA,-10800000,NA,491200000,97800000,97800000,-102800000,-7300000,4891000000,4793200000,4399800000,-115900000,NA,-10800000,-10800000,245700000,income_statement,Trucking,Yellow Corporation,"Yellow Corporation, through its subsidiaries, provides a range of transportation services primarily in North America. It primarily offers less-than-truckload (LTL) shipments and supply chain solutions. The company provides various services to transport industrial, commercial, and retail goods; next-day ground services; customer-specific logistics solutions, including truckload, residential, and warehouse solutions. It also offers specialized services, such as guaranteed expedited, time-specific delivery, cross-border, coast-to-coast air delivery, exhibit, product return, temperature-sensitive shipment protection, and government material shipment services. In addition, the company provides consolidation and distribution, reverse logistics, and residential white glove services. As of December 31, 2020, it had a fleet of approximately 13,500 tractors comprising 10,400 owned and 3,100 leased tractors; and 41,900 trailers consisting of 29,600 owned and 12,300 leased trailers. The company was formerly known as YRC Worldwide Inc. and changed its name to Yellow Corporation in February 2021. Yellow Corporation was founded in 1924 and is headquartered in Overland Park, Kansas."
YELL,2018-12-31,NA,31300000,NA,20200000,NA,509200000,112700000,112700000,-105800000,11100000,5092000000,4979300000,4582800000,-81400000,NA,20200000,20200000,248800000,income_statement,Trucking,Yellow Corporation,"Yellow Corporation, through its subsidiaries, provides a range of transportation services primarily in North America. It primarily offers less-than-truckload (LTL) shipments and supply chain solutions. The company provides various services to transport industrial, commercial, and retail goods; next-day ground services; customer-specific logistics solutions, including truckload, residential, and warehouse solutions. It also offers specialized services, such as guaranteed expedited, time-specific delivery, cross-border, coast-to-coast air delivery, exhibit, product return, temperature-sensitive shipment protection, and government material shipment services. In addition, the company provides consolidation and distribution, reverse logistics, and residential white glove services. As of December 31, 2020, it had a fleet of approximately 13,500 tractors comprising 10,400 owned and 3,100 leased tractors; and 41,900 trailers consisting of 29,600 owned and 12,300 leased trailers. The company was formerly known as YRC Worldwide Inc. and changed its name to Yellow Corporation in February 2021. Yellow Corporation was founded in 1924 and is headquartered in Overland Park, Kansas."
YELL,2019-12-31,NA,-108300000,NA,-104000000,NA,401200000,7600000,7600000,-111200000,-4300000,4871200000,4863600000,4470000000,-115900000,NA,-104000000,-104000000,241200000,income_statement,Trucking,Yellow Corporation,"Yellow Corporation, through its subsidiaries, provides a range of transportation services primarily in North America. It primarily offers less-than-truckload (LTL) shipments and supply chain solutions. The company provides various services to transport industrial, commercial, and retail goods; next-day ground services; customer-specific logistics solutions, including truckload, residential, and warehouse solutions. It also offers specialized services, such as guaranteed expedited, time-specific delivery, cross-border, coast-to-coast air delivery, exhibit, product return, temperature-sensitive shipment protection, and government material shipment services. In addition, the company provides consolidation and distribution, reverse logistics, and residential white glove services. As of December 31, 2020, it had a fleet of approximately 13,500 tractors comprising 10,400 owned and 3,100 leased tractors; and 41,900 trailers consisting of 29,600 owned and 12,300 leased trailers. The company was formerly known as YRC Worldwide Inc. and changed its name to Yellow Corporation in February 2021. Yellow Corporation was founded in 1924 and is headquartered in Overland Park, Kansas."
YELL,2020-12-31,NA,-73100000,NA,-53500000,NA,392000000,17500000,17500000,-135900000,-19600000,4513700000,4496200000,4121700000,-90600000,NA,-53500000,-53500000,239600000,income_statement,Trucking,Yellow Corporation,"Yellow Corporation, through its subsidiaries, provides a range of transportation services primarily in North America. It primarily offers less-than-truckload (LTL) shipments and supply chain solutions. The company provides various services to transport industrial, commercial, and retail goods; next-day ground services; customer-specific logistics solutions, including truckload, residential, and warehouse solutions. It also offers specialized services, such as guaranteed expedited, time-specific delivery, cross-border, coast-to-coast air delivery, exhibit, product return, temperature-sensitive shipment protection, and government material shipment services. In addition, the company provides consolidation and distribution, reverse logistics, and residential white glove services. As of December 31, 2020, it had a fleet of approximately 13,500 tractors comprising 10,400 owned and 3,100 leased tractors; and 41,900 trailers consisting of 29,600 owned and 12,300 leased trailers. The company was formerly known as YRC Worldwide Inc. and changed its name to Yellow Corporation in February 2021. Yellow Corporation was founded in 1924 and is headquartered in Overland Park, Kansas."
YGMZ,2017-12-31,NA,1926355,NA,1238090,1492277,3809753,2317476,2317476,-289967,688265,20616011,18298535,16806258,-391121,NA,1238090,1238090,NA,income_statement,Trucking,MingZhu Logistics Holdings Limi,"MingZhu Logistics Holdings Limited, through its subsidiaries, provides trucking and delivery services using its truckload fleet and subcontractors in the People's Republic of China. The company provides dedicated truckload services to sizeable logistics companies, freight forwarders, and warehouse operators. It operates a truckload fleet with 132 tractors and 90 trailers. MingZhu Logistics Holdings Limited was founded in 2002 and is based in Shenzhen, China."
YGMZ,2018-12-31,NA,3860915,NA,2854887,1212957,5247723,4034766,4034766,-355332,1006028,27646789,23612023,22399066,-173851,NA,2854887,2854887,NA,income_statement,Trucking,MingZhu Logistics Holdings Limi,"MingZhu Logistics Holdings Limited, through its subsidiaries, provides trucking and delivery services using its truckload fleet and subcontractors in the People's Republic of China. The company provides dedicated truckload services to sizeable logistics companies, freight forwarders, and warehouse operators. It operates a truckload fleet with 132 tractors and 90 trailers. MingZhu Logistics Holdings Limited was founded in 2002 and is based in Shenzhen, China."
YGMZ,2019-12-31,NA,2464044,NA,1642794,1377028,4052094,2675066,2675066,-370682,821250,29410550,26735484,25358456,-211022,NA,1642794,1642794,NA,income_statement,Trucking,MingZhu Logistics Holdings Limi,"MingZhu Logistics Holdings Limited, through its subsidiaries, provides trucking and delivery services using its truckload fleet and subcontractors in the People's Republic of China. The company provides dedicated truckload services to sizeable logistics companies, freight forwarders, and warehouse operators. It operates a truckload fleet with 132 tractors and 90 trailers. MingZhu Logistics Holdings Limited was founded in 2002 and is based in Shenzhen, China."
YI,2016-12-31,61767000,-363446000,2185000,-362681000,313665000,9162000,-364280000,-364280000,-751000,0,873837000,1238117000,864675000,834000,NA,-363446000,-417962000,-1990000,income_statement,Pharmaceutical Retailers,"111, Inc.","111, Inc., through its subsidiaries, operates an integrated online and offline platform in the healthcare market in the People's Republic of China. It operates through two segments, B2B and B2C. The company sells medical and wellness products through online retail, and wholesale and retail pharmacies, as well as provides value-added services, such as online consultation services and e-prescription services to consumers. Its product portfolio comprises prescription and over-the counter drugs, such as western and traditional Chinese medicinal drugs; nutritional supplements, such as vitamins and dietary products; contact lenses; medical supplies and devices, including bandages and thermometers; and personal care products, such as skin care, birth control, and sexual wellness products; and baby products. The company also operates an online marketplace where third-party sellers can directly sell to pharmacies; provides online loan application services to the clients of 1 Drug Mall, including pharmacies and wholesalers; and digital contract sales organization and data services. As of December 31, 2019, it operated 12 offline retail pharmacies under the Yi Hao Pharmacy brand name in Guangzhou, Shanghai, Tianjin, and Kunshan. In addition, the company offers warehousing, logistics, procurement, research and development, and consulting services; and software development and information technology support services. It serves pharmacies, pharmaceutical companies and distributors, medical professionals, and insurance companies. 111, Inc. has a strategic partnership with Bayer Healthcare Co. Ltd. to develop a digitalized content portal that would provide online pharmacist training and interactive patient education content and services. The company was formerly known as New Peak Group and changed its name to 111, Inc. in April 2018. 111, Inc. was founded in 2010 and is headquartered in Shanghai, the People's Republic of China."
YI,2017-12-31,48133000,-249327000,1438000,-248580000,243508000,34887000,-254022000,-254022000,-55000,0,959486000,1213508000,924599000,4695000,NA,-249327000,-248580000,-2732000,income_statement,Pharmaceutical Retailers,"111, Inc.","111, Inc., through its subsidiaries, operates an integrated online and offline platform in the healthcare market in the People's Republic of China. It operates through two segments, B2B and B2C. The company sells medical and wellness products through online retail, and wholesale and retail pharmacies, as well as provides value-added services, such as online consultation services and e-prescription services to consumers. Its product portfolio comprises prescription and over-the counter drugs, such as western and traditional Chinese medicinal drugs; nutritional supplements, such as vitamins and dietary products; contact lenses; medical supplies and devices, including bandages and thermometers; and personal care products, such as skin care, birth control, and sexual wellness products; and baby products. The company also operates an online marketplace where third-party sellers can directly sell to pharmacies; provides online loan application services to the clients of 1 Drug Mall, including pharmacies and wholesalers; and digital contract sales organization and data services. As of December 31, 2019, it operated 12 offline retail pharmacies under the Yi Hao Pharmacy brand name in Guangzhou, Shanghai, Tianjin, and Kunshan. In addition, the company offers warehousing, logistics, procurement, research and development, and consulting services; and software development and information technology support services. It serves pharmacies, pharmaceutical companies and distributors, medical professionals, and insurance companies. 111, Inc. has a strategic partnership with Bayer Healthcare Co. Ltd. to develop a digitalized content portal that would provide online pharmacist training and interactive patient education content and services. The company was formerly known as New Peak Group and changed its name to 111, Inc. in April 2018. 111, Inc. was founded in 2010 and is headquartered in Shanghai, the People's Republic of China."
YI,2018-12-31,71248000,-382033000,-512000,-380091000,358799000,30340000,-400375000,-400375000,-3622000,8000,1785970000,2186345000,1755630000,18342000,NA,-382041000,-380091000,668000,income_statement,Pharmaceutical Retailers,"111, Inc.","111, Inc., through its subsidiaries, operates an integrated online and offline platform in the healthcare market in the People's Republic of China. It operates through two segments, B2B and B2C. The company sells medical and wellness products through online retail, and wholesale and retail pharmacies, as well as provides value-added services, such as online consultation services and e-prescription services to consumers. Its product portfolio comprises prescription and over-the counter drugs, such as western and traditional Chinese medicinal drugs; nutritional supplements, such as vitamins and dietary products; contact lenses; medical supplies and devices, including bandages and thermometers; and personal care products, such as skin care, birth control, and sexual wellness products; and baby products. The company also operates an online marketplace where third-party sellers can directly sell to pharmacies; provides online loan application services to the clients of 1 Drug Mall, including pharmacies and wholesalers; and digital contract sales organization and data services. As of December 31, 2019, it operated 12 offline retail pharmacies under the Yi Hao Pharmacy brand name in Guangzhou, Shanghai, Tianjin, and Kunshan. In addition, the company offers warehousing, logistics, procurement, research and development, and consulting services; and software development and information technology support services. It serves pharmacies, pharmaceutical companies and distributors, medical professionals, and insurance companies. 111, Inc. has a strategic partnership with Bayer Healthcare Co. Ltd. to develop a digitalized content portal that would provide online pharmacist training and interactive patient education content and services. The company was formerly known as New Peak Group and changed its name to 111, Inc. in April 2018. 111, Inc. was founded in 2010 and is headquartered in Shanghai, the People's Republic of China."
YI,2019-12-31,61902000,-501827000,-2733000,-499606000,464063000,36187000,-493513000,-493513000,-3622000,0,3952053000,4445566000,3915866000,-8314000,NA,-501827000,-499606000,3735000,income_statement,Pharmaceutical Retailers,"111, Inc.","111, Inc., through its subsidiaries, operates an integrated online and offline platform in the healthcare market in the People's Republic of China. It operates through two segments, B2B and B2C. The company sells medical and wellness products through online retail, and wholesale and retail pharmacies, as well as provides value-added services, such as online consultation services and e-prescription services to consumers. Its product portfolio comprises prescription and over-the counter drugs, such as western and traditional Chinese medicinal drugs; nutritional supplements, such as vitamins and dietary products; contact lenses; medical supplies and devices, including bandages and thermometers; and personal care products, such as skin care, birth control, and sexual wellness products; and baby products. The company also operates an online marketplace where third-party sellers can directly sell to pharmacies; provides online loan application services to the clients of 1 Drug Mall, including pharmacies and wholesalers; and digital contract sales organization and data services. As of December 31, 2019, it operated 12 offline retail pharmacies under the Yi Hao Pharmacy brand name in Guangzhou, Shanghai, Tianjin, and Kunshan. In addition, the company offers warehousing, logistics, procurement, research and development, and consulting services; and software development and information technology support services. It serves pharmacies, pharmaceutical companies and distributors, medical professionals, and insurance companies. 111, Inc. has a strategic partnership with Bayer Healthcare Co. Ltd. to develop a digitalized content portal that would provide online pharmacist training and interactive patient education content and services. The company was formerly known as New Peak Group and changed its name to 111, Inc. in April 2018. 111, Inc. was founded in 2010 and is headquartered in Shanghai, the People's Republic of China."
YJ,2016-12-31,18207000,-45218000,6362000,-24668000,334606000,305756000,-47057000,-47057000,-98000,-20550000,1284444000,1331501000,978688000,1839000,NA,-24668000,-101715000,-25047000,income_statement,Internet Retail,Yunji Inc. - American Depositor,"Yunji Inc. operates a social e-commerce platform in the People's Republic of China. It offers a range of product categories that cater various daily needs of users and their households, including beauty and personal care, household goods, cloths, food and fresh produce, computer and electronics, apparel, bags and cases, baby and maternity products, and home appliances. The company was founded in 2015 and is headquartered in Hangzhou, the People's Republic of China."
YJ,2017-12-31,58159000,-109055000,6362000,-105724000,1327298000,1271229000,-114228000,-114228000,NA,-3331000,6444071000,6558299000,5172842000,5173000,NA,-105724000,-1734380000,-25047000,income_statement,Internet Retail,Yunji Inc. - American Depositor,"Yunji Inc. operates a social e-commerce platform in the People's Republic of China. It offers a range of product categories that cater various daily needs of users and their households, including beauty and personal care, household goods, cloths, food and fresh produce, computer and electronics, apparel, bags and cases, baby and maternity products, and home appliances. The company was founded in 2015 and is headquartered in Hangzhou, the People's Republic of China."
YJ,2018-12-31,143645000,-43980000,6362000,-59688000,2264387000,2308629000,-99403000,-99403000,NA,12346000,13015225000,13114628000,10706596000,55423000,NA,-56326000,-2308010000,-25047000,income_statement,Internet Retail,Yunji Inc. - American Depositor,"Yunji Inc. operates a social e-commerce platform in the People's Republic of China. It offers a range of product categories that cater various daily needs of users and their households, including beauty and personal care, household goods, cloths, food and fresh produce, computer and electronics, apparel, bags and cases, baby and maternity products, and home appliances. The company was founded in 2015 and is headquartered in Hangzhou, the People's Republic of China."
YJ,2019-12-31,315167000,-140554000,10690000,-125762000,2430832000,2422550000,-298402000,-298402000,NA,-16720000,11672024000,11970426000,9249474000,157848000,NA,-123834000,-1657775000,-25047000,income_statement,Internet Retail,Yunji Inc. - American Depositor,"Yunji Inc. operates a social e-commerce platform in the People's Republic of China. It offers a range of product categories that cater various daily needs of users and their households, including beauty and personal care, household goods, cloths, food and fresh produce, computer and electronics, apparel, bags and cases, baby and maternity products, and home appliances. The company was founded in 2015 and is headquartered in Hangzhou, the People's Republic of China."
YMAB,2016-12-31,13855000,-17057000,NA,-17057000,3184000,0,-17039000,-17039000,-18000,0,0,17039000,0,-18000,NA,-17057000,-17057000,NA,income_statement,Biotechnology,"Y-mAbs Therapeutics, Inc.","Y-mAbs Therapeutics, Inc., a clinical-stage biopharmaceutical company, focuses on the development and commercialization of novel antibody-based therapeutic products for the treatment cancer in the United States. The company develops naxitamab that is in Phase 2 clinical trial for the treatment of pediatric patients with relapsed steosarcoma or refractory, and high-risk neuroblastoma, as well as other GD2 positive tumors; and GD2-GD3 Vaccine which is in Phase 2 clinical trial for the treatment of high-risk neuroblastoma. It is developing omburtamab that is in Phase 2 clinical trial for the treatment of desmoplastic small round cell tumors; in Phase 1 clinical trial for the treatment of diffuse intrinsic pontine glioma, as well as for the treatment of pediatric patients with central nervous system and leptomeningeal metastases; The company also engages in the development of huB7-H3 product candidate for the treatment of B7-H3 positive adult solid tumors; and pre clinical development of huCD33 BsAb product candidate for the treatment of huCD33 positive hermatological cancers. The company has a license and research collaboration agreement with Memorial Sloan Kettering Cancer Center and Massachusetts Institute of Technology to develop and commercialize antibody constructs based on the SADA-BiDE pre-targeted radioimmunotherapy platform. Y-mAbs Therapeutics, Inc. was founded in 2015 and is headquartered in New York, New York."
YMAB,2017-12-31,14307000,-19161000,NA,-19161000,4937000,0,-19244000,-19244000,NA,0,0,19244000,0,83000,NA,-19161000,-19161000,NA,income_statement,Biotechnology,"Y-mAbs Therapeutics, Inc.","Y-mAbs Therapeutics, Inc., a clinical-stage biopharmaceutical company, focuses on the development and commercialization of novel antibody-based therapeutic products for the treatment cancer in the United States. The company develops naxitamab that is in Phase 2 clinical trial for the treatment of pediatric patients with relapsed steosarcoma or refractory, and high-risk neuroblastoma, as well as other GD2 positive tumors; and GD2-GD3 Vaccine which is in Phase 2 clinical trial for the treatment of high-risk neuroblastoma. It is developing omburtamab that is in Phase 2 clinical trial for the treatment of desmoplastic small round cell tumors; in Phase 1 clinical trial for the treatment of diffuse intrinsic pontine glioma, as well as for the treatment of pediatric patients with central nervous system and leptomeningeal metastases; The company also engages in the development of huB7-H3 product candidate for the treatment of B7-H3 positive adult solid tumors; and pre clinical development of huCD33 BsAb product candidate for the treatment of huCD33 positive hermatological cancers. The company has a license and research collaboration agreement with Memorial Sloan Kettering Cancer Center and Massachusetts Institute of Technology to develop and commercialize antibody constructs based on the SADA-BiDE pre-targeted radioimmunotherapy platform. Y-mAbs Therapeutics, Inc. was founded in 2015 and is headquartered in New York, New York."
YMAB,2018-12-31,34269000,-43274000,NA,-43274000,8961000,0,-43230000,-43230000,NA,0,0,43230000,0,-44000,NA,-43274000,-43274000,NA,income_statement,Biotechnology,"Y-mAbs Therapeutics, Inc.","Y-mAbs Therapeutics, Inc., a clinical-stage biopharmaceutical company, focuses on the development and commercialization of novel antibody-based therapeutic products for the treatment cancer in the United States. The company develops naxitamab that is in Phase 2 clinical trial for the treatment of pediatric patients with relapsed steosarcoma or refractory, and high-risk neuroblastoma, as well as other GD2 positive tumors; and GD2-GD3 Vaccine which is in Phase 2 clinical trial for the treatment of high-risk neuroblastoma. It is developing omburtamab that is in Phase 2 clinical trial for the treatment of desmoplastic small round cell tumors; in Phase 1 clinical trial for the treatment of diffuse intrinsic pontine glioma, as well as for the treatment of pediatric patients with central nervous system and leptomeningeal metastases; The company also engages in the development of huB7-H3 product candidate for the treatment of B7-H3 positive adult solid tumors; and pre clinical development of huCD33 BsAb product candidate for the treatment of huCD33 positive hermatological cancers. The company has a license and research collaboration agreement with Memorial Sloan Kettering Cancer Center and Massachusetts Institute of Technology to develop and commercialize antibody constructs based on the SADA-BiDE pre-targeted radioimmunotherapy platform. Y-mAbs Therapeutics, Inc. was founded in 2015 and is headquartered in New York, New York."
YMAB,2019-12-31,62999000,-81028000,NA,-81028000,20005000,0,-83004000,-83004000,NA,0,0,83004000,0,1976000,NA,-81028000,-81028000,NA,income_statement,Biotechnology,"Y-mAbs Therapeutics, Inc.","Y-mAbs Therapeutics, Inc., a clinical-stage biopharmaceutical company, focuses on the development and commercialization of novel antibody-based therapeutic products for the treatment cancer in the United States. The company develops naxitamab that is in Phase 2 clinical trial for the treatment of pediatric patients with relapsed steosarcoma or refractory, and high-risk neuroblastoma, as well as other GD2 positive tumors; and GD2-GD3 Vaccine which is in Phase 2 clinical trial for the treatment of high-risk neuroblastoma. It is developing omburtamab that is in Phase 2 clinical trial for the treatment of desmoplastic small round cell tumors; in Phase 1 clinical trial for the treatment of diffuse intrinsic pontine glioma, as well as for the treatment of pediatric patients with central nervous system and leptomeningeal metastases; The company also engages in the development of huB7-H3 product candidate for the treatment of B7-H3 positive adult solid tumors; and pre clinical development of huCD33 BsAb product candidate for the treatment of huCD33 positive hermatological cancers. The company has a license and research collaboration agreement with Memorial Sloan Kettering Cancer Center and Massachusetts Institute of Technology to develop and commercialize antibody constructs based on the SADA-BiDE pre-targeted radioimmunotherapy platform. Y-mAbs Therapeutics, Inc. was founded in 2015 and is headquartered in New York, New York."
YMTX,2018-12-31,NA,-23587000,NA,-23587000,5567000,-17822000,-23389000,-23389000,-740000,0,0,23389000,17822000,-198000,NA,-23587000,-23587000,NA,income_statement,Biotechnology,"Yumanity Therapeutics, Inc.","Yumanity Therapeutics Inc. discovers and develops disease-modifying therapies for neurodegenerative diseases. It focuses on discovering disease-modifying therapies for patients with Parkinson's, amyotrophic lateral sclerosis, and Alzheimer's diseases. The company concentrates on reversing the cellular phenotypes and disease pathologies caused by protein misfolding. Yumanity Therapeutics Inc. has a strategic research collaboration and license agreement with Merck. The company was founded in 2014 and is headquartered in Boston, Massachusetts."
YMTX,2019-12-31,NA,-31209000,NA,-31209000,7062000,-22969000,-30031000,-30031000,-1209000,0,0,30031000,22969000,-1178000,NA,-31209000,-31209000,NA,income_statement,Biotechnology,"Yumanity Therapeutics, Inc.","Yumanity Therapeutics Inc. discovers and develops disease-modifying therapies for neurodegenerative diseases. It focuses on discovering disease-modifying therapies for patients with Parkinson's, amyotrophic lateral sclerosis, and Alzheimer's diseases. The company concentrates on reversing the cellular phenotypes and disease pathologies caused by protein misfolding. Yumanity Therapeutics Inc. has a strategic research collaboration and license agreement with Merck. The company was founded in 2014 and is headquartered in Boston, Massachusetts."
YNDX,2017-12-31,18866000000,14097000000,9821000000,9201000000,26836000000,70102000000,13161000000,13161000000,-897000000,5016000000,94054000000,80893000000,23952000000,936000000,NA,9081000000,9201000000,NA,income_statement,Internet Content & Information,Yandex N.V.,"Yandex N.V., an Internet and technology company, provides Internet search engine in Russia and internationally. The company offers search, location-based, personalized, and mobile services that enable users to find information, and communicate and connect over the Internet from desktops and mobile devices. It provides geolocation services, such as Yandex.Maps, Yandex.Navigator, Yandex.Auto, and Yandex.Routing; Yandex.Mail that provides access to email accounts; Yandex.Disk, a cloud-based storage service; Yandex.News, an online news aggregation service; Yandex.Weather hyperlocal weather information services; Yandex Browser for desktops and mobile platforms; and Yandex Search Apps. The company also provides Yandex.Direct, an auction-based advertising placement platform; Yandex Advertising Network service; Yandex.Radar, a market analytics tool; mobile advertising products; Yandex.Metrica, a web analytics system; Yandex.Market, an e-commerce gateway service; Yandex.Station, a smart speaker; Alice, an assistant. It offers Yandex.Taxi, a ride-sharing service; Auto.ru for used and new cars, commercial vehicles, and spare parts; Yandex.Realty, a real estate classifieds platform; Yandex.Jobs, a job search Website; and Yandex.Travel, a travel aggregator service. Further, it offers KinoPoisk, a Russian language source for movies, TV series, celebrity content, and entertainment news; Yandex.Music, a music streaming service; Yandex.Afisha to buy tickets to cinemas, theaters, and concerts online; Yandex Plus; Yandex.Studio; and Yandex.TV Program that provides up to date schedule of broadcast, cable and digital TV channels, as well as an option to view certain TV channels online. Additionally, it offers Yandex Zen, a personal recommendation service; Yandex.Cloud that allows companies to host and develop apps and services, and store and manage data; and Yandex.Drive, a free-floating car-sharing service. The company was incorporated in 2004 and is based in Schiphol, the Netherlands."
YNDX,2018-12-31,22579000000,52459000000,35771000000,45984000000,35724000000,91764000000,21324000000,21324000000,-945000000,8201000000,127657000000,106333000000,35893000000,31135000000,NA,44258000000,45984000000,NA,income_statement,Internet Content & Information,Yandex N.V.,"Yandex N.V., an Internet and technology company, provides Internet search engine in Russia and internationally. The company offers search, location-based, personalized, and mobile services that enable users to find information, and communicate and connect over the Internet from desktops and mobile devices. It provides geolocation services, such as Yandex.Maps, Yandex.Navigator, Yandex.Auto, and Yandex.Routing; Yandex.Mail that provides access to email accounts; Yandex.Disk, a cloud-based storage service; Yandex.News, an online news aggregation service; Yandex.Weather hyperlocal weather information services; Yandex Browser for desktops and mobile platforms; and Yandex Search Apps. The company also provides Yandex.Direct, an auction-based advertising placement platform; Yandex Advertising Network service; Yandex.Radar, a market analytics tool; mobile advertising products; Yandex.Metrica, a web analytics system; Yandex.Market, an e-commerce gateway service; Yandex.Station, a smart speaker; Alice, an assistant. It offers Yandex.Taxi, a ride-sharing service; Auto.ru for used and new cars, commercial vehicles, and spare parts; Yandex.Realty, a real estate classifieds platform; Yandex.Jobs, a job search Website; and Yandex.Travel, a travel aggregator service. Further, it offers KinoPoisk, a Russian language source for movies, TV series, celebrity content, and entertainment news; Yandex.Music, a music streaming service; Yandex.Afisha to buy tickets to cinemas, theaters, and concerts online; Yandex Plus; Yandex.Studio; and Yandex.TV Program that provides up to date schedule of broadcast, cable and digital TV channels, as well as an option to view certain TV channels online. Additionally, it offers Yandex Zen, a personal recommendation service; Yandex.Cloud that allows companies to host and develop apps and services, and store and manage data; and Yandex.Drive, a free-floating car-sharing service. The company was incorporated in 2004 and is based in Schiphol, the Netherlands."
YNDX,2019-12-31,29209000000,22855000000,34507000000,12826000000,50155000000,119603000000,25462000000,25462000000,-74000000,11656000000,175391000000,149929000000,55788000000,-2607000000,NA,11199000000,12826000000,NA,income_statement,Internet Content & Information,Yandex N.V.,"Yandex N.V., an Internet and technology company, provides Internet search engine in Russia and internationally. The company offers search, location-based, personalized, and mobile services that enable users to find information, and communicate and connect over the Internet from desktops and mobile devices. It provides geolocation services, such as Yandex.Maps, Yandex.Navigator, Yandex.Auto, and Yandex.Routing; Yandex.Mail that provides access to email accounts; Yandex.Disk, a cloud-based storage service; Yandex.News, an online news aggregation service; Yandex.Weather hyperlocal weather information services; Yandex Browser for desktops and mobile platforms; and Yandex Search Apps. The company also provides Yandex.Direct, an auction-based advertising placement platform; Yandex Advertising Network service; Yandex.Radar, a market analytics tool; mobile advertising products; Yandex.Metrica, a web analytics system; Yandex.Market, an e-commerce gateway service; Yandex.Station, a smart speaker; Alice, an assistant. It offers Yandex.Taxi, a ride-sharing service; Auto.ru for used and new cars, commercial vehicles, and spare parts; Yandex.Realty, a real estate classifieds platform; Yandex.Jobs, a job search Website; and Yandex.Travel, a travel aggregator service. Further, it offers KinoPoisk, a Russian language source for movies, TV series, celebrity content, and entertainment news; Yandex.Music, a music streaming service; Yandex.Afisha to buy tickets to cinemas, theaters, and concerts online; Yandex Plus; Yandex.Studio; and Yandex.TV Program that provides up to date schedule of broadcast, cable and digital TV channels, as well as an option to view certain TV channels online. Additionally, it offers Yandex Zen, a personal recommendation service; Yandex.Cloud that allows companies to host and develop apps and services, and store and manage data; and Yandex.Drive, a free-floating car-sharing service. The company was incorporated in 2004 and is based in Schiphol, the Netherlands."
YNDX,2020-12-31,36339000000,37204000000,23261000000,25512000000,62335000000,132610000000,16249000000,16249000000,-2373000000,13055000000,218344000000,202095000000,85734000000,20955000000,NA,24149000000,25512000000,NA,income_statement,Internet Content & Information,Yandex N.V.,"Yandex N.V., an Internet and technology company, provides Internet search engine in Russia and internationally. The company offers search, location-based, personalized, and mobile services that enable users to find information, and communicate and connect over the Internet from desktops and mobile devices. It provides geolocation services, such as Yandex.Maps, Yandex.Navigator, Yandex.Auto, and Yandex.Routing; Yandex.Mail that provides access to email accounts; Yandex.Disk, a cloud-based storage service; Yandex.News, an online news aggregation service; Yandex.Weather hyperlocal weather information services; Yandex Browser for desktops and mobile platforms; and Yandex Search Apps. The company also provides Yandex.Direct, an auction-based advertising placement platform; Yandex Advertising Network service; Yandex.Radar, a market analytics tool; mobile advertising products; Yandex.Metrica, a web analytics system; Yandex.Market, an e-commerce gateway service; Yandex.Station, a smart speaker; Alice, an assistant. It offers Yandex.Taxi, a ride-sharing service; Auto.ru for used and new cars, commercial vehicles, and spare parts; Yandex.Realty, a real estate classifieds platform; Yandex.Jobs, a job search Website; and Yandex.Travel, a travel aggregator service. Further, it offers KinoPoisk, a Russian language source for movies, TV series, celebrity content, and entertainment news; Yandex.Music, a music streaming service; Yandex.Afisha to buy tickets to cinemas, theaters, and concerts online; Yandex Plus; Yandex.Studio; and Yandex.TV Program that provides up to date schedule of broadcast, cable and digital TV channels, as well as an option to view certain TV channels online. Additionally, it offers Yandex Zen, a personal recommendation service; Yandex.Cloud that allows companies to host and develop apps and services, and store and manage data; and Yandex.Drive, a free-floating car-sharing service. The company was incorporated in 2004 and is based in Schiphol, the Netherlands."
YORW,2016-12-31,NA,17255000,NA,11846000,9129000,39553000,22888000,22888000,-5265000,5409000,47584000,24696000,8031000,-5633000,NA,11846000,11846000,1114000,income_statement,Utilities—Regulated Water,The York Water Company,"The York Water Company impounds, purifies, and distributes drinking water. The company owns and operates two wastewater collection systems and two wastewater treatment systems; and two reservoirs, including Lake Williams and Lake Redman, which hold approximately 2.2 billion gallons of water. It also operates a 15-mile pipeline from the Susquehanna River to Lake Redman; and owns seven wells that supply water to its customers in Carroll Valley Borough and Cumberland Township, Adams County. The company serves customers in the fixtures and furniture, electrical machinery, food product, paper, ordnance unit, textile product, air conditioning system, laundry detergent, barbell, and motorcycle industries in 39 municipalities within York County and 9 municipalities within Adams County, Pennsylvania. The York Water Company was founded in 1816 and is based in York, Pennsylvania."
YORW,2017-12-31,NA,17517000,NA,12974000,9323000,39698000,22473000,22473000,-5348000,4543000,48589000,26116000,8891000,-4956000,NA,12974000,12974000,1133000,income_statement,Utilities—Regulated Water,The York Water Company,"The York Water Company impounds, purifies, and distributes drinking water. The company owns and operates two wastewater collection systems and two wastewater treatment systems; and two reservoirs, including Lake Williams and Lake Redman, which hold approximately 2.2 billion gallons of water. It also operates a 15-mile pipeline from the Susquehanna River to Lake Redman; and owns seven wells that supply water to its customers in Carroll Valley Borough and Cumberland Township, Adams County. The company serves customers in the fixtures and furniture, electrical machinery, food product, paper, ordnance unit, textile product, air conditioning system, laundry detergent, barbell, and motorcycle industries in 39 municipalities within York County and 9 municipalities within Adams County, Pennsylvania. The York Water Company was founded in 1816 and is based in York, Pennsylvania."
YORW,2018-12-31,NA,15867000,NA,13376000,9380000,38767000,21232000,21232000,-5509000,2491000,48437000,27205000,9670000,-5365000,NA,13376000,13376000,1145000,income_statement,Utilities—Regulated Water,The York Water Company,"The York Water Company impounds, purifies, and distributes drinking water. The company owns and operates two wastewater collection systems and two wastewater treatment systems; and two reservoirs, including Lake Williams and Lake Redman, which hold approximately 2.2 billion gallons of water. It also operates a 15-mile pipeline from the Susquehanna River to Lake Redman; and owns seven wells that supply water to its customers in Carroll Valley Borough and Cumberland Township, Adams County. The company serves customers in the fixtures and furniture, electrical machinery, food product, paper, ordnance unit, textile product, air conditioning system, laundry detergent, barbell, and motorcycle industries in 39 municipalities within York County and 9 municipalities within Adams County, Pennsylvania. The York Water Company was founded in 1816 and is based in York, Pennsylvania."
YORW,2019-12-31,NA,16642000,NA,14402000,9968000,41191000,22335000,22335000,-5124000,2240000,51578000,29243000,10387000,-5693000,NA,14402000,14402000,1200000,income_statement,Utilities—Regulated Water,The York Water Company,"The York Water Company impounds, purifies, and distributes drinking water. The company owns and operates two wastewater collection systems and two wastewater treatment systems; and two reservoirs, including Lake Williams and Lake Redman, which hold approximately 2.2 billion gallons of water. It also operates a 15-mile pipeline from the Susquehanna River to Lake Redman; and owns seven wells that supply water to its customers in Carroll Valley Borough and Cumberland Township, Adams County. The company serves customers in the fixtures and furniture, electrical machinery, food product, paper, ordnance unit, textile product, air conditioning system, laundry detergent, barbell, and motorcycle industries in 39 municipalities within York County and 9 municipalities within Adams County, Pennsylvania. The York Water Company was founded in 1816 and is based in York, Pennsylvania."
YQ,2018-12-31,398627000,-656071000,NA,-656071000,506621000,205739000,-699509000,-699509000,-485000,0,310706000,1010215000,104967000,43438000,NA,-656071000,-900442000,NA,income_statement,Education & Training Services,M17 Entertainment Limited,"17 Education & Technology Group Inc., an education technology company, provides K-12 online education service in the People's Republic of China. The company's smart in-school classroom solution offers data-driven teaching, learning, and assessment products to teachers, students, and parents across approximately 70,000 K-12 schools. Its in-school content in its massive and proprietary content library primarily includes localized homework and academic assessment questions sets, and multimedia and interactive educational materials. The company also offers online K-12 large-class after-school tutoring services on development of course syllabi and content and adaptation for live classes areas. The company was incorporated in 2012 and is headquartered in Beijing, the People's Republic of China."
YQ,2019-12-31,491266000,-963750000,NA,-963750000,741611000,232769000,-1000108000,-1000108000,-485000,0,406245000,1406353000,173476000,36358000,NA,-963750000,-1564285000,NA,income_statement,Education & Training Services,M17 Entertainment Limited,"17 Education & Technology Group Inc., an education technology company, provides K-12 online education service in the People's Republic of China. The company's smart in-school classroom solution offers data-driven teaching, learning, and assessment products to teachers, students, and parents across approximately 70,000 K-12 schools. Its in-school content in its massive and proprietary content library primarily includes localized homework and academic assessment questions sets, and multimedia and interactive educational materials. The company also offers online K-12 large-class after-school tutoring services on development of course syllabi and content and adaptation for live classes areas. The company was incorporated in 2012 and is headquartered in Beijing, the People's Republic of China."
